learnable	normalized	partOfSpeech	source
-el	-el		Duolingo
-els	-els		Duolingo
-en	-en		Duolingo
-hi	-hi		Duolingo
-ho	-ho		Duolingo
-la	-la		Duolingo
-les	-les		Duolingo
-li	-li		Duolingo
-lo	-lo		Duolingo
-los	-los		Duolingo
-me	-me		Duolingo
-ne	-ne		Duolingo
-nos	-nos		Duolingo
-se	-se		Duolingo
-vos	-vos		Duolingo
a	a		Duolingo
a dins	a dins		Duolingo
a més	a mes		Duolingo
a poc a poc	a poc a poc		Duolingo
a prop	a prop		Duolingo
a sota	a sota		Duolingo
abandonar	abandonar		Duolingo
abans	abans		Duolingo
abraçada	abracada		Duolingo
abraçades	abracades		Duolingo
abric	abric		Duolingo
abrics	abrics		Duolingo
abril	abril		Duolingo
absència	absencia		Duolingo
absolutament	absolutament		Duolingo
acaba	acaba		Duolingo
acabar	acabar		Duolingo
acaben	acaben		Duolingo
acabes	acabes		Duolingo
acadèmia	academia		Duolingo
acceptem	acceptem		Duolingo
accepten	accepten		Duolingo
acceptes	acceptes		Duolingo
accepteu	accepteu		Duolingo
accepto	accepto		Duolingo
aconseguir	aconseguir		Duolingo
aconseguit	aconseguit		Duolingo
actor	actor		Duolingo
actors	actors		Duolingo
actriu	actriu		Duolingo
actrius	actrius		Duolingo
actualment	actualment		Duolingo
actuar	actuar		Duolingo
adéu	adeu		Duolingo
admès	admes		Duolingo
adult	adult		Duolingo
advocada	advocada		Duolingo
advocades	advocades		Duolingo
advocat	advocat		Duolingo
advocats	advocats		Duolingo
aeroport	aeroport		Duolingo
aeroports	aeroports		Duolingo
afaitadora	afaitadora		Duolingo
afegeixen	afegeixen		Duolingo
afegeixes	afegeixes		Duolingo
afegeixo	afegeixo		Duolingo
afegim	afegim		Duolingo
afegiu	afegiu		Duolingo
àfrica	africa		Duolingo
agafa	agafa		Duolingo
agafar	agafar		Duolingo
agafat	agafat		Duolingo
agafeu	agafeu		Duolingo
agafo	agafo		Duolingo
agost	agost		Duolingo
agricultura	agricultura		Duolingo
ahir	ahir		Duolingo
aigua	aigua		Duolingo
aixecar	aixecar		Duolingo
així	aixi		Duolingo
això	aixo		Duolingo
ajuda	ajuda		Duolingo
ajudava	ajudava		Duolingo
ajudaves	ajudaves		Duolingo
ajudàveu	ajudaveu		Duolingo
ajudem	ajudem		Duolingo
ajuden	ajuden		Duolingo
ajudes	ajudes		Duolingo
ajudeu	ajudeu		Duolingo
ajudo	ajudo		Duolingo
ajuntament	ajuntament		Duolingo
ajuntaments	ajuntaments		Duolingo
al	al		Duolingo
al damunt	al damunt		Duolingo
al darrere	al darrere		Duolingo
al davant	al davant		Duolingo
al voltant de	al voltant de		Duolingo
alcohol	alcohol		Duolingo
alegria	alegria		Duolingo
algú	algu		Duolingo
algun	algun		Duolingo
alguna	alguna		Duolingo
alguna cosa	alguna cosa		Duolingo
algunes	algunes		Duolingo
alguns	alguns		Duolingo
allà	alla		Duolingo
allò	allo		Duolingo
als	als		Duolingo
alt	alt		Duolingo
alta	alta		Duolingo
altes	altes		Duolingo
altra	altra		Duolingo
altre	altre		Duolingo
altres	altres		Duolingo
amables	amables		Duolingo
amb	amb		Duolingo
amèrica	america		Duolingo
amic	amic		Duolingo
amiga	amiga		Duolingo
amistat	amistat		Duolingo
amor	amor		Duolingo
ampla	ampla		Duolingo
ample	ample		Duolingo
amples	amples		Duolingo
ampli	ampli		Duolingo
àmplies	amplies		Duolingo
amplis	amplis		Duolingo
ampolla	ampolla		Duolingo
ampolles	ampolles		Duolingo
analitzar	analitzar		Duolingo
anar	anar		Duolingo
anat	anat		Duolingo
anaven	anaven		Duolingo
andorra	andorra		Duolingo
ànec	anec		Duolingo
ànecs	anecs		Duolingo
anem	anem		Duolingo
aneu	aneu		Duolingo
anglaterra	anglaterra		Duolingo
anglès	angles		Duolingo
animal	animal		Duolingo
animals	animals		Duolingo
anteriorment	anteriorment		Duolingo
any	any		Duolingo
anys	anys		Duolingo
aparec	aparec		Duolingo
apareix	apareix		Duolingo
apareixen	apareixen		Duolingo
apareixes	apareixes		Duolingo
aparell	aparell		Duolingo
àpat	apat		Duolingo
aplicar	aplicar		Duolingo
aprèn	apren		Duolingo
aprenc	aprenc		Duolingo
aprendre	aprendre		Duolingo
aprenem	aprenem		Duolingo
apreneu	apreneu		Duolingo
aprenia	aprenia		Duolingo
aprenien	aprenien		Duolingo
aprenies	aprenies		Duolingo
après	apres		Duolingo
aproximadament	aproximadament		Duolingo
aquell	aquell		Duolingo
aquella	aquella		Duolingo
aquelles	aquelles		Duolingo
aquells	aquells		Duolingo
aquest	aquest		Duolingo
aquesta	aquesta		Duolingo
aquestes	aquestes		Duolingo
aquests	aquests		Duolingo
aquí	aqui		Duolingo
ara	ara		Duolingo
aranya	aranya		Duolingo
àrea	area		Duolingo
argentí	argenti		Duolingo
argentina	argentina		Duolingo
arma	arma		Duolingo
armes	armes		Duolingo
arqueòleg	arqueoleg		Duolingo
arqueòlegs	arqueolegs		Duolingo
arqueòloga	arqueologa		Duolingo
arqueòlogues	arqueologues		Duolingo
arriba	arriba		Duolingo
arribada	arribada		Duolingo
arribar	arribar		Duolingo
arribes	arribes		Duolingo
arribo	arribo		Duolingo
arròs	arros		Duolingo
artista	artista		Duolingo
artistes	artistes		Duolingo
assecadora	assecadora		Duolingo
atleta	atleta		Duolingo
atletes	atletes		Duolingo
atura	atura		Duolingo
audiència	audiencia		Duolingo
autobús	autobus		Duolingo
autobusos	autobusos		Duolingo
autor	autor		Duolingo
autora	autora		Duolingo
autores	autores		Duolingo
autors	autors		Duolingo
avi	avi		Duolingo
àvia	avia		Duolingo
aviat	aviat		Duolingo
àvies	avies		Duolingo
avinguda	avinguda		Duolingo
avingudes	avingudes		Duolingo
avió	avio		Duolingo
avions	avions		Duolingo
avis	avis		Duolingo
avorrides	avorrides		Duolingo
avorrit	avorrit		Duolingo
avorrits	avorrits		Duolingo
avui	avui		Duolingo
baix	baix		Duolingo
baixa	baixa		Duolingo
baixes	baixes		Duolingo
baixos	baixos		Duolingo
ballant	ballant		Duolingo
banc	banc		Duolingo
banda	banda		Duolingo
bandera	bandera		Duolingo
banderes	banderes		Duolingo
bany	bany		Duolingo
bar	bar		Duolingo
barat	barat		Duolingo
barcelona	barcelona		Duolingo
barret	barret		Duolingo
barrets	barrets		Duolingo
barri	barri		Duolingo
barris	barris		Duolingo
bars	bars		Duolingo
bastant	bastant		Duolingo
bastants	bastants		Duolingo
bateria	bateria		Duolingo
bateries	bateries		Duolingo
bé	be		Duolingo
bebent	bebent		Duolingo
bec	bec		Duolingo
beguem	beguem		Duolingo
benvinguda	benvinguda		Duolingo
benvingudes	benvingudes		Duolingo
benvingut	benvingut		Duolingo
benvinguts	benvinguts		Duolingo
berenar	berenar		Duolingo
beu	beu		Duolingo
beuen	beuen		Duolingo
beure	beure		Duolingo
beus	beus		Duolingo
bevem	bevem		Duolingo
beveu	beveu		Duolingo
bevies	bevies		Duolingo
bevíeu	bevieu		Duolingo
biblioteca	biblioteca		Duolingo
biblioteques	biblioteques		Duolingo
bicicleta	bicicleta		Duolingo
bicicletes	bicicletes		Duolingo
blanc	blanc		Duolingo
blanca	blanca		Duolingo
blancs	blancs		Duolingo
blanques	blanques		Duolingo
blau	blau		Duolingo
blaus	blaus		Duolingo
blava	blava		Duolingo
blaves	blaves		Duolingo
bo	bo		Duolingo
bola	bola		Duolingo
boles	boles		Duolingo
bolígraf	boligraf		Duolingo
bolígrafs	boligrafs		Duolingo
bomba	bomba		Duolingo
bombes	bombes		Duolingo
bon	bon		Duolingo
bon dia	bon dia		Duolingo
bona	bona		Duolingo
bona nit	bona nit		Duolingo
bona tarda	bona tarda		Duolingo
bones	bones		Duolingo
bonic	bonic		Duolingo
bonica	bonica		Duolingo
boniques	boniques		Duolingo
bons	bons		Duolingo
bosc	bosc		Duolingo
bossa	bossa		Duolingo
bosses	bosses		Duolingo
bota	bota		Duolingo
botes	botes		Duolingo
bressol	bressol		Duolingo
britànic	britanic		Duolingo
brusel·les	brusel*les		Duolingo
brut	brut		Duolingo
bruta	bruta		Duolingo
buida	buida		Duolingo
buides	buides		Duolingo
buit	buit		Duolingo
busca	busca		Duolingo
buscar	buscar		Duolingo
busques	busques		Duolingo
cabells	cabells		Duolingo
cabem	cabem		Duolingo
caben	caben		Duolingo
cabo	cabo		Duolingo
cada	cada		Duolingo
cadascú	cadascu		Duolingo
cadena	cadena		Duolingo
cadenes	cadenes		Duolingo
cadira	cadira		Duolingo
cafè	cafe		Duolingo
caixa	caixa		Duolingo
caixer	caixer		Duolingo
caixeres	caixeres		Duolingo
caixers	caixers		Duolingo
caixes	caixes		Duolingo
cal	cal		Duolingo
calent	calent		Duolingo
calenta	calenta		Duolingo
cambrer	cambrer		Duolingo
cambreres	cambreres		Duolingo
cambrers	cambrers		Duolingo
càmera	camera		Duolingo
càmeres	cameres		Duolingo
camina	camina		Duolingo
caminant	caminant		Duolingo
caminem	caminem		Duolingo
caminen	caminen		Duolingo
camines	camines		Duolingo
camineu	camineu		Duolingo
camino	camino		Duolingo
camisa	camisa		Duolingo
camises	camises		Duolingo
campana	campana		Duolingo
campanes	campanes		Duolingo
camperol	camperol		Duolingo
cancel·lar	cancel*lar		Duolingo
cansades	cansades		Duolingo
cansat	cansat		Duolingo
cantonada	cantonada		Duolingo
canvi	canvi		Duolingo
canviar	canviar		Duolingo
canviat	canviat		Duolingo
cap	cap		Duolingo
cap a	cap a		Duolingo
cap al	cap al		Duolingo
capaços	capacos		Duolingo
capellà	capella		Duolingo
capellans	capellans		Duolingo
capità	capita		Duolingo
capital	capital		Duolingo
capitals	capitals		Duolingo
capitana	capitana		Duolingo
capitanes	capitanes		Duolingo
capítol	capitol		Duolingo
car	car		Duolingo
carn	carn		Duolingo
carrer	carrer		Duolingo
carrers	carrers		Duolingo
carretera	carretera		Duolingo
carreteres	carreteres		Duolingo
carta	carta		Duolingo
cartera	cartera		Duolingo
cartes	cartes		Duolingo
casa	casa		Duolingo
cases	cases		Duolingo
castell	castell		Duolingo
castelló	castello		Duolingo
castells	castells		Duolingo
català	catala		Duolingo
catalans	catalans		Duolingo
catalunya	catalunya		Duolingo
catorze	catorze		Duolingo
caure	caure		Duolingo
cavall	cavall		Duolingo
cavaller	cavaller		Duolingo
cavalls	cavalls		Duolingo
ceba	ceba		Duolingo
cent	cent		Duolingo
central	central		Duolingo
centre	centre		Duolingo
cerca	cerca		Duolingo
cercant	cercant		Duolingo
cert	cert		Duolingo
certa	certa		Duolingo
certes	certes		Duolingo
certs	certs		Duolingo
cervesa	cervesa		Duolingo
cinc	cinc		Duolingo
cinquanta	cinquanta		Duolingo
cinturó	cinturo		Duolingo
cinturons	cinturons		Duolingo
cita	cita		Duolingo
cites	cites		Duolingo
ciutadà	ciutada		Duolingo
ciutadanes	ciutadanes		Duolingo
ciutat	ciutat		Duolingo
ciutats	ciutats		Duolingo
clar	clar		Duolingo
clara	clara		Duolingo
classe	classe		Duolingo
classes	classes		Duolingo
clau	clau		Duolingo
claus	claus		Duolingo
col·locar	col*locar		Duolingo
colombià	colombia		Duolingo
color	color		Duolingo
colors	colors		Duolingo
colossal	colossal		Duolingo
colossals	colossals		Duolingo
columna	columna		Duolingo
columnes	columnes		Duolingo
com	com		Duolingo
comarca	comarca		Duolingo
comarques	comarques		Duolingo
comença	comenca		Duolingo
començar	comencar		Duolingo
començat	comencat		Duolingo
comencen	comencen		Duolingo
comences	comences		Duolingo
començo	comenco		Duolingo
company	company		Duolingo
completament	completament		Duolingo
comportar	comportar		Duolingo
compra	compra		Duolingo
comprendre	comprendre		Duolingo
compres	compres		Duolingo
compta	compta		Duolingo
comptes	comptes		Duolingo
compto	compto		Duolingo
comú	comu		Duolingo
comuna	comuna		Duolingo
comunes	comunes		Duolingo
comunitat	comunitat		Duolingo
conduíem	conduiem		Duolingo
conduïen	conduien		Duolingo
conduíeu	conduieu		Duolingo
conduir	conduir		Duolingo
conduït	conduit		Duolingo
conec	conec		Duolingo
conegut	conegut		Duolingo
coneixem	coneixem		Duolingo
coneixement	coneixement		Duolingo
coneixen	coneixen		Duolingo
conèixer	coneixer		Duolingo
coneixes	coneixes		Duolingo
coneixeu	coneixeu		Duolingo
coneixia	coneixia		Duolingo
coneixien	coneixien		Duolingo
coneixies	coneixies		Duolingo
coneixíeu	coneixieu		Duolingo
conill	conill		Duolingo
consideres	consideres		Duolingo
considero	considero		Duolingo
construir	construir		Duolingo
continent	continent		Duolingo
continents	continents		Duolingo
continua	continua		Duolingo
continuació	continuacio		Duolingo
continuar	continuar		Duolingo
continueu	continueu		Duolingo
contra	contra		Duolingo
controlar	controlar		Duolingo
cooperació	cooperacio		Duolingo
cop	cop		Duolingo
copa	copa		Duolingo
copes	copes		Duolingo
corbata	corbata		Duolingo
corbates	corbates		Duolingo
corre	corre		Duolingo
corregut	corregut		Duolingo
correm	correm		Duolingo
corren	corren		Duolingo
corrent	corrent		Duolingo
correu	correu		Duolingo
corro	corro		Duolingo
cosa	cosa		Duolingo
coses	coses		Duolingo
cosí	cosi		Duolingo
cosina	cosina		Duolingo
cosines	cosines		Duolingo
cosins	cosins		Duolingo
costa	costa		Duolingo
costat	costat		Duolingo
costen	costen		Duolingo
costum	costum		Duolingo
costums	costums		Duolingo
cotxe	cotxe		Duolingo
cotxes	cotxes		Duolingo
cranc	cranc		Duolingo
creiem	creiem		Duolingo
creieu	creieu		Duolingo
créixer	creixer		Duolingo
creu	creu		Duolingo
creuen	creuen		Duolingo
creure	creure		Duolingo
creus	creus		Duolingo
crisi	crisi		Duolingo
cubà	cuba		Duolingo
cuina	cuina		Duolingo
cuinant	cuinant		Duolingo
cuinat	cuinat		Duolingo
cuinava	cuinava		Duolingo
cuinàvem	cuinavem		Duolingo
cuinaven	cuinaven		Duolingo
cuinem	cuinem		Duolingo
cuiner	cuiner		Duolingo
cuinera	cuinera		Duolingo
cuineres	cuineres		Duolingo
cuiners	cuiners		Duolingo
cuines	cuines		Duolingo
cuineu	cuineu		Duolingo
cuino	cuino		Duolingo
cullera	cullera		Duolingo
cultura	cultura		Duolingo
cultures	cultures		Duolingo
curs	curs		Duolingo
curta	curta		Duolingo
curtes	curtes		Duolingo
curts	curts		Duolingo
d'	d'		Duolingo
damunt	damunt		Duolingo
darrere	darrere		Duolingo
data	data		Duolingo
dates	dates		Duolingo
davant	davant		Duolingo
de	de		Duolingo
de res	de res		Duolingo
decidit	decidit		Duolingo
dedicat	dedicat		Duolingo
defensa	defensa		Duolingo
defensar	defensar		Duolingo
dèficit	deficit		Duolingo
definir	definir		Duolingo
definitivament	definitivament		Duolingo
deixa	deixa		Duolingo
deixant	deixant		Duolingo
deixar	deixar		Duolingo
deixen	deixen		Duolingo
deixes	deixes		Duolingo
deixo	deixo		Duolingo
del	del		Duolingo
dels	dels		Duolingo
demà	dema		Duolingo
demanar	demanar		Duolingo
demostrar	demostrar		Duolingo
demostrat	demostrat		Duolingo
des de	des de		Duolingo
descobert	descobert		Duolingo
descobrir	descobrir		Duolingo
desembre	desembre		Duolingo
desenvolupar	desenvolupar		Duolingo
despertar	despertar		Duolingo
despertat	despertat		Duolingo
després	despres		Duolingo
deu	deu		Duolingo
dia	dia		Duolingo
diari	diari		Duolingo
diaris	diaris		Duolingo
dibuixar	dibuixar		Duolingo
dic	dic		Duolingo
dient	dient		Duolingo
dies	dies		Duolingo
diferent	diferent		Duolingo
diferents	diferents		Duolingo
difícil	dificil		Duolingo
dignitat	dignitat		Duolingo
diguem	diguem		Duolingo
digues	digues		Duolingo
digueu	digueu		Duolingo
dijous	dijous		Duolingo
dilluns	dilluns		Duolingo
dimarts	dimarts		Duolingo
dimecres	dimecres		Duolingo
dinar	dinar		Duolingo
diner	diner		Duolingo
diners	diners		Duolingo
dins	dins		Duolingo
dir	dir		Duolingo
direcció	direccio		Duolingo
dirigit	dirigit		Duolingo
discussió	discussio		Duolingo
disponibles	disponibles		Duolingo
dissabte	dissabte		Duolingo
distància	distancia		Duolingo
distàncies	distancies		Duolingo
dit	dit		Duolingo
diu	diu		Duolingo
diuen	diuen		Duolingo
diumenge	diumenge		Duolingo
dius	dius		Duolingo
divendres	divendres		Duolingo
diverses	diverses		Duolingo
diversos	diversos		Duolingo
doble	doble		Duolingo
document	document		Duolingo
documents	documents		Duolingo
dòlar	dolar		Duolingo
dòlars	dolars		Duolingo
dolç	dolc		Duolingo
dolça	dolca		Duolingo
dolces	dolces		Duolingo
dolent	dolent		Duolingo
dolenta	dolenta		Duolingo
dolentes	dolentes		Duolingo
dolents	dolents		Duolingo
dona	dona		Duolingo
donant	donant		Duolingo
donar	donar		Duolingo
donat	donat		Duolingo
donàvem	donavem		Duolingo
donaven	donaven		Duolingo
donàveu	donaveu		Duolingo
donem	donem		Duolingo
donen	donen		Duolingo
dones	dones		Duolingo
doneu	doneu		Duolingo
dono	dono		Duolingo
dormen	dormen		Duolingo
dormia	dormia		Duolingo
dormien	dormien		Duolingo
dormies	dormies		Duolingo
dormíeu	dormieu		Duolingo
dormim	dormim		Duolingo
dormint	dormint		Duolingo
dormir	dormir		Duolingo
dormit	dormit		Duolingo
dormitori	dormitori		Duolingo
dormiu	dormiu		Duolingo
dormo	dormo		Duolingo
dorms	dorms		Duolingo
dos	dos		Duolingo
dotze	dotze		Duolingo
dreta	dreta		Duolingo
dretes	dretes		Duolingo
dubtem	dubtem		Duolingo
dubten	dubten		Duolingo
dubteu	dubteu		Duolingo
dubto	dubto		Duolingo
dues	dues		Duolingo
dur	dur		Duolingo
dura	dura		Duolingo
dures	dures		Duolingo
dutxem	dutxem		Duolingo
edifici	edifici		Duolingo
edificis	edificis		Duolingo
educació	educacio		Duolingo
eivissa	eivissa		Duolingo
el	el		Duolingo
elefant	elefant		Duolingo
elefants	elefants		Duolingo
ell	ell		Duolingo
ella	ella		Duolingo
elles	elles		Duolingo
ells	ells		Duolingo
els	els		Duolingo
em	em		Duolingo
em sap greu	em sap greu		Duolingo
emporta	emporta		Duolingo
emportem	emportem		Duolingo
emprat	emprat		Duolingo
empresari	empresari		Duolingo
empresària	empresaria		Duolingo
empresàries	empresaries		Duolingo
empresaris	empresaris		Duolingo
en	en		Duolingo
en general	en general		Duolingo
encara	encara		Duolingo
encara que	encara que		Duolingo
endavant	endavant		Duolingo
endreça	endreca		Duolingo
endrecen	endrecen		Duolingo
endreces	endreces		Duolingo
endreço	endreco		Duolingo
enemic	enemic		Duolingo
enginyer	enginyer		Duolingo
enginyera	enginyera		Duolingo
enginyeres	enginyeres		Duolingo
enginyers	enginyers		Duolingo
enlloc	enlloc		Duolingo
enorme	enorme		Duolingo
enormes	enormes		Duolingo
ens	ens		Duolingo
entendre	entendre		Duolingo
entenen	entenen		Duolingo
enteneu	enteneu		Duolingo
entrada	entrada		Duolingo
entrar	entrar		Duolingo
entre	entre		Duolingo
entrepà	entrepa		Duolingo
envia	envia		Duolingo
enviat	enviat		Duolingo
enviem	enviem		Duolingo
envien	envien		Duolingo
envies	envies		Duolingo
equivoco	equivoco		Duolingo
equivoqueu	equivoqueu		Duolingo
eren	eren		Duolingo
eres	eres		Duolingo
éreu	ereu		Duolingo
és	es		Duolingo
escacs	escacs		Duolingo
escala	escala		Duolingo
escola	escola		Duolingo
escollit	escollit		Duolingo
escolta	escolta		Duolingo
escoltat	escoltat		Duolingo
escoltem	escoltem		Duolingo
escolten	escolten		Duolingo
escoltes	escoltes		Duolingo
escolteu	escolteu		Duolingo
escric	escric		Duolingo
escriguis	escriguis		Duolingo
escriptori	escriptori		Duolingo
escrit	escrit		Duolingo
escriu	escriu		Duolingo
escriuen	escriuen		Duolingo
escriure	escriure		Duolingo
escrius	escrius		Duolingo
escrivien	escrivien		Duolingo
escrivíeu	escrivieu		Duolingo
escrivim	escrivim		Duolingo
escrivint	escrivint		Duolingo
escriviu	escriviu		Duolingo
esmorza	esmorza		Duolingo
esmorzar	esmorzar		Duolingo
espanya	espanya		Duolingo
espanyol	espanyol		Duolingo
especialment	especialment		Duolingo
especials	especials		Duolingo
esperant	esperant		Duolingo
esperanto	esperanto		Duolingo
esperar	esperar		Duolingo
esponja	esponja		Duolingo
esquerra	esquerra		Duolingo
esquerre	esquerre		Duolingo
est	est		Duolingo
estabilitat	estabilitat		Duolingo
estació	estacio		Duolingo
estacions	estacions		Duolingo
estàs	estas		Duolingo
estat	estat		Duolingo
estatunidenc	estatunidenc		Duolingo
esteu	esteu		Duolingo
estimant	estimant		Duolingo
estiu	estiu		Duolingo
estius	estius		Duolingo
estona	estona		Duolingo
estones	estones		Duolingo
estranger	estranger		Duolingo
estranyes	estranyes		Duolingo
estranys	estranys		Duolingo
estret	estret		Duolingo
estreta	estreta		Duolingo
estretes	estretes		Duolingo
estrets	estrets		Duolingo
estudi	estudi		Duolingo
estudia	estudia		Duolingo
estudiant	estudiant		Duolingo
estudiants	estudiants		Duolingo
estudiar	estudiar		Duolingo
estudies	estudies		Duolingo
estudio	estudio		Duolingo
esvelt	esvelt		Duolingo
esvelta	esvelta		Duolingo
esvelts	esvelts		Duolingo
et	et		Duolingo
ets	ets		Duolingo
europa	europa		Duolingo
europeu	europeu		Duolingo
evitar	evitar		Duolingo
exactament	exactament		Duolingo
exemple	exemple		Duolingo
existir	existir		Duolingo
explicació	explicacio		Duolingo
explicar	explicar		Duolingo
exterior	exterior		Duolingo
fa	fa		Duolingo
fàcil	facil		Duolingo
fàcilment	facilment		Duolingo
facultat	facultat		Duolingo
faig	faig		Duolingo
faldilla	faldilla		Duolingo
faldilles	faldilles		Duolingo
fals	fals		Duolingo
falsa	falsa		Duolingo
família	familia		Duolingo
famílies	families		Duolingo
fan	fan		Duolingo
fantàstic	fantastic		Duolingo
fantàstica	fantastica		Duolingo
fantàstics	fantastics		Duolingo
fantàstiques	fantastiques		Duolingo
fas	fas		Duolingo
fàstic	fastic		Duolingo
febrer	febrer		Duolingo
feia	feia		Duolingo
fèiem	feiem		Duolingo
feies	feies		Duolingo
feina	feina		Duolingo
feliç	felic		Duolingo
felices	felices		Duolingo
felicitat	felicitat		Duolingo
feliços	felicos		Duolingo
fem	fem		Duolingo
fent	fent		Duolingo
fent servir	fent servir		Duolingo
fer	fer		Duolingo
festa	festa		Duolingo
festes	festes		Duolingo
fet	fet		Duolingo
feu	feu		Duolingo
fi	fi		Duolingo
ficat	ficat		Duolingo
fill	fill		Duolingo
filla	filla		Duolingo
filles	filles		Duolingo
fillol	fillol		Duolingo
fillola	fillola		Duolingo
filloles	filloles		Duolingo
fillols	fillols		Duolingo
fills	fills		Duolingo
fina	fina		Duolingo
finalment	finalment		Duolingo
fines	fines		Duolingo
finestra	finestra		Duolingo
finestres	finestres		Duolingo
fins	fins		Duolingo
fins a	fins a		Duolingo
fins al	fins al		Duolingo
fira	fira		Duolingo
font	font		Duolingo
fonts	fonts		Duolingo
fora	fora		Duolingo
força	forca		Duolingo
formatge	formatge		Duolingo
forn	forn		Duolingo
fornera	fornera		Duolingo
forneres	forneres		Duolingo
forners	forners		Duolingo
forquilla	forquilla		Duolingo
forquilles	forquilles		Duolingo
fort	fort		Duolingo
forta	forta		Duolingo
fortes	fortes		Duolingo
forts	forts		Duolingo
fosca	fosca		Duolingo
foto	foto		Duolingo
fotos	fotos		Duolingo
frança	franca		Duolingo
francès	frances		Duolingo
fred	fred		Duolingo
freda	freda		Duolingo
freds	freds		Duolingo
frontera	frontera		Duolingo
fronteres	fronteres		Duolingo
fruita	fruita		Duolingo
funcionari	funcionari		Duolingo
funcionària	funcionaria		Duolingo
funcionàries	funcionaries		Duolingo
funcionaris	funcionaris		Duolingo
fuster	fuster		Duolingo
fustera	fustera		Duolingo
fusteres	fusteres		Duolingo
fusters	fusters		Duolingo
futbol	futbol		Duolingo
gaire	gaire		Duolingo
gairebé	gairebe		Duolingo
gaires	gaires		Duolingo
ganivet	ganivet		Duolingo
gat	gat		Duolingo
gata	gata		Duolingo
gates	gates		Duolingo
gats	gats		Duolingo
gener	gener		Duolingo
generalitat	generalitat		Duolingo
generalment	generalment		Duolingo
generós	generos		Duolingo
generoses	generoses		Duolingo
generosos	generosos		Duolingo
gens	gens		Duolingo
gens de	gens de		Duolingo
gent	gent		Duolingo
germà	germa		Duolingo
germana	germana		Duolingo
germans	germans		Duolingo
girona	girona		Duolingo
gos	gos		Duolingo
gossos	gossos		Duolingo
got	got		Duolingo
gràcies	gracies		Duolingo
gran	gran		Duolingo
granger	granger		Duolingo
grangera	grangera		Duolingo
grangeres	grangeres		Duolingo
grangers	grangers		Duolingo
grans	grans		Duolingo
gras	gras		Duolingo
grassa	grassa		Duolingo
grasses	grasses		Duolingo
grassos	grassos		Duolingo
grau	grau		Duolingo
gris	gris		Duolingo
grisa	grisa		Duolingo
grises	grises		Duolingo
grisos	grisos		Duolingo
groc	groc		Duolingo
grocs	grocs		Duolingo
groga	groga		Duolingo
grogues	grogues		Duolingo
gros	gros		Duolingo
grossa	grossa		Duolingo
grosses	grosses		Duolingo
grossos	grossos		Duolingo
gruixuda	gruixuda		Duolingo
gruixudes	gruixudes		Duolingo
gruixut	gruixut		Duolingo
gruixuts	gruixuts		Duolingo
guanyar	guanyar		Duolingo
guitarra	guitarra		Duolingo
habitació	habitacio		Duolingo
haig	haig		Duolingo
hem	hem		Duolingo
hi	hi		Duolingo
hi ha	hi ha		Duolingo
hi hauria	hi hauria		Duolingo
història	historia		Duolingo
hivern	hivern		Duolingo
ho	ho		Duolingo
hola	hola		Duolingo
hom	hom		Duolingo
home	home		Duolingo
homes	homes		Duolingo
hores	hores		Duolingo
hospital	hospital		Duolingo
hospitals	hospitals		Duolingo
hostesses	hostesses		Duolingo
hotel	hotel		Duolingo
hotels	hotels		Duolingo
humanitat	humanitat		Duolingo
i	i		Duolingo
ideal	ideal		Duolingo
ideals	ideals		Duolingo
igualment	igualment		Duolingo
illa	illa		Duolingo
illes	illes		Duolingo
imaginat	imaginat		Duolingo
immediatament	immediatament		Duolingo
immens	immens		Duolingo
important	important		Duolingo
importants	importants		Duolingo
impossible	impossible		Duolingo
incloc	incloc		Duolingo
incloem	incloem		Duolingo
incloent	incloent		Duolingo
incloeu	incloeu		Duolingo
inclou	inclou		Duolingo
inclous	inclous		Duolingo
independent	independent		Duolingo
individu	individu		Duolingo
industrials	industrials		Duolingo
inferior	inferior		Duolingo
inferiors	inferiors		Duolingo
infermer	infermer		Duolingo
infermera	infermera		Duolingo
infermeres	infermeres		Duolingo
infermers	infermers		Duolingo
informàtic	informatic		Duolingo
informàtica	informatica		Duolingo
informàtics	informatics		Duolingo
informàtiques	informatiques		Duolingo
institució	institucio		Duolingo
institucions	institucions		Duolingo
institut	institut		Duolingo
instituts	instituts		Duolingo
intel·lectual	intel*lectual		Duolingo
intel·lectuals	intel*lectuals		Duolingo
intel·ligència	intel*ligencia		Duolingo
intel·ligent	intel*ligent		Duolingo
intel·ligents	intel*ligents		Duolingo
intentar	intentar		Duolingo
intentat	intentat		Duolingo
interessant	interessant		Duolingo
interessants	interessants		Duolingo
interior	interior		Duolingo
internacional	internacional		Duolingo
internet	internet		Duolingo
italià	italia		Duolingo
ja	ja		Duolingo
jardí	jardi		Duolingo
jardins	jardins		Duolingo
jersei	jersei		Duolingo
jerseis	jerseis		Duolingo
jo	jo		Duolingo
joc	joc		Duolingo
jocs	jocs		Duolingo
jove	jove		Duolingo
joves	joves		Duolingo
juga	juga		Duolingo
jugat	jugat		Duolingo
jugaven	jugaven		Duolingo
jugaves	jugaves		Duolingo
jugo	jugo		Duolingo
juguem	juguem		Duolingo
juguen	juguen		Duolingo
jugues	jugues		Duolingo
jugueu	jugueu		Duolingo
juliol	juliol		Duolingo
juny	juny		Duolingo
justa	justa		Duolingo
justícia	justicia		Duolingo
jutges	jutges		Duolingo
jutgessa	jutgessa		Duolingo
jutgesses	jutgesses		Duolingo
l'	l'		Duolingo
l'alguer	l'alguer		Duolingo
la	la		Duolingo
lectura	lectura		Duolingo
lent	lent		Duolingo
lenta	lenta		Duolingo
lentament	lentament		Duolingo
lentes	lentes		Duolingo
lents	lents		Duolingo
les	les		Duolingo
li	li		Duolingo
llar	llar		Duolingo
llarg	llarg		Duolingo
llarga	llarga		Duolingo
llargs	llargs		Duolingo
llargues	llargues		Duolingo
llàstima	llastima		Duolingo
llavors	llavors		Duolingo
llegeix	llegeix		Duolingo
llegeixen	llegeixen		Duolingo
llegeixes	llegeixes		Duolingo
llegeixo	llegeixo		Duolingo
llegia	llegia		Duolingo
llegien	llegien		Duolingo
llegíeu	llegieu		Duolingo
llegint	llegint		Duolingo
llegit	llegit		Duolingo
llegiu	llegiu		Duolingo
lleig	lleig		Duolingo
llençol	llencol		Duolingo
lleó	lleo		Duolingo
llet	llet		Duolingo
lletja	lletja		Duolingo
llibre	llibre		Duolingo
llibres	llibres		Duolingo
llimona	llimona		Duolingo
llista	llista		Duolingo
llistes	llistes		Duolingo
llit	llit		Duolingo
lloc	lloc		Duolingo
llocs	llocs		Duolingo
llogar	llogar		Duolingo
llop	llop		Duolingo
llum	llum		Duolingo
lluny	lluny		Duolingo
llur	llur		Duolingo
llurs	llurs		Duolingo
lògic	logic		Duolingo
lògics	logics		Duolingo
m'	m'		Duolingo
m'agrada	m'agrada		Duolingo
mà	ma		Duolingo
maduixa	maduixa		Duolingo
maduixes	maduixes		Duolingo
mai	mai		Duolingo
maig	maig		Duolingo
majoria	majoria		Duolingo
malalt	malalt		Duolingo
maleta	maleta		Duolingo
maletes	maletes		Duolingo
malgrat	malgrat		Duolingo
mamà	mama		Duolingo
mamàs	mamas		Duolingo
mandra	mandra		Duolingo
mantenir	mantenir		Duolingo
mapa	mapa		Duolingo
mapes	mapes		Duolingo
màquina	maquina		Duolingo
màquines	maquines		Duolingo
març	marc		Duolingo
mare	mare		Duolingo
mares	mares		Duolingo
marit	marit		Duolingo
marits	marits		Duolingo
massa	massa		Duolingo
material	material		Duolingo
matí	mati		Duolingo
matinada	matinada		Duolingo
matinades	matinades		Duolingo
matins	matins		Duolingo
matrimoni	matrimoni		Duolingo
màxim	maxim		Duolingo
màxima	maxima		Duolingo
mecànic	mecanic		Duolingo
mecànica	mecanica		Duolingo
mecànics	mecanics		Duolingo
mecàniques	mecaniques		Duolingo
meitat	meitat		Duolingo
mengem	mengem		Duolingo
mengen	mengen		Duolingo
menges	menges		Duolingo
mengi	mengi		Duolingo
menja	menja		Duolingo
menjador	menjador		Duolingo
menjant	menjant		Duolingo
menjar	menjar		Duolingo
menjat	menjat		Duolingo
menjava	menjava		Duolingo
menjaven	menjaven		Duolingo
menjàveu	menjaveu		Duolingo
menjo	menjo		Duolingo
mentre	mentre		Duolingo
menú	menu		Duolingo
menys	menys		Duolingo
més	mes		Duolingo
mesos	mesos		Duolingo
mestra	mestra		Duolingo
mestre	mestre		Duolingo
mestres	mestres		Duolingo
mestressa de casa	mestressa de casa		Duolingo
mesura	mesura		Duolingo
mesures	mesures		Duolingo
metge	metge		Duolingo
metges	metges		Duolingo
metgessa	metgessa		Duolingo
metre	metre		Duolingo
meu	meu		Duolingo
meus	meus		Duolingo
meva	meva		Duolingo
meves	meves		Duolingo
mèxic	mexic		Duolingo
mexicà	mexica		Duolingo
mi	mi		Duolingo
mico	mico		Duolingo
mida	mida		Duolingo
mides	mides		Duolingo
migdia	migdia		Duolingo
migdies	migdies		Duolingo
mil	mil		Duolingo
miler	miler		Duolingo
milió	milio		Duolingo
milloren	milloren		Duolingo
millores	millores		Duolingo
milloro	milloro		Duolingo
minut	minut		Duolingo
minuts	minuts		Duolingo
mira	mira		Duolingo
mirall	mirall		Duolingo
mirant	mirant		Duolingo
mirar	mirar		Duolingo
mirem	mirem		Duolingo
mires	mires		Duolingo
miro	miro		Duolingo
mitjanit	mitjanit		Duolingo
mitjó	mitjo		Duolingo
mitjons	mitjons		Duolingo
mòbil	mobil		Duolingo
mòbils	mobils		Duolingo
modern	modern		Duolingo
moderna	moderna		Duolingo
molt	molt		Duolingo
molt de	molt de		Duolingo
molt de gust	molt de gust		Duolingo
molta	molta		Duolingo
moltes	moltes		Duolingo
moltes gràcies	moltes gracies		Duolingo
molts	molts		Duolingo
moment	moment		Duolingo
món	mon		Duolingo
moneda	moneda		Duolingo
monedes	monedes		Duolingo
mort	mort		Duolingo
moscou	moscou		Duolingo
mossegat	mossegat		Duolingo
mostra	mostra		Duolingo
mostrem	mostrem		Duolingo
mostro	mostro		Duolingo
moto	moto		Duolingo
motor	motor		Duolingo
motors	motors		Duolingo
motos	motos		Duolingo
motxilla	motxilla		Duolingo
motxilles	motxilles		Duolingo
muller	muller		Duolingo
mullers	mullers		Duolingo
múltiple	multiple		Duolingo
múltiples	multiples		Duolingo
mundial	mundial		Duolingo
museu	museu		Duolingo
música	musica		Duolingo
nació	nacio		Duolingo
nacionals	nacionals		Duolingo
nadó	nado		Duolingo
nadons	nadons		Duolingo
naixement	naixement		Duolingo
naixements	naixements		Duolingo
natural	natural		Duolingo
naturalment	naturalment		Duolingo
neboda	neboda		Duolingo
nebodes	nebodes		Duolingo
nebot	nebot		Duolingo
nebots	nebots		Duolingo
necessari	necessari		Duolingo
necessària	necessaria		Duolingo
necessàriament	necessariament		Duolingo
necessàries	necessaries		Duolingo
neda	neda		Duolingo
nedant	nedant		Duolingo
nedem	nedem		Duolingo
neden	neden		Duolingo
nedes	nedes		Duolingo
nedeu	nedeu		Duolingo
nedo	nedo		Duolingo
negra	negra		Duolingo
negre	negre		Duolingo
negres	negres		Duolingo
nen	nen		Duolingo
nena	nena		Duolingo
nenes	nenes		Duolingo
nens	nens		Duolingo
net	net		Duolingo
neta	neta		Duolingo
netejar	netejar		Duolingo
nétes	netes		Duolingo
néts	nets		Duolingo
neva	neva		Duolingo
nevar	nevar		Duolingo
nevera	nevera		Duolingo
ni	ni		Duolingo
ningú	ningu		Duolingo
nit	nit		Duolingo
nivell	nivell		Duolingo
no	no		Duolingo
noi	noi		Duolingo
noia	noia		Duolingo
nombrós	nombros		Duolingo
nombrosa	nombrosa		Duolingo
nombrosos	nombrosos		Duolingo
només	nomes		Duolingo
noranta	noranta		Duolingo
nord	nord		Duolingo
nord-americà	nord-america		Duolingo
normalment	normalment		Duolingo
nosaltres	nosaltres		Duolingo
nostra	nostra		Duolingo
nostre	nostre		Duolingo
nostres	nostres		Duolingo
nota	nota		Duolingo
notes	notes		Duolingo
nou	nou		Duolingo
nova	nova		Duolingo
nova york	nova york		Duolingo
novament	novament		Duolingo
novembre	novembre		Duolingo
noves	noves		Duolingo
número	numero		Duolingo
o	o		Duolingo
obert	obert		Duolingo
obertes	obertes		Duolingo
oberts	oberts		Duolingo
objecte	objecte		Duolingo
objectes	objectes		Duolingo
oblida	oblida		Duolingo
obre	obre		Duolingo
obrir	obrir		Duolingo
obro	obro		Duolingo
ocell	ocell		Duolingo
ocells	ocells		Duolingo
octubre	octubre		Duolingo
oest	oest		Duolingo
ofegava	ofegava		Duolingo
ofegaven	ofegaven		Duolingo
oferir	oferir		Duolingo
oficina	oficina		Duolingo
oficines	oficines		Duolingo
oli	oli		Duolingo
omplim	omplim		Duolingo
omplo	omplo		Duolingo
on	on		Duolingo
oncle	oncle		Duolingo
oncles	oncles		Duolingo
onze	onze		Duolingo
oposició	oposicio		Duolingo
ordinador	ordinador		Duolingo
orientació	orientacio		Duolingo
orientacions	orientacions		Duolingo
ós	os		Duolingo
ou	ou		Duolingo
pa	pa		Duolingo
padrí	padri		Duolingo
padrina	padrina		Duolingo
padrines	padrines		Duolingo
padrins	padrins		Duolingo
paella	paella		Duolingo
paga	paga		Duolingo
pagant	pagant		Duolingo
pagar	pagar		Duolingo
pàgina	pagina		Duolingo
pàgines	pagines		Duolingo
pago	pago		Duolingo
paguem	paguem		Duolingo
pagues	pagues		Duolingo
pagueu	pagueu		Duolingo
país	pais		Duolingo
països	paisos		Duolingo
palau	palau		Duolingo
palaus	palaus		Duolingo
palma	palma		Duolingo
pantalla	pantalla		Duolingo
pantaló	pantalo		Duolingo
pantalons	pantalons		Duolingo
papà	papa		Duolingo
papàs	papas		Duolingo
paper	paper		Duolingo
papers	papers		Duolingo
paraigües	paraigues		Duolingo
paraules	paraules		Duolingo
parc	parc		Duolingo
parcs	parcs		Duolingo
pare	pare		Duolingo
parell	parell		Duolingo
parella	parella		Duolingo
pares	pares		Duolingo
paret	paret		Duolingo
parís	paris		Duolingo
parla	parla		Duolingo
parlant	parlant		Duolingo
parlar	parlar		Duolingo
parlem	parlem		Duolingo
parles	parles		Duolingo
parleu	parleu		Duolingo
parlin	parlin		Duolingo
parlo	parlo		Duolingo
participar	participar		Duolingo
pas	pas		Duolingo
passant	passant		Duolingo
passejar	passejar		Duolingo
pasta	pasta		Duolingo
patata	patata		Duolingo
pati	pati		Duolingo
patir	patir		Duolingo
patit	patit		Duolingo
pàtria	patria		Duolingo
pàtries	patries		Duolingo
peça	peca		Duolingo
peces	peces		Duolingo
peix	peix		Duolingo
peixos	peixos		Duolingo
pel	pel		Duolingo
pel·lícula	pel*licula		Duolingo
pels	pels		Duolingo
pensa	pensa		Duolingo
pensant	pensant		Duolingo
pensar	pensar		Duolingo
pensat	pensat		Duolingo
penso	penso		Duolingo
per	per		Duolingo
per descomptat	per descomptat		Duolingo
per què	per que		Duolingo
perd	perd		Duolingo
perdem	perdem		Duolingo
perden	perden		Duolingo
perdó	perdo		Duolingo
perdre	perdre		Duolingo
perds	perds		Duolingo
perdudes	perdudes		Duolingo
perdut	perdut		Duolingo
perfectament	perfectament		Duolingo
periodista	periodista		Duolingo
periodistes	periodistes		Duolingo
permetre	permetre		Duolingo
però	pero		Duolingo
perpinyà	perpinya		Duolingo
perquè	perque		Duolingo
persona	persona		Duolingo
pescadores	pescadores		Duolingo
pescadors	pescadors		Duolingo
petit	petit		Duolingo
petita	petita		Duolingo
petites	petites		Duolingo
petits	petits		Duolingo
petó	peto		Duolingo
petons	petons		Duolingo
pingüí	pingui		Duolingo
pintora	pintora		Duolingo
pintores	pintores		Duolingo
pintors	pintors		Duolingo
piscina	piscina		Duolingo
pitjor	pitjor		Duolingo
pitjors	pitjors		Duolingo
pla	pla		Duolingo
plaça	placa		Duolingo
places	places		Duolingo
plana	plana		Duolingo
plat	plat		Duolingo
platges	platges		Duolingo
platja	platja		Duolingo
ple	ple		Duolingo
plena	plena		Duolingo
plenes	plenes		Duolingo
plogut	plogut		Duolingo
ploma	ploma		Duolingo
plomes	plomes		Duolingo
plora	plora		Duolingo
plorat	plorat		Duolingo
ploren	ploren		Duolingo
plores	plores		Duolingo
ploreu	ploreu		Duolingo
ploro	ploro		Duolingo
plou	plou		Duolingo
ploure	ploure		Duolingo
plovent	plovent		Duolingo
població	poblacio		Duolingo
poble	poble		Duolingo
pobra	pobra		Duolingo
pobre	pobre		Duolingo
poc	poc		Duolingo
poca	poca		Duolingo
pocs	pocs		Duolingo
podem	podem		Duolingo
poden	poden		Duolingo
podeu	podeu		Duolingo
pogut	pogut		Duolingo
policia	policia		Duolingo
policies	policies		Duolingo
pollastre	pollastre		Duolingo
pols	pols		Duolingo
poma	poma		Duolingo
pomes	pomes		Duolingo
pont	pont		Duolingo
ponts	ponts		Duolingo
poques	poques		Duolingo
por	por		Duolingo
porc	porc		Duolingo
port	port		Duolingo
porta	porta		Duolingo
portar	portar		Duolingo
portat	portat		Duolingo
portem	portem		Duolingo
porten	porten		Duolingo
portes	portes		Duolingo
porteu	porteu		Duolingo
porto	porto		Duolingo
posa	posa		Duolingo
posar	posar		Duolingo
posem	posem		Duolingo
poses	poses		Duolingo
posició	posicio		Duolingo
posicions	posicions		Duolingo
poso	poso		Duolingo
possible	possible		Duolingo
possiblement	possiblement		Duolingo
pot	pot		Duolingo
pots	pots		Duolingo
potser	potser		Duolingo
pràcticament	practicament		Duolingo
pregunta	pregunta		Duolingo
preguntar	preguntar		Duolingo
preguntes	preguntes		Duolingo
premi	premi		Duolingo
prenent	prenent		Duolingo
prepara	prepara		Duolingo
preparar	preparar		Duolingo
pres	pres		Duolingo
presentar	presentar		Duolingo
presó	preso		Duolingo
presons	presons		Duolingo
previst	previst		Duolingo
prim	prim		Duolingo
prima	prima		Duolingo
primavera	primavera		Duolingo
primaveres	primaveres		Duolingo
primer	primer		Duolingo
primes	primes		Duolingo
prims	prims		Duolingo
principalment	principalment		Duolingo
principi	principi		Duolingo
principis	principis		Duolingo
probablement	probablement		Duolingo
problema	problema		Duolingo
produït	produit		Duolingo
professional	professional		Duolingo
professora	professora		Duolingo
professores	professores		Duolingo
professors	professors		Duolingo
promig	promig		Duolingo
prop	prop		Duolingo
propi	propi		Duolingo
pròpia	propia		Duolingo
pròpies	propies		Duolingo
propis	propis		Duolingo
prou	prou		Duolingo
psicòleg	psicoleg		Duolingo
psicòlegs	psicolegs		Duolingo
psicòloga	psicologa		Duolingo
psicòlogues	psicologues		Duolingo
puc	puc		Duolingo
pujar	pujar		Duolingo
qual	qual		Duolingo
qualsevol	qualsevol		Duolingo
qualsevulla	qualsevulla		Duolingo
quan	quan		Duolingo
quant	quant		Duolingo
quanta	quanta		Duolingo
quantes	quantes		Duolingo
quants	quants		Duolingo
quaranta	quaranta		Duolingo
quatre	quatre		Duolingo
què	que		Duolingo
quedar	quedar		Duolingo
quedat	quedat		Duolingo
queixa	queixa		Duolingo
queixem	queixem		Duolingo
queixeu	queixeu		Duolingo
quelcom	quelcom		Duolingo
qüestionar	questionar		Duolingo
qui	qui		Duolingo
quilòmetre	quilometre		Duolingo
química	quimica		Duolingo
quin	quin		Duolingo
quina	quina		Duolingo
quines	quines		Duolingo
quins	quins		Duolingo
quinze	quinze		Duolingo
ràbia	rabia		Duolingo
ràdio	radio		Duolingo
ràdios	radios		Duolingo
ràpid	rapid		Duolingo
ràpida	rapida		Duolingo
ràpidament	rapidament		Duolingo
ràpids	rapids		Duolingo
raspall	raspall		Duolingo
ratolí	ratoli		Duolingo
realitzar	realitzar		Duolingo
realment	realment		Duolingo
rebut	rebut		Duolingo
rebutgem	rebutgem		Duolingo
rebutja	rebutja		Duolingo
rebutjo	rebutjo		Duolingo
recentment	recentment		Duolingo
recepcionista	recepcionista		Duolingo
recepcionistes	recepcionistes		Duolingo
reconèixer	reconeixer		Duolingo
recordar	recordar		Duolingo
recuperar	recuperar		Duolingo
reduir	reduir		Duolingo
refredar	refredar		Duolingo
regalar	regalar		Duolingo
regió	regio		Duolingo
regions	regions		Duolingo
regular	regular		Duolingo
regulars	regulars		Duolingo
rei	rei		Duolingo
reina	reina		Duolingo
reis	reis		Duolingo
relativament	relativament		Duolingo
rellotge	rellotge		Duolingo
rellotges	rellotges		Duolingo
remei	remei		Duolingo
renta	renta		Duolingo
rentadora	rentadora		Duolingo
rentem	rentem		Duolingo
renteu	renteu		Duolingo
rento	rento		Duolingo
reparar	reparar		Duolingo
repeteix	repeteix		Duolingo
repeteixes	repeteixes		Duolingo
repeteixo	repeteixo		Duolingo
repetir	repetir		Duolingo
repetiu	repetiu		Duolingo
res	res		Duolingo
responc	responc		Duolingo
responeu	responeu		Duolingo
resposta	resposta		Duolingo
restaurant	restaurant		Duolingo
revista	revista		Duolingo
revistes	revistes		Duolingo
revolució	revolucio		Duolingo
ric	ric		Duolingo
rica	rica		Duolingo
riem	riem		Duolingo
rieu	rieu		Duolingo
rigut	rigut		Duolingo
riques	riques		Duolingo
riquesa	riquesa		Duolingo
riuen	riuen		Duolingo
rius	rius		Duolingo
roba	roba		Duolingo
roda	roda		Duolingo
rodes	rodes		Duolingo
roma	roma		Duolingo
ruc	ruc		Duolingo
rumb	rumb		Duolingo
rus	rus		Duolingo
rússia	russia		Duolingo
ruta	ruta		Duolingo
rutes	rutes		Duolingo
s'	s'		Duolingo
sabata	sabata		Duolingo
sabater	sabater		Duolingo
sabatera	sabatera		Duolingo
sabateres	sabateres		Duolingo
sabaters	sabaters		Duolingo
sabates	sabates		Duolingo
saben	saben		Duolingo
sabeu	sabeu		Duolingo
sabó	sabo		Duolingo
sabut	sabut		Duolingo
sal	sal		Duolingo
sala d'estar	sala d'estar		Duolingo
salsa	salsa		Duolingo
salva	salva		Duolingo
salven	salven		Duolingo
salvo	salvo		Duolingo
samarreta	samarreta		Duolingo
samarretes	samarretes		Duolingo
sap	sap		Duolingo
saps	saps		Duolingo
secció	seccio		Duolingo
secretari	secretari		Duolingo
secretària	secretaria		Duolingo
secretàries	secretaries		Duolingo
secretaris	secretaris		Duolingo
segle	segle		Duolingo
segles	segles		Duolingo
segon	segon		Duolingo
segons	segons		Duolingo
següent	seguent		Duolingo
següents	seguents		Duolingo
seguint	seguint		Duolingo
segurament	segurament		Duolingo
seixanta	seixanta		Duolingo
sempre	sempre		Duolingo
sense	sense		Duolingo
sent	sent		Duolingo
senten	senten		Duolingo
sentim	sentim		Duolingo
sentir	sentir		Duolingo
sentit	sentit		Duolingo
sentits	sentits		Duolingo
sentiu	sentiu		Duolingo
sento	sento		Duolingo
sents	sents		Duolingo
senyal	senyal		Duolingo
senyor	senyor		Duolingo
senyora	senyora		Duolingo
ser	ser		Duolingo
seriós	serios		Duolingo
seriosa	seriosa		Duolingo
serioses	serioses		Duolingo
seriosos	seriosos		Duolingo
servir	servir		Duolingo
set	set		Duolingo
setanta	setanta		Duolingo
setembre	setembre		Duolingo
setmana	setmana		Duolingo
setmanes	setmanes		Duolingo
seu	seu		Duolingo
seus	seus		Duolingo
seva	seva		Duolingo
seves	seves		Duolingo
sí	si		Duolingo
si us plau	si us plau		Duolingo
signa	signa		Duolingo
signen	signen		Duolingo
signo	signo		Duolingo
siguis	siguis		Duolingo
similar	similar		Duolingo
similars	similars		Duolingo
simplement	simplement		Duolingo
sincera	sincera		Duolingo
sinceres	sinceres		Duolingo
sincers	sincers		Duolingo
sinó	sino		Duolingo
sis	sis		Duolingo
sóc	soc		Duolingo
sofà	sofa		Duolingo
sogre	sogre		Duolingo
sogres	sogres		Duolingo
sola	sola		Duolingo
solament	solament		Duolingo
soldat	soldat		Duolingo
soldats	soldats		Duolingo
sols	sols		Duolingo
solució	solucio		Duolingo
som	som		Duolingo
somriure	somriure		Duolingo
són	son		Duolingo
sopa	sopa		Duolingo
sopar	sopar		Duolingo
sortida	sortida		Duolingo
sortides	sortides		Duolingo
sortir	sortir		Duolingo
sortit	sortit		Duolingo
sostre	sostre		Duolingo
sota	sota		Duolingo
soterrani	soterrani		Duolingo
sou	sou		Duolingo
suc	suc		Duolingo
sucre	sucre		Duolingo
sud	sud		Duolingo
sumar	sumar		Duolingo
superàvit	superavit		Duolingo
superior	superior		Duolingo
surto	surto		Duolingo
t'	t'		Duolingo
tal	tal		Duolingo
talla	talla		Duolingo
tallar	tallar		Duolingo
tallat	tallat		Duolingo
talles	talles		Duolingo
tals	tals		Duolingo
també	tambe		Duolingo
tampoc	tampoc		Duolingo
tan	tan		Duolingo
tanca	tanca		Duolingo
tancar	tancar		Duolingo
tancat	tancat		Duolingo
tanco	tanco		Duolingo
tanquem	tanquem		Duolingo
tanquen	tanquen		Duolingo
tanques	tanques		Duolingo
tant	tant		Duolingo
tant de	tant de		Duolingo
tant de bo	tant de bo		Duolingo
tanta	tanta		Duolingo
tantes	tantes		Duolingo
tants	tants		Duolingo
tard	tard		Duolingo
tardor	tardor		Duolingo
tardors	tardors		Duolingo
targeta	targeta		Duolingo
targetes	targetes		Duolingo
taronja	taronja		Duolingo
tarragona	tarragona		Duolingo
tasca	tasca		Duolingo
tassa	tassa		Duolingo
taula	taula		Duolingo
te	te		Duolingo
telèfon	telefon		Duolingo
telefona	telefona		Duolingo
telefones	telefones		Duolingo
telefono	telefono		Duolingo
televisió	televisio		Duolingo
tema	tema		Duolingo
témer	temer		Duolingo
temes	temes		Duolingo
temporada	temporada		Duolingo
temporades	temporades		Duolingo
temps	temps		Duolingo
tenien	tenien		Duolingo
teníeu	tenieu		Duolingo
tenint	tenint		Duolingo
tenir	tenir		Duolingo
teniu	teniu		Duolingo
tens	tens		Duolingo
tensió	tensio		Duolingo
tercer	tercer		Duolingo
terra	terra		Duolingo
terreny	terreny		Duolingo
terrenys	terrenys		Duolingo
territori	territori		Duolingo
testimoni	testimoni		Duolingo
teu	teu		Duolingo
teus	teus		Duolingo
teva	teva		Duolingo
teves	teves		Duolingo
tia	tia		Duolingo
ties	ties		Duolingo
tinc	tinc		Duolingo
tingueu	tingueu		Duolingo
tipus	tipus		Duolingo
tisores	tisores		Duolingo
títol	titol		Duolingo
toca	toca		Duolingo
tocant	tocant		Duolingo
toco	toco		Duolingo
tomàquet	tomaquet		Duolingo
tona	tona		Duolingo
toquem	toquem		Duolingo
toquen	toquen		Duolingo
toques	toques		Duolingo
toqueu	toqueu		Duolingo
torna	torna		Duolingo
tornar	tornar		Duolingo
tornat	tornat		Duolingo
tornen	tornen		Duolingo
tornes	tornes		Duolingo
torneu	torneu		Duolingo
torno	torno		Duolingo
toro	toro		Duolingo
torre	torre		Duolingo
torres	torres		Duolingo
tortuga	tortuga		Duolingo
tortugues	tortugues		Duolingo
tot	tot		Duolingo
tot i que	tot i que		Duolingo
tot just	tot just		Duolingo
tota	tota		Duolingo
totalment	totalment		Duolingo
totes	totes		Duolingo
totes dues	totes dues		Duolingo
tothom	tothom		Duolingo
tots	tots		Duolingo
tots dos	tots dos		Duolingo
tractant	tractant		Duolingo
tradueix	tradueix		Duolingo
traduïu	traduiu		Duolingo
tranquil	tranquil		Duolingo
tranquil·la	tranquil*la		Duolingo
trànsit	transit		Duolingo
treballa	treballa		Duolingo
treballador	treballador		Duolingo
treballadors	treballadors		Duolingo
treballant	treballant		Duolingo
treballar	treballar		Duolingo
treballava	treballava		Duolingo
treballaven	treballaven		Duolingo
treballen	treballen		Duolingo
treballes	treballes		Duolingo
treballo	treballo		Duolingo
tren	tren		Duolingo
trenca	trenca		Duolingo
trencar	trencar		Duolingo
trenco	trenco		Duolingo
trenquem	trenquem		Duolingo
trenquen	trenquen		Duolingo
trenques	trenques		Duolingo
trens	trens		Duolingo
trenta	trenta		Duolingo
tres	tres		Duolingo
tretze	tretze		Duolingo
triar	triar		Duolingo
troba	troba		Duolingo
trobar	trobar		Duolingo
trobat	trobat		Duolingo
trobem	trobem		Duolingo
trobeu	trobeu		Duolingo
trobo	trobo		Duolingo
trucar	trucar		Duolingo
trucat	trucat		Duolingo
tu	tu		Duolingo
turisme	turisme		Duolingo
ulleres	ulleres		Duolingo
últim	ultim		Duolingo
última	ultima		Duolingo
últimes	ultimes		Duolingo
un	un		Duolingo
un cop d'ull	un cop d'ull		Duolingo
un cop de mà	un cop de ma		Duolingo
una	una		Duolingo
unes	unes		Duolingo
únicament	unicament		Duolingo
universal	universal		Duolingo
universals	universals		Duolingo
universitat	universitat		Duolingo
universitats	universitats		Duolingo
uns	uns		Duolingo
us	us		Duolingo
va	va		Duolingo
vacances	vacances		Duolingo
vagis	vagis		Duolingo
vaig	vaig		Duolingo
vaixell	vaixell		Duolingo
vaixells	vaixells		Duolingo
valència	valencia		Duolingo
vam	vam		Duolingo
van	van		Duolingo
vas	vas		Duolingo
vau	vau		Duolingo
ve	ve		Duolingo
vegada	vegada		Duolingo
vegetarià	vegetaria		Duolingo
vehicle	vehicle		Duolingo
vehicles	vehicles		Duolingo
veí	vei		Duolingo
veient	veient		Duolingo
veig	veig		Duolingo
vell	vell		Duolingo
vella	vella		Duolingo
velles	velles		Duolingo
vencen	vencen		Duolingo
vences	vences		Duolingo
venceu	venceu		Duolingo
vendre	vendre		Duolingo
venedor	venedor		Duolingo
venedora	venedora		Duolingo
venedores	venedores		Duolingo
venedors	venedors		Duolingo
vénen	venen		Duolingo
venir	venir		Duolingo
veniu	veniu		Duolingo
venut	venut		Duolingo
verd	verd		Duolingo
verda	verda		Duolingo
verdes	verdes		Duolingo
verds	verds		Duolingo
verdura	verdura		Duolingo
vermell	vermell		Duolingo
vermella	vermella		Duolingo
vermelles	vermelles		Duolingo
vermells	vermells		Duolingo
vertadera	vertadera		Duolingo
vespre	vespre		Duolingo
vestit	vestit		Duolingo
vestits	vestits		Duolingo
veterinàries	veterinaries		Duolingo
veterinaris	veterinaris		Duolingo
veuen	veuen		Duolingo
veure	veure		Duolingo
veus	veus		Duolingo
vi	vi		Duolingo
viatge	viatge		Duolingo
viatges	viatges		Duolingo
víctima	victima		Duolingo
vila	vila		Duolingo
vinc	vinc		Duolingo
vingut	vingut		Duolingo
vint	vint		Duolingo
virus	virus		Duolingo
viscut	viscut		Duolingo
vist	vist		Duolingo
viu	viu		Duolingo
viure	viure		Duolingo
vivim	vivim		Duolingo
vol	vol		Duolingo
volem	volem		Duolingo
volen	volen		Duolingo
voler	voler		Duolingo
voleu	voleu		Duolingo
volgut	volgut		Duolingo
volíem	voliem		Duolingo
volíeu	volieu		Duolingo
vols	vols		Duolingo
volta	volta		Duolingo
vosaltres	vosaltres		Duolingo
vostra	vostra		Duolingo
vostre	vostre		Duolingo
vostres	vostres		Duolingo
vuit	vuit		Duolingo
vuitanta	vuitanta		Duolingo
vull	vull		Duolingo
xicot	xicot		Duolingo
xicota	xicota		Duolingo
xina	xina		Duolingo
xinès	xines		Duolingo
xofer	xofer		Duolingo
xofers	xofers		Duolingo
zona	zona		Duolingo
zones	zones		Duolingo
