learnable	normalized	partOfSpeech	source
ab	ab		Duolingo
ab	ab	preposition	Duolingo
ab wann	ab wann		Duolingo
abend	abend	noun	Duolingo
abendessen	abendessen	noun	Duolingo
abends	abends	adverb	Duolingo
abenteuer	abenteuer	noun	Duolingo
aber	aber	conjunction	Duolingo
abfahrt	abfahrt	noun	Duolingo
abflug	abflug	noun	Duolingo
abgeben	abgeben		Duolingo
Abgeordnete	abgeordnete	noun	Duolingo
Abgeordneten	abgeordneten	noun	Duolingo
abgeschrieben	abgeschrieben		Duolingo
abgestürzt	abgesturzt	verb	Duolingo
abgewaschen	abgewaschen		Duolingo
abgewaschen	abgewaschen	verb	Duolingo
abhängig	abhangig	adjective	Duolingo
abheben	abheben		Duolingo
abholen	abholen	verb	Duolingo
Abiball	abiball	noun	Duolingo
abitur	abitur	noun	Duolingo
abnehmen	abnehmen		Duolingo
abnehmen	abnehmen	verb	Duolingo
abschluss	abschluss	noun	Duolingo
abteilung	abteilung	noun	Duolingo
abtrocknen	abtrocknen		Duolingo
abwaschen	abwaschen	verb	Duolingo
abzugeben	abzugeben		Duolingo
abzuholen	abzuholen		Duolingo
ach so	ach so		Duolingo
acht	acht	numeral	Duolingo
achthundert	achthundert	numeral	Duolingo
achtunddreißig	achtunddreissig	numeral	Duolingo
achtundsiebzig	achtundsiebzig	numeral	Duolingo
achtundzwanzig	achtundzwanzig	numeral	Duolingo
achtung	achtung		Duolingo
achtzehn	achtzehn	numeral	Duolingo
achtzehnten	achtzehnten	adjective	Duolingo
achtzig	achtzig	numeral	Duolingo
adler	adler	noun	Duolingo
adresse	adresse	noun	Duolingo
adressen	adressen	noun	Duolingo
affe	affe	noun	Duolingo
affen	affen	noun	Duolingo
afrika	afrika	noun	Duolingo
ägypten	agypten	noun	Duolingo
ähnlich	ahnlich	adjective	Duolingo
ähnlichen	ahnlichen	adjective	Duolingo
ahnung	ahnung	noun	Duolingo
akku	akku	noun	Duolingo
akte	akte	noun	Duolingo
akten	akten	noun	Duolingo
aktentasche	aktentasche	noun	Duolingo
aktiv	aktiv	adjective	Duolingo
aktive	aktive	adjective	Duolingo
aktivität	aktivitat	noun	Duolingo
aktivitäten	aktivitaten	noun	Duolingo
aktuelle	aktuelle	adjective	Duolingo
album	album	noun	Duolingo
alkohol	alkohol	noun	Duolingo
alle	alle	determiner	Duolingo
alle	alle	pronoun	Duolingo
allein	allein	adjective	Duolingo
allein	allein	adverb	Duolingo
alleine	alleine	adverb	Duolingo
allen	allen	determiner	Duolingo
aller	aller	determiner	Duolingo
allerdings	allerdings	adverb	Duolingo
allergien	allergien	noun	Duolingo
alles	alles	determiner	Duolingo
alles	alles	pronoun	Duolingo
alles gute	alles gute		Duolingo
alles klar	alles klar		Duolingo
allgemein	allgemein	adjective	Duolingo
alpen	alpen	noun	Duolingo
als	als		Duolingo
als	als	adverb	Duolingo
als	als	conjunction	Duolingo
also	also	adverb	Duolingo
ält	alt		Duolingo
alt	alt	adjective	Duolingo
alte	alte	adjective	Duolingo
alten	alten	adjective	Duolingo
älter	alter		Duolingo
alter	alter	adjective	Duolingo
alter	alter	noun	Duolingo
älteren	alteren	adjective	Duolingo
Altersheim	altersheim	noun	Duolingo
altes	altes	adjective	Duolingo
ältesten	altesten	adjective	Duolingo
ältestes	altestes	adjective	Duolingo
am	am		Duolingo
am	am	preposition	Duolingo
am besten	am besten		Duolingo
am billigsten	am billigsten		Duolingo
am frischsten	am frischsten		Duolingo
am größten	am grossten		Duolingo
am höchsten	am hochsten		Duolingo
am kleinsten	am kleinsten		Duolingo
am nächsten tag	am nachsten tag		Duolingo
am nettesten	am nettesten		Duolingo
am salzigsten	am salzigsten		Duolingo
am schlechtesten	am schlechtesten		Duolingo
am schnellsten	am schnellsten		Duolingo
am see	am see		Duolingo
am strand	am strand		Duolingo
am süßesten	am sussesten		Duolingo
am telefon	am telefon		Duolingo
am teuersten	am teuersten		Duolingo
am wochenende	am wochenende		Duolingo
amerika	amerika	proper noun	Duolingo
amerikaner	amerikaner	noun	Duolingo
amerikanerin	amerikanerin	noun	Duolingo
amerikanischen	amerikanischen	adjective	Duolingo
ampel	ampel	noun	Duolingo
an	an		Duolingo
an	an	adverb	Duolingo
an	an	preposition	Duolingo
an der kasse	an der kasse		Duolingo
ananas	ananas	noun	Duolingo
anbieten	anbieten		Duolingo
andere	andere	determiner	Duolingo
andere	andere	pronoun	Duolingo
anderes	anderes	determiner	Duolingo
anders	anders	adverb	Duolingo
anderthalb	anderthalb	numeral	Duolingo
anfang	anfang	noun	Duolingo
anfangen	anfangen	verb	Duolingo
angefangen	angefangen	adjective	Duolingo
angefangen	angefangen	verb	Duolingo
angekommen	angekommen		Duolingo
angemeldet	angemeldet		Duolingo
angerufen	angerufen	verb	Duolingo
angeschaut	angeschaut	verb	Duolingo
angst	angst	noun	Duolingo
anhang	anhang	noun	Duolingo
Ankunft	ankunft	noun	Duolingo
anmachen	anmachen		Duolingo
anmelden	anmelden		Duolingo
annas	annas	proper noun	Duolingo
annehmen	annehmen		Duolingo
anprobieren	anprobieren	verb	Duolingo
anprobiert	anprobiert		Duolingo
anruf	anruf	noun	Duolingo
anrufbeantworter	anrufbeantworter	noun	Duolingo
anrufen	anrufen	verb	Duolingo
ans	ans	preposition	Duolingo
ansage	ansage	noun	Duolingo
ansonsten	ansonsten	adverb	Duolingo
anstellen	anstellen	verb	Duolingo
anstrengend	anstrengend	adjective	Duolingo
antwort	antwort	noun	Duolingo
antworte	antworte	verb	Duolingo
antworten	antworten	noun	Duolingo
antworten	antworten	verb	Duolingo
antwortest	antwortest	verb	Duolingo
antwortet	antwortet	verb	Duolingo
anwalt	anwalt	noun	Duolingo
anwältin	anwaltin	noun	Duolingo
anweisungen	anweisungen	noun	Duolingo
anzeige	anzeige	noun	Duolingo
anziehen	anziehen	verb	Duolingo
anzug	anzug	noun	Duolingo
anzüge	anzuge	noun	Duolingo
anzukommen	anzukommen		Duolingo
anzurufen	anzurufen		Duolingo
äpfel	apfel	noun	Duolingo
apfelkuchen	apfelkuchen	noun	Duolingo
apfelsaft	apfelsaft	noun	Duolingo
apfelschorle	apfelschorle	noun	Duolingo
apfelstrudel	apfelstrudel	noun	Duolingo
apotheke	apotheke	noun	Duolingo
Aprikose	aprikose	noun	Duolingo
Aprikosen	aprikosen	noun	Duolingo
april	april	noun	Duolingo
arabisch	arabisch	noun	Duolingo
arbeit	arbeit	noun	Duolingo
arbeite	arbeite	verb	Duolingo
arbeiten	arbeiten	verb	Duolingo
arbeiter	arbeiter	noun	Duolingo
arbeitest	arbeitest	verb	Duolingo
arbeitet	arbeitet	verb	Duolingo
arbeitgeber	arbeitgeber	noun	Duolingo
Arbeitserlaubnis	arbeitserlaubnis	noun	Duolingo
arbeitsheft	arbeitsheft	noun	Duolingo
arbeitslos	arbeitslos	adjective	Duolingo
Arbeitslose	arbeitslose	noun	Duolingo
Arbeitsstelle	arbeitsstelle	noun	Duolingo
arbeitszimmer	arbeitszimmer	noun	Duolingo
architektur	architektur	noun	Duolingo
Ärger	arger	noun	Duolingo
ärgerlich	argerlich	adjective	Duolingo
ärm	arm		Duolingo
arm	arm	adjective	Duolingo
arm	arm	noun	Duolingo
armband	armband	noun	Duolingo
arme	arme	noun	Duolingo
armen	armen	adjective	Duolingo
artikel	artikel	noun	Duolingo
arzt	arzt	noun	Duolingo
ärztin	arztin	noun	Duolingo
arzttermin	arzttermin	noun	Duolingo
auch	auch	adverb	Duolingo
auf	auf		Duolingo
auf	auf	preposition	Duolingo
auf dem campus	auf dem campus		Duolingo
auf dem markt	auf dem markt		Duolingo
auf jeden fall	auf jeden fall		Duolingo
auf keinen fall	auf keinen fall		Duolingo
auf wiederhören	auf wiederhoren		Duolingo
auf wiedersehen	auf wiedersehen		Duolingo
Aufgaben	aufgaben	noun	Duolingo
aufgemacht	aufgemacht	verb	Duolingo
aufgepasst	aufgepasst		Duolingo
aufgeräumt	aufgeraumt		Duolingo
aufgeregt	aufgeregt	adjective	Duolingo
aufgestanden	aufgestanden	verb	Duolingo
aufgewachsen	aufgewachsen	verb	Duolingo
aufhören	aufhoren	verb	Duolingo
aufladen	aufladen		Duolingo
aufmachen	aufmachen		Duolingo
aufpassen	aufpassen		Duolingo
aufräumen	aufraumen		Duolingo
aufregen	aufregen		Duolingo
aufregend	aufregend	adjective	Duolingo
aufregender	aufregender	adjective	Duolingo
aufs	aufs	preposition	Duolingo
aufsatz	aufsatz	noun	Duolingo
aufstehe	aufstehe		Duolingo
aufstehen	aufstehen	verb	Duolingo
aufzug	aufzug	noun	Duolingo
auge	auge	noun	Duolingo
augen	augen	noun	Duolingo
august	august	noun	Duolingo
aula	aula	noun	Duolingo
aus	aus		Duolingo
aus	aus	preposition	Duolingo
ausbildung	ausbildung	noun	Duolingo
ausflug	ausflug	noun	Duolingo
ausfüllen	ausfullen	verb	Duolingo
ausgang	ausgang	noun	Duolingo
ausgeben	ausgeben		Duolingo
ausgefüllt	ausgefullt	verb	Duolingo
ausgegangen	ausgegangen	verb	Duolingo
ausgehen	ausgehen	verb	Duolingo
ausgepackt	ausgepackt	verb	Duolingo
ausgestiegen	ausgestiegen		Duolingo
ausgezeichnet	ausgezeichnet	adjective	Duolingo
ausländerbehörde	auslanderbehorde	noun	Duolingo
auspacken	auspacken	verb	Duolingo
ausrede	ausrede	noun	Duolingo
ausreichend	ausreichend	adjective	Duolingo
ausschlafe	ausschlafe		Duolingo
außen	aussen	adverb	Duolingo
außer	ausser	preposition	Duolingo
außerdem	ausserdem	adverb	Duolingo
außerhalb	ausserhalb	preposition	Duolingo
ausstellung	ausstellung	noun	Duolingo
ausverkauft	ausverkauft	adjective	Duolingo
Auswahl	auswahl	noun	Duolingo
ausweis	ausweis	noun	Duolingo
auszugehen	auszugehen		Duolingo
auto	auto	noun	Duolingo
autobahn	autobahn	noun	Duolingo
autofahren	autofahren	noun	Duolingo
automat	automat	noun	Duolingo
automaten	automaten	noun	Duolingo
automatisch	automatisch	adjective	Duolingo
Autoren	autoren	noun	Duolingo
autos	autos	noun	Duolingo
autowerkstatt	autowerkstatt	noun	Duolingo
baby	baby	noun	Duolingo
backen	backen	verb	Duolingo
bäckerei	backerei	noun	Duolingo
bäckerin	backerin	noun	Duolingo
backt	backt	verb	Duolingo
backwaren	backwaren	noun	Duolingo
bad	bad	noun	Duolingo
badeanzug	badeanzug	noun	Duolingo
badehose	badehose	noun	Duolingo
baden-württemberg	baden-wurttemberg		Duolingo
badetuch	badetuch	noun	Duolingo
badewanne	badewanne	noun	Duolingo
badezimmer	badezimmer	noun	Duolingo
bahn	bahn	noun	Duolingo
bahnhof	bahnhof	noun	Duolingo
Bahnsteig	bahnsteig	noun	Duolingo
bald	bald	adverb	Duolingo
balkon	balkon	noun	Duolingo
Ballett	ballett	noun	Duolingo
banane	banane	noun	Duolingo
bananen	bananen	noun	Duolingo
band	band	noun	Duolingo
bank	bank	noun	Duolingo
bankkauffrau	bankkauffrau	noun	Duolingo
bankkaufmann	bankkaufmann	noun	Duolingo
bar	bar	adverb	Duolingo
bär	bar	noun	Duolingo
bären	baren	noun	Duolingo
bargeld	bargeld	noun	Duolingo
bars	bars	noun	Duolingo
bart	bart	noun	Duolingo
basilikum	basilikum	noun	Duolingo
basketball	basketball	noun	Duolingo
basketballspiel	basketballspiel	noun	Duolingo
bauch	bauch	noun	Duolingo
bauchschmerzen	bauchschmerzen	noun	Duolingo
bauer	bauer	noun	Duolingo
bäuerin	bauerin	noun	Duolingo
bauernhof	bauernhof	noun	Duolingo
baum	baum	noun	Duolingo
bäume	baume	noun	Duolingo
baumwolle	baumwolle	noun	Duolingo
bayern	bayern	noun	Duolingo
Bayern München	bayern munchen	proper noun	Duolingo
beamter	beamter	noun	Duolingo
beamtin	beamtin	noun	Duolingo
beantworte	beantworte	verb	Duolingo
beantwortest	beantwortest	verb	Duolingo
beantwortet	beantwortet	verb	Duolingo
becher	becher	noun	Duolingo
bedeutet	bedeutet	verb	Duolingo
begeistert	begeistert	adjective	Duolingo
beginne	beginne	verb	Duolingo
beginnen	beginnen	verb	Duolingo
beginnst	beginnst	verb	Duolingo
beginnt	beginnt	verb	Duolingo
bei	bei	preposition	Duolingo
bei regen	bei regen		Duolingo
bei schlechtem wetter	bei schlechtem wetter		Duolingo
bei schönem wetter	bei schonem wetter		Duolingo
beide	beide	determiner	Duolingo
beide	beide	pronoun	Duolingo
beiden	beiden	determiner	Duolingo
beim	beim	preposition	Duolingo
bein	bein	noun	Duolingo
beinahe	beinahe	adverb	Duolingo
beine	beine	noun	Duolingo
bekannt	bekannt	adjective	Duolingo
bekannten	bekannten	adjective	Duolingo
bekanntere	bekanntere		Duolingo
bekommen	bekommen	verb	Duolingo
bekommst	bekommst	verb	Duolingo
beliebt	beliebt	adjective	Duolingo
benzin	benzin	noun	Duolingo
bequem	bequem	adjective	Duolingo
bereit	bereit	adjective	Duolingo
bereits	bereits	adverb	Duolingo
berg	berg	noun	Duolingo
berge	berge	noun	Duolingo
bergen	bergen	noun	Duolingo
bergsteigen	bergsteigen		Duolingo
berliner	berliner	noun	Duolingo
Berliner	berliner	proper noun	Duolingo
beruf	beruf	noun	Duolingo
beruflich	beruflich	adjective	Duolingo
berühmt	beruhmt	adjective	Duolingo
berühmten	beruhmten	adjective	Duolingo
beschäftigt	beschaftigt	adjective	Duolingo
bescheid	bescheid		Duolingo
beschrieben	beschrieben	verb	Duolingo
beschwert	beschwert	verb	Duolingo
besetzt	besetzt	adjective	Duolingo
besichtigen	besichtigen	verb	Duolingo
besichtigt	besichtigt	verb	Duolingo
besonderen	besonderen	adjective	Duolingo
besonders	besonders	adverb	Duolingo
besser	besser	adjective	Duolingo
best	best		Duolingo
bestanden	bestanden	verb	Duolingo
beste	beste	adjective	Duolingo
beste freundin	beste freundin		Duolingo
bestelle	bestelle	verb	Duolingo
bestellen	bestellen	verb	Duolingo
bestellst	bestellst	verb	Duolingo
bestellt	bestellt	verb	Duolingo
bestellung	bestellung	noun	Duolingo
besten	besten	adjective	Duolingo
bester freund	bester freund		Duolingo
bestimmt	bestimmt	adjective	Duolingo
besuch	besuch	noun	Duolingo
besuchen	besuchen	verb	Duolingo
besuchst	besuchst	verb	Duolingo
besucht	besucht		Duolingo
bett	bett	noun	Duolingo
bettdecke	bettdecke	noun	Duolingo
betten	betten	noun	Duolingo
bettlaken	bettlaken	noun	Duolingo
bevor	bevor	conjunction	Duolingo
bewerbung	bewerbung	noun	Duolingo
bewertungen	bewertungen	noun	Duolingo
bewölkt	bewolkt	adjective	Duolingo
beworben	beworben	verb	Duolingo
bezahle	bezahle	verb	Duolingo
bezahlen	bezahlen	verb	Duolingo
bezahlst	bezahlst	verb	Duolingo
bezahlt	bezahlt	adjective	Duolingo
bezahlt	bezahlt	verb	Duolingo
beziehung	beziehung	noun	Duolingo
beziehungen	beziehungen	noun	Duolingo
bibliothek	bibliothek	noun	Duolingo
biene	biene	noun	Duolingo
bienen	bienen	noun	Duolingo
bier	bier	noun	Duolingo
biergarten	biergarten	noun	Duolingo
bierkrug	bierkrug	noun	Duolingo
bild	bild	noun	Duolingo
bilder	bilder	noun	Duolingo
bildschirm	bildschirm	noun	Duolingo
billig	billig	adjective	Duolingo
billiger	billiger	adjective	Duolingo
bin	bin	verb	Duolingo
biogurken	biogurken	noun	Duolingo
bioladen	bioladen	noun	Duolingo
biologie	biologie	noun	Duolingo
birne	birne	noun	Duolingo
birnen	birnen	noun	Duolingo
bis	bis	conjunction	Duolingo
bis	bis	preposition	Duolingo
bis bald	bis bald		Duolingo
bis morgen	bis morgen		Duolingo
bis später	bis spater		Duolingo
bis wann	bis wann		Duolingo
bis zum	bis zum		Duolingo
bis zum hotel	bis zum hotel		Duolingo
bis zum nächsten mal	bis zum nachsten mal		Duolingo
bisher	bisher	adverb	Duolingo
bisschen	bisschen	determiner	Duolingo
bist	bist	verb	Duolingo
bitte	bitte	adverb	Duolingo
bitte	bitte	interjection	Duolingo
bitte	bitte	noun	Duolingo
bitte schön	bitte schon		Duolingo
blass	blass	adjective	Duolingo
blatt	blatt	noun	Duolingo
blau	blau	adjective	Duolingo
blaue	blaue	adjective	Duolingo
blaues	blaues	adjective	Duolingo
bleistift	bleistift	noun	Duolingo
blick	blick	noun	Duolingo
blond	blond	adjective	Duolingo
blume	blume	noun	Duolingo
blumen	blumen	noun	Duolingo
blumenladen	blumenladen	noun	Duolingo
bluse	bluse	noun	Duolingo
blut	blut	noun	Duolingo
boden	boden	noun	Duolingo
bohnen	bohnen	noun	Duolingo
bond	bond	proper noun	Duolingo
bonus	bonus	noun	Duolingo
boot	boot	noun	Duolingo
bootsfahrt	bootsfahrt	noun	Duolingo
böse	bose	adjective	Duolingo
brandenburger tor	brandenburger tor	proper noun	Duolingo
brauche	brauche	verb	Duolingo
brauchen	brauchen	verb	Duolingo
brauchst	brauchst	verb	Duolingo
braucht	braucht	verb	Duolingo
braun	braun	adjective	Duolingo
braune	braune	adjective	Duolingo
braunen	braunen	adjective	Duolingo
brav	brav	adjective	Duolingo
breit	breit	adjective	Duolingo
brezel	brezel	noun	Duolingo
brief	brief	noun	Duolingo
briefmarke	briefmarke	noun	Duolingo
briefmarken	briefmarken	noun	Duolingo
brieftasche	brieftasche	noun	Duolingo
briefumschlag	briefumschlag	noun	Duolingo
brille	brille	noun	Duolingo
bring	bring		Duolingo
bring	bring	verb	Duolingo
bringe	bringe	verb	Duolingo
bringen	bringen		Duolingo
bringen	bringen	verb	Duolingo
bringst	bringst	verb	Duolingo
bringt	bringt	verb	Duolingo
brot	brot	noun	Duolingo
brötchen	brotchen	noun	Duolingo
brücke	brucke	noun	Duolingo
brücken	brucken	noun	Duolingo
brüder	bruder	noun	Duolingo
brüdern	brudern	noun	Duolingo
brunnen	brunnen	noun	Duolingo
buch	buch	noun	Duolingo
bücher	bucher	noun	Duolingo
bücherei	bucherei	noun	Duolingo
bücherregal	bucherregal	noun	Duolingo
buchladen	buchladen	noun	Duolingo
bühne	buhne	noun	Duolingo
bundesland	bundesland	noun	Duolingo
bundesländer	bundeslander	noun	Duolingo
Bundesländern	bundeslandern	noun	Duolingo
Bundestag	bundestag	noun	Duolingo
bunt	bunt	adjective	Duolingo
Burg	burg	noun	Duolingo
burger	burger	noun	Duolingo
bürgerbüro	burgerburo	noun	Duolingo
büro	buro	noun	Duolingo
büros	buros	noun	Duolingo
Bürste	burste	noun	Duolingo
bus	bus	noun	Duolingo
bushaltestelle	bushaltestelle	noun	Duolingo
busse	busse	noun	Duolingo
butter	butter	noun	Duolingo
bwl	bwl	noun	Duolingo
café	cafe	noun	Duolingo
Café central	cafe central	proper noun	Duolingo
cafés	cafes	noun	Duolingo
campe	campe	verb	Duolingo
campen	campen	verb	Duolingo
campingplatz	campingplatz	noun	Duolingo
campt	campt	verb	Duolingo
campus	campus	noun	Duolingo
cent	cent	noun	Duolingo
chef	chef	noun	Duolingo
chefin	chefin	noun	Duolingo
chemie	chemie	noun	Duolingo
china	china	noun	Duolingo
chinesisch	chinesisch	noun	Duolingo
chor	chor	noun	Duolingo
circa	circa	adverb	Duolingo
clown	clown	noun	Duolingo
club	club	noun	Duolingo
cola	cola	noun	Duolingo
comics	comics	noun	Duolingo
computer	computer	noun	Duolingo
Computerraum	computerraum	noun	Duolingo
cool	cool	adjective	Duolingo
coolen	coolen	adjective	Duolingo
cooler	cooler	adjective	Duolingo
coolsten	coolsten	adjective	Duolingo
couch	couch	noun	Duolingo
cousin	cousin	noun	Duolingo
cousine	cousine	noun	Duolingo
Croissant	croissant	noun	Duolingo
currywurst	currywurst	noun	Duolingo
da	da	adverb	Duolingo
da	da	conjunction	Duolingo
da drüben	da druben	adverb	Duolingo
dabei	dabei	adverb	Duolingo
dach	dach	noun	Duolingo
dadurch	dadurch	adverb	Duolingo
dafür	dafur	adverb	Duolingo
dagegen	dagegen	adverb	Duolingo
daher	daher	adverb	Duolingo
damals	damals	adverb	Duolingo
dame	dame	noun	Duolingo
damen	damen	noun	Duolingo
damit	damit	adverb	Duolingo
damit	damit	conjunction	Duolingo
danach	danach	adverb	Duolingo
daneben	daneben	adverb	Duolingo
dänemark	danemark	noun	Duolingo
danke	danke	interjection	Duolingo
danke schön	danke schon		Duolingo
dann	dann	adverb	Duolingo
daran	daran	adverb	Duolingo
darauf	darauf	adverb	Duolingo
darf	darf	verb	Duolingo
darfst	darfst	verb	Duolingo
darin	darin	adverb	Duolingo
darüber	daruber	adverb	Duolingo
darum	darum	adverb	Duolingo
das	das		Duolingo
das	das	determiner	Duolingo
das	das	pronoun	Duolingo
das alte auto	das alte auto		Duolingo
das geht	das geht		Duolingo
das gleiche	das gleiche		Duolingo
das heißt	das heisst		Duolingo
das macht	das macht		Duolingo
das macht dann	das macht dann		Duolingo
das macht nichts	das macht nichts		Duolingo
das tut	das tut		Duolingo
das wäre alles	das ware alles		Duolingo
dass	dass	conjunction	Duolingo
datum	datum	noun	Duolingo
dauert	dauert	verb	Duolingo
davon	davon	adverb	Duolingo
dazu	dazu	adverb	Duolingo
decke	decke	noun	Duolingo
dein	dein		Duolingo
dein	dein	determiner	Duolingo
dein	dein	pronoun	Duolingo
deine	deine		Duolingo
deine	deine	determiner	Duolingo
deine	deine	pronoun	Duolingo
deinem	deinem	determiner	Duolingo
deinen	deinen	determiner	Duolingo
deinen	deinen	pronoun	Duolingo
deiner	deiner	determiner	Duolingo
dem	dem		Duolingo
dem	dem	determiner	Duolingo
demnächst	demnachst	adverb	Duolingo
Demokratie	demokratie	noun	Duolingo
den	den		Duolingo
den	den	determiner	Duolingo
den	den	pronoun	Duolingo
den ganzen tag	den ganzen tag		Duolingo
denen	denen		Duolingo
denke	denke	verb	Duolingo
denken	denken	verb	Duolingo
Denkmal	denkmal	noun	Duolingo
denkst	denkst	verb	Duolingo
denkt	denkt	verb	Duolingo
denn	denn	adverb	Duolingo
denn	denn	conjunction	Duolingo
dennoch	dennoch	adverb	Duolingo
der	der		Duolingo
der	der	determiner	Duolingo
der	der	pronoun	Duolingo
der welt	der welt		Duolingo
deren	deren		Duolingo
deren	deren	determiner	Duolingo
derzeit	derzeit	adverb	Duolingo
des	des	determiner	Duolingo
deshalb	deshalb	adverb	Duolingo
design	design	noun	Duolingo
dessen	dessen		Duolingo
desto	desto	conjunction	Duolingo
deswegen	deswegen	adverb	Duolingo
detaillierte	detaillierte	adjective	Duolingo
deutlich	deutlich	adjective	Duolingo
deutsch	deutsch	noun	Duolingo
deutsche	deutsche	adjective	Duolingo
deutsche	deutsche	noun	Duolingo
deutschen	deutschen	adjective	Duolingo
deutschen	deutschen	noun	Duolingo
deutscher	deutscher	noun	Duolingo
deutschland	deutschland	proper noun	Duolingo
Deutschlands	deutschlands	proper noun	Duolingo
dezember	dezember	noun	Duolingo
Dialog	dialog	noun	Duolingo
dich	dich	pronoun	Duolingo
dick	dick	adjective	Duolingo
die	die		Duolingo
die	die	determiner	Duolingo
die	die	pronoun	Duolingo
die ganze nacht	die ganze nacht		Duolingo
die ganze zeit	die ganze zeit		Duolingo
die vereinigten staaten	die vereinigten staaten	proper noun	Duolingo
dienstag	dienstag	noun	Duolingo
dies	dies	pronoun	Duolingo
diese	diese	determiner	Duolingo
diese	diese	pronoun	Duolingo
diesem	diesem	determiner	Duolingo
diesem	diesem	pronoun	Duolingo
diesen	diesen		Duolingo
diesen	diesen	determiner	Duolingo
diesen	diesen	pronoun	Duolingo
dieser	dieser	determiner	Duolingo
dieser	dieser	pronoun	Duolingo
dieses	dieses	determiner	Duolingo
dieses	dieses	pronoun	Duolingo
dieses jahr	dieses jahr		Duolingo
dir	dir	pronoun	Duolingo
direkt	direkt	adverb	Duolingo
Diskussion	diskussion	noun	Duolingo
diskutiert	diskutiert		Duolingo
doch	doch		Duolingo
doch	doch	conjunction	Duolingo
dokufilme	dokufilme	noun	Duolingo
dokument	dokument	noun	Duolingo
dokumente	dokumente	noun	Duolingo
dollar	dollar	noun	Duolingo
dom	dom	noun	Duolingo
döner	doner	noun	Duolingo
donnerstag	donnerstag	noun	Duolingo
doppelzimmer	doppelzimmer	noun	Duolingo
dorf	dorf	noun	Duolingo
dort	dort	adverb	Duolingo
dose	dose	noun	Duolingo
dosen	dosen	noun	Duolingo
drache	drache	noun	Duolingo
drachen	drachen	noun	Duolingo
dran	dran		Duolingo
dran	dran	adverb	Duolingo
draußen	draussen	adverb	Duolingo
drei	drei	numeral	Duolingo
dreißig	dreissig	numeral	Duolingo
dreitausend	dreitausend	numeral	Duolingo
dreiundzwanzig	dreiundzwanzig	numeral	Duolingo
dreizehn	dreizehn	numeral	Duolingo
drin	drin	adverb	Duolingo
dringend	dringend	adjective	Duolingo
drinnen	drinnen	adverb	Duolingo
dritten	dritten	adjective	Duolingo
drogeriemarkt	drogeriemarkt	noun	Duolingo
drüben	druben	adverb	Duolingo
drucker	drucker	noun	Duolingo
du	du	pronoun	Duolingo
dümm	dumm		Duolingo
dumm	dumm	adjective	Duolingo
dunkel	dunkel	adjective	Duolingo
dunkler	dunkler	adjective	Duolingo
dunkles	dunkles	adjective	Duolingo
dünn	dunn	adjective	Duolingo
durch	durch	preposition	Duolingo
durchaus	durchaus	adverb	Duolingo
durcheinander	durcheinander	adverb	Duolingo
durchstellen	durchstellen		Duolingo
durchwahlnummer	durchwahlnummer	noun	Duolingo
dürfen	durfen	verb	Duolingo
durst	durst	noun	Duolingo
dusche	dusche	noun	Duolingo
e	e		Duolingo
e-mail	e-mail	noun	Duolingo
e-mail-adresse	e-mail-adresse	noun	Duolingo
e-mails	e-mails	noun	Duolingo
ebenfalls	ebenfalls	adverb	Duolingo
ebenso	ebenso	adverb	Duolingo
ec-karte	ec-karte	noun	Duolingo
echt	echt	adjective	Duolingo
echt	echt	adverb	Duolingo
echte	echte	adjective	Duolingo
echter	echter	adjective	Duolingo
echtes	echtes	adjective	Duolingo
ecke	ecke	noun	Duolingo
edelstahl	edelstahl	noun	Duolingo
egal	egal		Duolingo
egal	egal	adjective	Duolingo
ehefrau	ehefrau	noun	Duolingo
ehemalige	ehemalige	adjective	Duolingo
ehemaligen	ehemaligen	adjective	Duolingo
ehemann	ehemann	noun	Duolingo
eher	eher	adverb	Duolingo
ehrenamtlich	ehrenamtlich	adjective	Duolingo
ehrlich	ehrlich	adjective	Duolingo
ei	ei	noun	Duolingo
Eidechse	eidechse	noun	Duolingo
eier	eier	noun	Duolingo
eigene	eigene	adjective	Duolingo
eigenen	eigenen	adjective	Duolingo
eigener	eigener	adjective	Duolingo
eigenes	eigenes	adjective	Duolingo
eigentlich	eigentlich	adverb	Duolingo
eilig	eilig	adjective	Duolingo
ein	ein		Duolingo
ein	ein	determiner	Duolingo
ein	ein	numeral	Duolingo
ein bisschen	ein bisschen		Duolingo
ein bisschen	ein bisschen	adverb	Duolingo
ein hemd	ein hemd	noun	Duolingo
ein kleid	ein kleid	noun	Duolingo
ein paar	ein paar	adverb	Duolingo
ein sakko	ein sakko	noun	Duolingo
einander	einander	pronoun	Duolingo
einchecken	einchecken		Duolingo
eindeutig	eindeutig	adjective	Duolingo
eine	eine	determiner	Duolingo
eineinhalb	eineinhalb	numeral	Duolingo
einem	einem	determiner	Duolingo
einen	einen	determiner	Duolingo
einen augenblick	einen augenblick		Duolingo
einen schönen tag noch	einen schonen tag noch		Duolingo
einer	einer	determiner	Duolingo
eines	eines	determiner	Duolingo
eines tages	eines tages		Duolingo
einfach	einfach		Duolingo
einfach	einfach	adjective	Duolingo
einfache	einfache	adjective	Duolingo
einfachen	einfachen	adjective	Duolingo
einfacher	einfacher	adjective	Duolingo
eingang	eingang	noun	Duolingo
eingebrochen	eingebrochen		Duolingo
eingekauft	eingekauft		Duolingo
eingeladen	eingeladen	adjective	Duolingo
eingeladen	eingeladen	verb	Duolingo
eingeloggt	eingeloggt		Duolingo
eingepackt	eingepackt	verb	Duolingo
eingezogen	eingezogen	verb	Duolingo
einhalten	einhalten		Duolingo
einheimische	einheimische	adjective	Duolingo
einhundert	einhundert	numeral	Duolingo
einigen	einigen	determiner	Duolingo
einiger	einiger	determiner	Duolingo
einkaufen	einkaufen	verb	Duolingo
einkaufszentrum	einkaufszentrum	noun	Duolingo
einkaufszettel	einkaufszettel	noun	Duolingo
einladung	einladung	noun	Duolingo
einlösen	einlosen		Duolingo
einmal	einmal	adverb	Duolingo
Eins	eins	noun	Duolingo
eins	eins	numeral	Duolingo
einschließlich	einschliesslich	preposition	Duolingo
einstein	einstein	proper noun	Duolingo
Eintritt	eintritt	noun	Duolingo
eintrittskarte	eintrittskarte	noun	Duolingo
eintrittskarten	eintrittskarten	noun	Duolingo
einundzwanzig	einundzwanzig	numeral	Duolingo
einverstanden	einverstanden	adjective	Duolingo
einverstanden	einverstanden	verb	Duolingo
einweihungsparty	einweihungsparty	noun	Duolingo
einwohner	einwohner	noun	Duolingo
einwohnern	einwohnern	noun	Duolingo
einzahlen	einzahlen		Duolingo
einzelnen	einzelnen	adjective	Duolingo
einzelzimmer	einzelzimmer	noun	Duolingo
einzige	einzige	adjective	Duolingo
Einzimmerwohnung	einzimmerwohnung	noun	Duolingo
eis	eis		Duolingo
eis	eis	noun	Duolingo
eiskaffee	eiskaffee	noun	Duolingo
eislaufe	eislaufe		Duolingo
eisläufst	eislaufst		Duolingo
eisläuft	eislauft		Duolingo
elefant	elefant	noun	Duolingo
Elefanten	elefanten	noun	Duolingo
elegant	elegant	adjective	Duolingo
elektroladen	elektroladen	noun	Duolingo
elf	elf	numeral	Duolingo
elften	elften	adjective	Duolingo
eltern	eltern	noun	Duolingo
emma	emma	proper noun	Duolingo
empfohlen	empfohlen	verb	Duolingo
en	en		Duolingo
ende	ende	noun	Duolingo
endet	endet	verb	Duolingo
endlich	endlich	adverb	Duolingo
eng	eng	adjective	Duolingo
englisch	englisch	noun	Duolingo
englische	englische	adjective	Duolingo
enkel	enkel	noun	Duolingo
enkelin	enkelin	noun	Duolingo
ente	ente	noun	Duolingo
enten	enten	noun	Duolingo
enthalten	enthalten	adjective	Duolingo
entlang	entlang	preposition	Duolingo
entschieden	entschieden	verb	Duolingo
entschuldigen sie	entschuldigen sie		Duolingo
entschuldigen sie bitte	entschuldigen sie bitte		Duolingo
entschuldigung	entschuldigung	interjection	Duolingo
entschuldigung	entschuldigung	noun	Duolingo
entstehen	entstehen	verb	Duolingo
enttäuscht	enttauscht	adjective	Duolingo
entweder	entweder	conjunction	Duolingo
er	er		Duolingo
er	er	pronoun	Duolingo
erdbeere	erdbeere	noun	Duolingo
erdbeeren	erdbeeren	noun	Duolingo
erde	erde	noun	Duolingo
erdkunde	erdkunde	noun	Duolingo
erfahrung	erfahrung	noun	Duolingo
erfolgreich	erfolgreich	adjective	Duolingo
erfunden	erfunden	verb	Duolingo
erhalten	erhalten	verb	Duolingo
erholt	erholt	verb	Duolingo
erholung	erholung	noun	Duolingo
Erinnerungen	erinnerungen	noun	Duolingo
erkältung	erkaltung	noun	Duolingo
erkannt	erkannt	verb	Duolingo
erlässt	erlasst	verb	Duolingo
erlaubt	erlaubt	adjective	Duolingo
erlaubt	erlaubt	verb	Duolingo
erleichtert	erleichtert	adjective	Duolingo
ermäßigung	ermassigung	noun	Duolingo
erneut	erneut	adjective	Duolingo
eröffnen	eroffnen	verb	Duolingo
erreicht	erreicht	verb	Duolingo
erst	erst	adverb	Duolingo
ersten	ersten	adjective	Duolingo
erstens	erstens	adverb	Duolingo
erwachsene	erwachsene	noun	Duolingo
erwähnt	erwahnt	verb	Duolingo
erzählt	erzahlt	verb	Duolingo
es	es		Duolingo
es	es	pronoun	Duolingo
es geht	es geht		Duolingo
es gibt	es gibt		Duolingo
es tut mir leid	es tut mir leid		Duolingo
es wäre	es ware		Duolingo
esse	esse	verb	Duolingo
essen	essen	noun	Duolingo
essen	essen	verb	Duolingo
essig	essig	noun	Duolingo
esst	esst	verb	Duolingo
esszimmer	esszimmer	noun	Duolingo
etwa	etwa	adverb	Duolingo
etwas	etwas	pronoun	Duolingo
euch	euch	determiner	Duolingo
euch	euch	pronoun	Duolingo
euer	euer	determiner	Duolingo
euer	euer	pronoun	Duolingo
eule	eule	noun	Duolingo
eulen	eulen	noun	Duolingo
eure	eure	determiner	Duolingo
eure	eure	pronoun	Duolingo
eurem	eurem	determiner	Duolingo
euren	euren	determiner	Duolingo
euren	euren	pronoun	Duolingo
eurer	eurer	determiner	Duolingo
euro	euro	noun	Duolingo
europa	europa	noun	Duolingo
europäisch	europaisch	adjective	Duolingo
europäischen	europaischen	adjective	Duolingo
exotische	exotische	adjective	Duolingo
experiment	experiment	noun	Duolingo
externe	externe	adjective	Duolingo
externer	externer	adjective	Duolingo
extra	extra		Duolingo
extrem	extrem	adjective	Duolingo
fach	fach	noun	Duolingo
fahr	fahr	verb	Duolingo
fahre	fahre	verb	Duolingo
fahren	fahren	verb	Duolingo
fahrkarte	fahrkarte	noun	Duolingo
fahrkarten	fahrkarten	noun	Duolingo
fahrplan	fahrplan	noun	Duolingo
fahrrad	fahrrad	noun	Duolingo
fahrräder	fahrrader	noun	Duolingo
fahrradfahren	fahrradfahren	noun	Duolingo
fahrradhelm	fahrradhelm	noun	Duolingo
fahrschein	fahrschein	noun	Duolingo
fährst	fahrst	verb	Duolingo
fahrt	fahrt	noun	Duolingo
fährt	fahrt	verb	Duolingo
fair	fair	adjective	Duolingo
fallen	fallen	verb	Duolingo
fällig	fallig	adjective	Duolingo
falls	falls	conjunction	Duolingo
fallschirmspringen	fallschirmspringen	noun	Duolingo
fällt	fallt	verb	Duolingo
falsch	falsch	adjective	Duolingo
familie	familie	noun	Duolingo
familien	familien	noun	Duolingo
familienstand	familienstand		Duolingo
fand	fand	verb	Duolingo
fandest	fandest	verb	Duolingo
fantastisch	fantastisch	adjective	Duolingo
farbe	farbe	noun	Duolingo
farben	farben	noun	Duolingo
farbstifte	farbstifte	noun	Duolingo
fast	fast	adverb	Duolingo
faul	faul	adjective	Duolingo
februar	februar	noun	Duolingo
federball	federball	noun	Duolingo
federn	federn	noun	Duolingo
fehler	fehler	noun	Duolingo
feierabend	feierabend	noun	Duolingo
feiern	feiern	verb	Duolingo
feierst	feierst	verb	Duolingo
feiert	feiert	verb	Duolingo
feiertag	feiertag	noun	Duolingo
fell	fell	noun	Duolingo
fenster	fenster	noun	Duolingo
ferien	ferien	noun	Duolingo
ferkel	ferkel	noun	Duolingo
fern	fern		Duolingo
fern	fern	adjective	Duolingo
Fernbedienung	fernbedienung	noun	Duolingo
fernsehen	fernsehen	noun	Duolingo
fernsehen	fernsehen	verb	Duolingo
fernseher	fernseher	noun	Duolingo
Fernsehserie	fernsehserie	noun	Duolingo
fernsehserien	fernsehserien	noun	Duolingo
fertig	fertig	adjective	Duolingo
fest	fest	adjective	Duolingo
fest	fest	noun	Duolingo
fettarme	fettarme	adjective	Duolingo
feuer	feuer	noun	Duolingo
feuerwehr	feuerwehr	noun	Duolingo
feuerwerk	feuerwerk	noun	Duolingo
fieber	fieber	noun	Duolingo
figur	figur	noun	Duolingo
figuren	figuren	noun	Duolingo
film	film	noun	Duolingo
filme	filme		Duolingo
filmen	filmen	noun	Duolingo
filmstar	filmstar	noun	Duolingo
finden	finden	verb	Duolingo
finger	finger	noun	Duolingo
firma	firma	noun	Duolingo
fisch	fisch	noun	Duolingo
fische	fische	noun	Duolingo
fische	fische	verb	Duolingo
fischen	fischen	verb	Duolingo
fischt	fischt	verb	Duolingo
fit	fit	adjective	Duolingo
fitnessstudio	fitnessstudio	noun	Duolingo
fix und fertig	fix und fertig		Duolingo
flamingos	flamingos	noun	Duolingo
flasche	flasche	noun	Duolingo
flaschen	flaschen	noun	Duolingo
Flecken	flecken	noun	Duolingo
fleisch	fleisch	noun	Duolingo
fliege	fliege	noun	Duolingo
fliegst	fliegst	verb	Duolingo
fliegt	fliegt	verb	Duolingo
fließend	fliessend	adjective	Duolingo
flohmarkt	flohmarkt	noun	Duolingo
flug	flug	noun	Duolingo
fluggesellschaft	fluggesellschaft	noun	Duolingo
flughafen	flughafen	noun	Duolingo
flugnummer	flugnummer	noun	Duolingo
flugzeug	flugzeug	noun	Duolingo
fluss	fluss	noun	Duolingo
flüsse	flusse	noun	Duolingo
folge	folge	noun	Duolingo
folgen	folgen	noun	Duolingo
formular	formular	noun	Duolingo
formulare	formulare	noun	Duolingo
fortsetzung	fortsetzung	noun	Duolingo
foto	foto	noun	Duolingo
fotoalbum	fotoalbum	noun	Duolingo
Fotoapparat	fotoapparat	noun	Duolingo
fotografiere	fotografiere	verb	Duolingo
fotografierst	fotografierst	verb	Duolingo
fotografiert	fotografiert	verb	Duolingo
fotos	fotos	noun	Duolingo
frage	frage	noun	Duolingo
fragen	fragen	noun	Duolingo
fragst	fragst	verb	Duolingo
frankreich	frankreich	proper noun	Duolingo
franz	franz	proper noun	Duolingo
französisch	franzosisch	noun	Duolingo
französische	franzosische	adjective	Duolingo
frau	frau		Duolingo
frau	frau	noun	Duolingo
frau schmidts	frau schmidts		Duolingo
frauen	frauen	noun	Duolingo
frechen	frechen	adjective	Duolingo
frei	frei	adjective	Duolingo
frei	frei	adverb	Duolingo
freiburg	freiburg	proper noun	Duolingo
freien	freien	adjective	Duolingo
freitag	freitag	noun	Duolingo
freitags	freitags	adverb	Duolingo
Freiwillige	freiwillige	noun	Duolingo
freizeit	freizeit	noun	Duolingo
fressen	fressen	verb	Duolingo
freund	freund	noun	Duolingo
freunde	freunde	noun	Duolingo
freunden	freunden	noun	Duolingo
freundin	freundin	noun	Duolingo
freundinnen	freundinnen	noun	Duolingo
freundlich	freundlich	adjective	Duolingo
freundlichen	freundlichen	adjective	Duolingo
freut mich	freut mich		Duolingo
frikadellen	frikadellen	noun	Duolingo
frisch	frisch	adjective	Duolingo
frischem	frischem	adjective	Duolingo
frischen	frischen	adjective	Duolingo
frischer	frischer	adjective	Duolingo
friseur	friseur	noun	Duolingo
friseurin	friseurin	noun	Duolingo
frisst	frisst	verb	Duolingo
froh	froh	adjective	Duolingo
frosch	frosch	noun	Duolingo
froschkönig	froschkonig	noun	Duolingo
früh	fruh	adjective	Duolingo
früher	fruher	adjective	Duolingo
früher	fruher	adverb	Duolingo
frühling	fruhling	noun	Duolingo
frühstück	fruhstuck	noun	Duolingo
frühstücke	fruhstucke	verb	Duolingo
frühstücken	fruhstucken	verb	Duolingo
frühstücksflocken	fruhstucksflocken	noun	Duolingo
frühstückst	fruhstuckst	verb	Duolingo
frühstückt	fruhstuckt	verb	Duolingo
fuchs	fuchs	noun	Duolingo
führerschein	fuhrerschein	noun	Duolingo
füllung	fullung	noun	Duolingo
fünf	funf	numeral	Duolingo
fünftausend	funftausend	numeral	Duolingo
fünfunddreißig	funfunddreissig	numeral	Duolingo
fünfundvierzig	funfundvierzig	numeral	Duolingo
fünfundzwanzig	funfundzwanzig	numeral	Duolingo
fünfzehn	funfzehn	numeral	Duolingo
fünfzig	funfzig	numeral	Duolingo
funktioniert	funktioniert	verb	Duolingo
für	fur		Duolingo
für	fur	preposition	Duolingo
für wie lange	fur wie lange		Duolingo
fürs	furs	preposition	Duolingo
fuß	fuss	noun	Duolingo
fußball	fussball	noun	Duolingo
fußballspiel	fussballspiel	noun	Duolingo
fußballspielen	fussballspielen	noun	Duolingo
fußballtraining	fussballtraining	noun	Duolingo
Futter	futter	noun	Duolingo
gab	gab		Duolingo
gabel	gabel	noun	Duolingo
gabeln	gabeln	noun	Duolingo
Galerie	galerie	noun	Duolingo
gans	gans	noun	Duolingo
ganz	ganz	adverb	Duolingo
ganz bestimmt	ganz bestimmt		Duolingo
ganzen	ganzen	adjective	Duolingo
ganzen familie	ganzen familie		Duolingo
gar	gar	adverb	Duolingo
gar nicht	gar nicht		Duolingo
garage	garage	noun	Duolingo
garten	garten	noun	Duolingo
gassi	gassi		Duolingo
gast	gast	noun	Duolingo
gäste	gaste	noun	Duolingo
gearbeitet	gearbeitet	verb	Duolingo
geärgert	geargert	verb	Duolingo
Gebäck	geback	noun	Duolingo
gebäude	gebaude	noun	Duolingo
gebaut	gebaut		Duolingo
gebaut	gebaut	verb	Duolingo
geben	geben		Duolingo
geben	geben	verb	Duolingo
geblieben	geblieben		Duolingo
geboren	geboren	verb	Duolingo
gebracht	gebracht	verb	Duolingo
gebrochen	gebrochen	adjective	Duolingo
gebrochen	gebrochen	verb	Duolingo
gebühr	gebuhr	noun	Duolingo
Geburt	geburt	noun	Duolingo
geburtsjahr	geburtsjahr	noun	Duolingo
geburtsort	geburtsort	noun	Duolingo
geburtstag	geburtstag	noun	Duolingo
geburtstagskarte	geburtstagskarte	noun	Duolingo
gecampt	gecampt	verb	Duolingo
gedauert	gedauert	verb	Duolingo
gedicht	gedicht	noun	Duolingo
gedichte	gedichte	noun	Duolingo
gefahren	gefahren	verb	Duolingo
gefährlich	gefahrlich	adjective	Duolingo
gefährlicher	gefahrlicher	adjective	Duolingo
gefallen	gefallen	verb	Duolingo
gefällt	gefallt	verb	Duolingo
gefangen	gefangen	verb	Duolingo
gefasst	gefasst	verb	Duolingo
gefeiert	gefeiert	verb	Duolingo
geflogen	geflogen	verb	Duolingo
gefolgt	gefolgt	verb	Duolingo
gefreut	gefreut	verb	Duolingo
gefühlt	gefuhlt	verb	Duolingo
gefunden	gefunden	verb	Duolingo
gefüttert	gefuttert	verb	Duolingo
gegangen	gegangen	verb	Duolingo
gegeben	gegeben		Duolingo
gegen	gegen	adverb	Duolingo
gegen	gegen	preposition	Duolingo
gegend	gegend	noun	Duolingo
gegenüber	gegenuber	preposition	Duolingo
gegessen	gegessen	verb	Duolingo
gegrillt	gegrillt	verb	Duolingo
gegrilltem	gegrilltem	adjective	Duolingo
geh	geh	verb	Duolingo
gehalten	gehalten	verb	Duolingo
gehasst	gehasst		Duolingo
gehe	gehe	verb	Duolingo
geheimzahl	geheimzahl	noun	Duolingo
geheiratet	geheiratet	verb	Duolingo
gehen	gehen		Duolingo
gehen	gehen	verb	Duolingo
gehen wir	gehen wir		Duolingo
gehört	gehort	verb	Duolingo
gehst	gehst	verb	Duolingo
geht	geht	verb	Duolingo
geht es	geht es		Duolingo
geht's	geht's		Duolingo
geige	geige	noun	Duolingo
gejubelt	gejubelt	verb	Duolingo
gekauft	gekauft	verb	Duolingo
geklickt	geklickt	verb	Duolingo
gekocht	gekocht	verb	Duolingo
gekommen	gekommen	verb	Duolingo
gekostet	gekostet	verb	Duolingo
gekündigt	gekundigt	verb	Duolingo
gelacht	gelacht	verb	Duolingo
gelassen	gelassen	verb	Duolingo
gelaufen	gelaufen	verb	Duolingo
gelb	gelb	adjective	Duolingo
gelbe	gelbe	adjective	Duolingo
gelben	gelben	adjective	Duolingo
gelber	gelber	adjective	Duolingo
geld	geld	noun	Duolingo
geldautomat	geldautomat	noun	Duolingo
geldautomaten	geldautomaten		Duolingo
geldbeutel	geldbeutel	noun	Duolingo
geldstrafe	geldstrafe	noun	Duolingo
gelebt	gelebt	verb	Duolingo
gelernt	gelernt	verb	Duolingo
gelesen	gelesen		Duolingo
gelogen	gelogen	verb	Duolingo
gemacht	gemacht	verb	Duolingo
gemalt	gemalt		Duolingo
gemalt	gemalt	verb	Duolingo
gemein	gemein	adjective	Duolingo
gemeinsam	gemeinsam	adjective	Duolingo
gemeinsame	gemeinsame	adjective	Duolingo
gemocht	gemocht		Duolingo
gemüse	gemuse	noun	Duolingo
gemütlich	gemutlich	adjective	Duolingo
genau	genau		Duolingo
genau	genau	adjective	Duolingo
genau	genau	adverb	Duolingo
genauso	genauso	adverb	Duolingo
genauso	genauso	conjunction	Duolingo
genervt	genervt	adjective	Duolingo
genf	genf	proper noun	Duolingo
genfer see	genfer see		Duolingo
genie	genie	noun	Duolingo
genommen	genommen		Duolingo
genug	genug	adverb	Duolingo
genug	genug	pronoun	Duolingo
geöffnet	geoffnet	adjective	Duolingo
gepäck	gepack	noun	Duolingo
geplant	geplant	verb	Duolingo
geputzt	geputzt		Duolingo
geputzt	geputzt	verb	Duolingo
gerade	gerade		Duolingo
gerade	gerade	adjective	Duolingo
gerade	gerade	adverb	Duolingo
geradeaus	geradeaus	adverb	Duolingo
geräusch	gerausch	noun	Duolingo
geregnet	geregnet		Duolingo
gereist	gereist		Duolingo
gerettet	gerettet	verb	Duolingo
gericht	gericht	noun	Duolingo
gern	gern	adverb	Duolingo
gern geschehen	gern geschehen		Duolingo
gerne	gerne	adverb	Duolingo
gesagt	gesagt	verb	Duolingo
gesalzene	gesalzene	adjective	Duolingo
gesammelt	gesammelt	verb	Duolingo
gesamte	gesamte	adjective	Duolingo
gesamten	gesamten	adjective	Duolingo
geschafft	geschafft		Duolingo
geschafft	geschafft	verb	Duolingo
geschäft	geschaft	noun	Duolingo
geschäfte	geschafte	noun	Duolingo
geschäftlich	geschaftlich		Duolingo
geschäftsfrau	geschaftsfrau	noun	Duolingo
geschäftsmann	geschaftsmann	noun	Duolingo
geschehen	geschehen	verb	Duolingo
geschenk	geschenk	noun	Duolingo
geschenke	geschenke	noun	Duolingo
geschichte	geschichte	noun	Duolingo
geschichten	geschichten	noun	Duolingo
geschickt	geschickt	verb	Duolingo
geschieden	geschieden	adjective	Duolingo
geschirr	geschirr	noun	Duolingo
geschlafen	geschlafen	verb	Duolingo
geschlossen	geschlossen	adjective	Duolingo
geschmeckt	geschmeckt	verb	Duolingo
geschnarcht	geschnarcht	verb	Duolingo
geschneit	geschneit		Duolingo
geschossen	geschossen	verb	Duolingo
geschrieben	geschrieben		Duolingo
geschummelt	geschummelt	verb	Duolingo
geschwister	geschwister	noun	Duolingo
geschwistern	geschwistern	noun	Duolingo
geschwommen	geschwommen	verb	Duolingo
gesegelt	gesegelt	verb	Duolingo
gesehen	gesehen	verb	Duolingo
Gesellschaft	gesellschaft	noun	Duolingo
gesessen	gesessen	verb	Duolingo
gesicht	gesicht	noun	Duolingo
gespannt	gespannt	adjective	Duolingo
gespenst	gespenst	noun	Duolingo
gespielt	gespielt	verb	Duolingo
gesprochen	gesprochen	verb	Duolingo
gesprungen	gesprungen	verb	Duolingo
gestern	gestern	adverb	Duolingo
gestohlen	gestohlen	verb	Duolingo
gestresst	gestresst	adjective	Duolingo
gesucht	gesucht	verb	Duolingo
gesünd	gesund		Duolingo
gesund	gesund	adjective	Duolingo
gesundheit	gesundheit	noun	Duolingo
gesungen	gesungen		Duolingo
gesungen	gesungen	verb	Duolingo
gesurft	gesurft	verb	Duolingo
getanzt	getanzt	verb	Duolingo
getragen	getragen	verb	Duolingo
getränk	getrank	noun	Duolingo
getränke	getranke	noun	Duolingo
getränken	getranken	noun	Duolingo
getrennt	getrennt	adverb	Duolingo
getroffen	getroffen	verb	Duolingo
getrunken	getrunken		Duolingo
gewachsen	gewachsen	adjective	Duolingo
gewalt	gewalt	noun	Duolingo
gewandert	gewandert	verb	Duolingo
gewaschen	gewaschen	verb	Duolingo
gewitter	gewitter	noun	Duolingo
gewöhnlich	gewohnlich	adjective	Duolingo
gewonnen	gewonnen		Duolingo
geworfen	geworfen	verb	Duolingo
gewusst	gewusst		Duolingo
gezeigt	gezeigt	verb	Duolingo
gibst	gibst	verb	Duolingo
gibt	gibt	verb	Duolingo
gibt es	gibt es		Duolingo
gipsverband	gipsverband	noun	Duolingo
giraffe	giraffe	noun	Duolingo
Giraffen	giraffen	noun	Duolingo
girokonto	girokonto	noun	Duolingo
gitarre	gitarre	noun	Duolingo
glas	glas	noun	Duolingo
gläser	glaser	noun	Duolingo
gleich	gleich	adjective	Duolingo
gleich	gleich	adverb	Duolingo
gleiche	gleiche	adjective	Duolingo
gleichen	gleichen	adjective	Duolingo
gleichfalls	gleichfalls		Duolingo
gleis	gleis	noun	Duolingo
glück	gluck	noun	Duolingo
glücklich	glucklich	adjective	Duolingo
glücksbringer	glucksbringer	noun	Duolingo
glühwein	gluhwein	noun	Duolingo
gold	gold	noun	Duolingo
goldene hochzeit	goldene hochzeit		Duolingo
golf	golf	noun	Duolingo
Gorillas	gorillas	noun	Duolingo
gott und die welt	gott und die welt		Duolingo
grad celsius	grad celsius		Duolingo
gramm	gramm	noun	Duolingo
grammatik	grammatik	noun	Duolingo
gras	gras	noun	Duolingo
gratis	gratis	adverb	Duolingo
grau	grau	adjective	Duolingo
Grenze	grenze	noun	Duolingo
griechisch	griechisch	adjective	Duolingo
griechische	griechische	adjective	Duolingo
grillen	grillen	verb	Duolingo
grillparty	grillparty	noun	Duolingo
grillt	grillt	verb	Duolingo
grimm	grimm	proper noun	Duolingo
grippe	grippe	noun	Duolingo
groß	gross	adjective	Duolingo
großartig	grossartig	adjective	Duolingo
großbritannien	grossbritannien	proper noun	Duolingo
große	grosse	adjective	Duolingo
größe	grosse	noun	Duolingo
großeltern	grosseltern	noun	Duolingo
großen	grossen	adjective	Duolingo
größer	grosser	adjective	Duolingo
großes	grosses	adjective	Duolingo
großmutter	grossmutter	noun	Duolingo
größt	grosst		Duolingo
größte	grosste	adjective	Duolingo
größten	grossten	adjective	Duolingo
großvater	grossvater	noun	Duolingo
grün	grun	adjective	Duolingo
grundschule	grundschule	noun	Duolingo
grüne	grune	adjective	Duolingo
grünen	grunen	adjective	Duolingo
Grünen	grunen	proper noun	Duolingo
gruppe	gruppe	noun	Duolingo
grüß dich	gruss dich		Duolingo
grüße	grusse	verb	Duolingo
gummibärchen	gummibarchen	noun	Duolingo
günstige	gunstige	adjective	Duolingo
gurke	gurke	noun	Duolingo
gurken	gurken	noun	Duolingo
gurkensalat	gurkensalat	noun	Duolingo
gürtel	gurtel	noun	Duolingo
gut	gut	adjective	Duolingo
gut	gut	adverb	Duolingo
gut gemacht	gut gemacht		Duolingo
gute	gute	adjective	Duolingo
gute besserung	gute besserung		Duolingo
gute nacht	gute nacht		Duolingo
gute reise	gute reise		Duolingo
guten	guten	adjective	Duolingo
guten abend	guten abend		Duolingo
guten appetit	guten appetit		Duolingo
guten morgen	guten morgen		Duolingo
guten rutsch ins neue Jahr	guten rutsch ins neue jahr		Duolingo
guten tag	guten tag		Duolingo
guter	guter	adjective	Duolingo
gutschein	gutschein	noun	Duolingo
Haar	haar	noun	Duolingo
haarbürste	haarburste	noun	Duolingo
haare	haare	noun	Duolingo
Haarreif	haarreif	noun	Duolingo
habe	habe	verb	Duolingo
haben	haben	verb	Duolingo
habt	habt	verb	Duolingo
hähnchen	hahnchen	noun	Duolingo
Haifisch	haifisch	noun	Duolingo
halb	halb	adjective	Duolingo
Halbzeit	halbzeit	noun	Duolingo
hallo	hallo	interjection	Duolingo
hallo zusammen	hallo zusammen		Duolingo
hals	hals	noun	Duolingo
haltbar	haltbar	adjective	Duolingo
Haltestelle	haltestelle	noun	Duolingo
haltestellen	haltestellen	noun	Duolingo
hand	hand	noun	Duolingo
handball	handball	noun	Duolingo
hände	hande	noun	Duolingo
handlung	handlung	noun	Duolingo
handschuhe	handschuhe	noun	Duolingo
handtasche	handtasche	noun	Duolingo
handtaschen	handtaschen	noun	Duolingo
handtuch	handtuch	noun	Duolingo
handy	handy	noun	Duolingo
handynummer	handynummer	noun	Duolingo
handys	handys	noun	Duolingo
harmlos	harmlos	adjective	Duolingo
hart	hart	adjective	Duolingo
hässlich	hasslich	adjective	Duolingo
hast	hast	verb	Duolingo
hat	hat	verb	Duolingo
hatte	hatte	verb	Duolingo
hatten	hatten	verb	Duolingo
hattest	hattest	verb	Duolingo
hättet	hattet	verb	Duolingo
häufig	haufig	adjective	Duolingo
Hauptbahnhof	hauptbahnhof	noun	Duolingo
hauptfach	hauptfach	noun	Duolingo
hauptstadt	hauptstadt	noun	Duolingo
haus	haus	noun	Duolingo
hausadresse	hausadresse	noun	Duolingo
hausarbeit	hausarbeit	noun	Duolingo
hausaufgaben	hausaufgaben	noun	Duolingo
häuser	hauser	noun	Duolingo
hausgemachtem	hausgemachtem	adjective	Duolingo
hausnummer	hausnummer	noun	Duolingo
haustier	haustier	noun	Duolingo
haustiere	haustiere	noun	Duolingo
haut	haut	noun	Duolingo
heft	heft	noun	Duolingo
heidi	heidi	proper noun	Duolingo
heilig	heilig	adjective	Duolingo
Heimtrainer	heimtrainer	noun	Duolingo
heimweh	heimweh	noun	Duolingo
heiß	heiss	adjective	Duolingo
heiße	heisse	verb	Duolingo
heißen	heissen	verb	Duolingo
heißt	heisst	verb	Duolingo
heizung	heizung	noun	Duolingo
helfen	helfen	verb	Duolingo
hell	hell	adjective	Duolingo
hemd	hemd	noun	Duolingo
hemden	hemden	noun	Duolingo
her	her	adverb	Duolingo
heraus	heraus	adverb	Duolingo
herausfinden	herausfinden		Duolingo
herausgefunden	herausgefunden	verb	Duolingo
herbst	herbst	noun	Duolingo
herd	herd	noun	Duolingo
herein	herein	adverb	Duolingo
herr	herr	noun	Duolingo
herren	herren	noun	Duolingo
herrlich	herrlich	adjective	Duolingo
herrn	herrn	noun	Duolingo
herum	herum		Duolingo
herum	herum	adverb	Duolingo
herunter	herunter	adverb	Duolingo
heruntergeladen	heruntergeladen		Duolingo
hervorragend	hervorragend	adjective	Duolingo
herzlich	herzlich	adjective	Duolingo
herzlich willkommen	herzlich willkommen		Duolingo
herzlichen glückwunsch	herzlichen gluckwunsch		Duolingo
heute	heute	adverb	Duolingo
heute abend	heute abend		Duolingo
heute morgen	heute morgen		Duolingo
heute nachmittag	heute nachmittag		Duolingo
heute nacht	heute nacht		Duolingo
heutigen	heutigen	adjective	Duolingo
hexe	hexe	noun	Duolingo
hey	hey	interjection	Duolingo
hier	hier		Duolingo
hier	hier	adverb	Duolingo
hierher	hierher	adverb	Duolingo
hiermit	hiermit	adverb	Duolingo
hierzu	hierzu	adverb	Duolingo
hilf	hilf	verb	Duolingo
hilfe	hilfe	noun	Duolingo
hilfreich	hilfreich	adjective	Duolingo
hilfst	hilfst	verb	Duolingo
hilft	hilft	verb	Duolingo
himmel	himmel	noun	Duolingo
hin	hin		Duolingo
hin	hin	adverb	Duolingo
hin- und rückfahrt	hin- und ruckfahrt	noun	Duolingo
hinaus	hinaus		Duolingo
hinaus	hinaus	adverb	Duolingo
hinausgehen	hinausgehen		Duolingo
hinduismus	hinduismus	noun	Duolingo
hingegen	hingegen	adverb	Duolingo
hinlegen	hinlegen		Duolingo
hinten	hinten	adverb	Duolingo
hinter	hinter	preposition	Duolingo
hinzu	hinzu	adverb	Duolingo
hip-hop	hip-hop	noun	Duolingo
hitze	hitze	noun	Duolingo
hobby	hobby	noun	Duolingo
hobbys	hobbys	noun	Duolingo
hoch	hoch	adjective	Duolingo
höchst	hochst		Duolingo
höchste	hochste	adjective	Duolingo
hochzeit	hochzeit	noun	Duolingo
hockey	hockey	noun	Duolingo
hof	hof	noun	Duolingo
hoffentlich	hoffentlich	adverb	Duolingo
hofft	hofft	verb	Duolingo
hohe	hohe	adjective	Duolingo
hohen	hohen	adjective	Duolingo
höher	hoher	adjective	Duolingo
höhere	hohere	adjective	Duolingo
höheren	hoheren	adjective	Duolingo
hole	hole	verb	Duolingo
holen	holen	verb	Duolingo
holländisch	hollandisch	noun	Duolingo
holländischen	hollandischen	adjective	Duolingo
holst	holst	verb	Duolingo
holt	holt	verb	Duolingo
holz	holz	noun	Duolingo
honig	honig	noun	Duolingo
höre	hore	verb	Duolingo
hören	horen	verb	Duolingo
horrorfilm	horrorfilm	noun	Duolingo
hörst	horst	verb	Duolingo
Hort	hort	noun	Duolingo
hört	hort	verb	Duolingo
hose	hose	noun	Duolingo
hosen	hosen	noun	Duolingo
hosentasche	hosentasche	noun	Duolingo
hotel	hotel	noun	Duolingo
hübsch	hubsch	adjective	Duolingo
hubschrauber	hubschrauber	noun	Duolingo
hügel	hugel	noun	Duolingo
huhn	huhn	noun	Duolingo
humboldt-universität	humboldt-universitat	proper noun	Duolingo
hund	hund	noun	Duolingo
hunde	hunde	noun	Duolingo
hunden	hunden	noun	Duolingo
hundert	hundert	numeral	Duolingo
hundertdreiundzwanzig	hundertdreiundzwanzig	numeral	Duolingo
hunger	hunger	noun	Duolingo
hungrig	hungrig	adjective	Duolingo
hurra	hurra	interjection	Duolingo
hut	hut	noun	Duolingo
hüte	hute	noun	Duolingo
ice	ice	noun	Duolingo
ich	ich	pronoun	Duolingo
ich freue mich	ich freue mich		Duolingo
ich kann nicht	ich kann nicht		Duolingo
idee	idee	noun	Duolingo
ideen	ideen	noun	Duolingo
ihm	ihm	pronoun	Duolingo
ihn	ihn	pronoun	Duolingo
ihnen	ihnen	pronoun	Duolingo
ihr	ihr		Duolingo
ihr	ihr	determiner	Duolingo
ihr	ihr	pronoun	Duolingo
ihre	ihre		Duolingo
ihre	ihre	determiner	Duolingo
ihre	ihre	pronoun	Duolingo
ihrem	ihrem	determiner	Duolingo
ihrem	ihrem	pronoun	Duolingo
ihren	ihren	determiner	Duolingo
ihren	ihren	pronoun	Duolingo
ihrer	ihrer	determiner	Duolingo
im	im		Duolingo
im	im	preposition	Duolingo
im angebot	im angebot		Duolingo
im ausland	im ausland		Duolingo
im bett	im bett		Duolingo
im jahr	im jahr		Duolingo
im koffer	im koffer		Duolingo
im monat	im monat		Duolingo
im park	im park		Duolingo
im schrank	im schrank		Duolingo
immer	immer	adverb	Duolingo
immer noch	immer noch		Duolingo
in	in		Duolingo
in	in	preposition	Duolingo
in deiner pause	in deiner pause		Duolingo
in dem stadtviertel	in dem stadtviertel		Duolingo
in den ferien	in den ferien		Duolingo
in der nähe	in der nahe		Duolingo
in der nähe von	in der nahe von		Duolingo
in der woche	in der woche		Duolingo
in der wohnung	in der wohnung		Duolingo
in die bar	in die bar		Duolingo
in eile	in eile		Duolingo
in einem team	in einem team		Duolingo
in einer stunde	in einer stunde		Duolingo
in einer wg	in einer wg		Duolingo
in meiner pause	in meiner pause		Duolingo
in ordnung	in ordnung		Duolingo
in rente	in rente		Duolingo
indien	indien	noun	Duolingo
indische	indische	adjective	Duolingo
individuell	individuell	adjective	Duolingo
individuelle	individuelle	adjective	Duolingo
individuellen	individuellen	adjective	Duolingo
informatik	informatik	noun	Duolingo
informationen	informationen	noun	Duolingo
inklusive	inklusive	adverb	Duolingo
innen	innen	adverb	Duolingo
ins	ins		Duolingo
ins	ins	preposition	Duolingo
ins internet	ins internet		Duolingo
ins möbelhaus	ins mobelhaus		Duolingo
insbesondere	insbesondere	adverb	Duolingo
insekt	insekt	noun	Duolingo
insekten	insekten	noun	Duolingo
insel	insel	noun	Duolingo
inseln	inseln	noun	Duolingo
instrument	instrument	noun	Duolingo
intelligent	intelligent	adjective	Duolingo
interessant	interessant	adjective	Duolingo
interessante	interessante	adjective	Duolingo
interessen	interessen	noun	Duolingo
interessiert	interessiert	verb	Duolingo
international	international	adjective	Duolingo
international	international	adverb	Duolingo
internationale	internationale	adjective	Duolingo
internationalen	internationalen	adjective	Duolingo
internet	internet	noun	Duolingo
internetverbindung	internetverbindung	noun	Duolingo
Interview	interview	noun	Duolingo
inzwischen	inzwischen	adverb	Duolingo
irgendein	irgendein	determiner	Duolingo
irgendetwas	irgendetwas	determiner	Duolingo
irgendjemand	irgendjemand	determiner	Duolingo
irgendwann	irgendwann	adverb	Duolingo
irgendwas	irgendwas	determiner	Duolingo
irgendwem	irgendwem	determiner	Duolingo
irgendwen	irgendwen	determiner	Duolingo
irgendwer	irgendwer	determiner	Duolingo
irgendwie	irgendwie	adverb	Duolingo
irgendwo	irgendwo	adverb	Duolingo
island	island	proper noun	Duolingo
iss	iss	verb	Duolingo
isst	isst	verb	Duolingo
ist	ist	verb	Duolingo
italienisch	italienisch	adjective	Duolingo
italienische	italienische	adjective	Duolingo
italienischem	italienischem	adjective	Duolingo
ja	ja	adverb	Duolingo
jacke	jacke	noun	Duolingo
jacken	jacken	noun	Duolingo
jahr	jahr	noun	Duolingo
jahre	jahre	noun	Duolingo
jahren	jahren	noun	Duolingo
jahrestag	jahrestag	noun	Duolingo
jahrhundert	jahrhundert	noun	Duolingo
jährlich	jahrlich	adjective	Duolingo
januar	januar	noun	Duolingo
japan	japan	proper noun	Duolingo
jazz	jazz	noun	Duolingo
je	je	adverb	Duolingo
je	je	conjunction	Duolingo
jeans	jeans	noun	Duolingo
jeans	jeans	proper noun	Duolingo
jede	jede	determiner	Duolingo
jedem	jedem	determiner	Duolingo
jeden	jeden	adjective	Duolingo
jedenfalls	jedenfalls	adverb	Duolingo
jeder	jeder	determiner	Duolingo
jeder	jeder	pronoun	Duolingo
jederzeit	jederzeit	adverb	Duolingo
jedes	jedes	determiner	Duolingo
jedes mal	jedes mal		Duolingo
jedoch	jedoch	adverb	Duolingo
jemals	jemals	adverb	Duolingo
jemand	jemand	determiner	Duolingo
jemand	jemand	pronoun	Duolingo
jemandem	jemandem	determiner	Duolingo
jemandem	jemandem	pronoun	Duolingo
jemanden	jemanden	determiner	Duolingo
jemanden	jemanden	pronoun	Duolingo
jemandes	jemandes	determiner	Duolingo
jetzt	jetzt	adverb	Duolingo
jetzt geht's los	jetzt geht's los		Duolingo
job	job	noun	Duolingo
jobinterview	jobinterview	noun	Duolingo
jogge	jogge	verb	Duolingo
joggen	joggen	verb	Duolingo
joggst	joggst	verb	Duolingo
joggt	joggt	verb	Duolingo
joghurt	joghurt	noun	Duolingo
jugendherberge	jugendherberge	noun	Duolingo
jugendliche	jugendliche	adjective	Duolingo
jugendlichen	jugendlichen	adjective	Duolingo
jugendlichen	jugendlichen	noun	Duolingo
juli	juli	noun	Duolingo
julia	julia	proper noun	Duolingo
jüng	jung		Duolingo
jung	jung	adjective	Duolingo
junge	junge	adjective	Duolingo
junge	junge	noun	Duolingo
jungen	jungen	adjective	Duolingo
jungen	jungen	noun	Duolingo
jünger	junger		Duolingo
jüngeren	jungeren	adjective	Duolingo
jüngsten	jungsten	adjective	Duolingo
jüngstes	jungstes	adjective	Duolingo
juni	juni	noun	Duolingo
käfer	kafer	noun	Duolingo
kaffee	kaffee	noun	Duolingo
Kaffeehaus	kaffeehaus	noun	Duolingo
kaffeemaschine	kaffeemaschine	noun	Duolingo
kaffeetisch	kaffeetisch	noun	Duolingo
käfig	kafig	noun	Duolingo
kakao	kakao	noun	Duolingo
kalender	kalender	noun	Duolingo
kält	kalt		Duolingo
kalt	kalt	adjective	Duolingo
kaltem	kaltem	adjective	Duolingo
kälter	kalter	adjective	Duolingo
kamera	kamera	noun	Duolingo
kanada	kanada	proper noun	Duolingo
kanadier	kanadier	noun	Duolingo
kanadierin	kanadierin	noun	Duolingo
Kanal	kanal	noun	Duolingo
kaninchen	kaninchen	noun	Duolingo
kantine	kantine	noun	Duolingo
kanzler	kanzler	noun	Duolingo
kanzlerin	kanzlerin	noun	Duolingo
Kapitel	kapitel	noun	Duolingo
kaputt	kaputt	adjective	Duolingo
kaputtgegangen	kaputtgegangen		Duolingo
Karibik	karibik	noun	Duolingo
karl	karl	proper noun	Duolingo
karneval	karneval	noun	Duolingo
karnevalsparty	karnevalsparty	noun	Duolingo
karnevalsumzug	karnevalsumzug	noun	Duolingo
karotte	karotte	noun	Duolingo
karotten	karotten	noun	Duolingo
karte	karte	noun	Duolingo
karten	karten	noun	Duolingo
kartoffel	kartoffel	noun	Duolingo
kartoffeln	kartoffeln	noun	Duolingo
kartoffelsalat	kartoffelsalat	noun	Duolingo
Karton	karton	noun	Duolingo
Kartons	kartons	noun	Duolingo
käse	kase	noun	Duolingo
käsebrot	kasebrot	noun	Duolingo
käsespätzle	kasespatzle	noun	Duolingo
kasse	kasse	noun	Duolingo
kassenbon	kassenbon	noun	Duolingo
kassenzettel	kassenzettel	noun	Duolingo
kater	kater	noun	Duolingo
katze	katze	noun	Duolingo
katzen	katzen	noun	Duolingo
kauf	kauf	verb	Duolingo
kaufen	kaufen	verb	Duolingo
kaufhaus	kaufhaus	noun	Duolingo
kaufst	kaufst	verb	Duolingo
kauft	kauft	verb	Duolingo
kaum	kaum	adverb	Duolingo
kein	kein	determiner	Duolingo
kein problem	kein problem		Duolingo
keine	keine	determiner	Duolingo
keine ursache	keine ursache		Duolingo
keinen	keinen	determiner	Duolingo
keinen hunger	keinen hunger		Duolingo
keiner	keiner	determiner	Duolingo
keinerlei	keinerlei	determiner	Duolingo
kekse	kekse	noun	Duolingo
keller	keller	noun	Duolingo
kellner	kellner	noun	Duolingo
kellnerin	kellnerin	noun	Duolingo
kenne	kenne	verb	Duolingo
kennen	kennen		Duolingo
kennen	kennen	verb	Duolingo
kennengelernt	kennengelernt		Duolingo
kennenlernen	kennenlernen	verb	Duolingo
kennenzulernen	kennenzulernen		Duolingo
kennst	kennst	verb	Duolingo
kennt	kennt	verb	Duolingo
kette	kette	noun	Duolingo
kilo	kilo	noun	Duolingo
kilogramm	kilogramm	noun	Duolingo
kilometer	kilometer	noun	Duolingo
kind	kind	noun	Duolingo
kinder	kinder	noun	Duolingo
kinderbuch	kinderbuch	noun	Duolingo
kindergarten	kindergarten	noun	Duolingo
kindern	kindern	noun	Duolingo
kinderstuhl	kinderstuhl	noun	Duolingo
kinderzimmer	kinderzimmer	noun	Duolingo
kino	kino	noun	Duolingo
kinokarten	kinokarten	noun	Duolingo
kiosk	kiosk	noun	Duolingo
kirche	kirche	noun	Duolingo
kirchen	kirchen	noun	Duolingo
klar	klar	adjective	Duolingo
klasse	klasse	adjective	Duolingo
klasse	klasse	noun	Duolingo
klassenarbeit	klassenarbeit	noun	Duolingo
klassentreffen	klassentreffen	noun	Duolingo
klassische musik	klassische musik		Duolingo
klavier	klavier	noun	Duolingo
kleid	kleid	noun	Duolingo
kleider	kleider	noun	Duolingo
kleidung	kleidung	noun	Duolingo
klein	klein	adjective	Duolingo
kleine	kleine	adjective	Duolingo
kleinen	kleinen	adjective	Duolingo
kleiner	kleiner	adjective	Duolingo
kleines	kleines	adjective	Duolingo
kleingeld	kleingeld	noun	Duolingo
klima	klima	noun	Duolingo
klimaanlage	klimaanlage	noun	Duolingo
Kloß	kloss	noun	Duolingo
klüg	klug		Duolingo
klug	klug	adjective	Duolingo
klüger	kluger	adjective	Duolingo
knapp	knapp	adjective	Duolingo
Kneipe	kneipe	noun	Duolingo
knoblauch	knoblauch	noun	Duolingo
knödel	knodel	noun	Duolingo
knopf	knopf	noun	Duolingo
knöpfe	knopfe	noun	Duolingo
Koalition	koalition	noun	Duolingo
koch	koch	noun	Duolingo
kochbuch	kochbuch	noun	Duolingo
koche	koche	verb	Duolingo
kochen	kochen	noun	Duolingo
köchin	kochin	noun	Duolingo
kochlöffel	kochloffel	noun	Duolingo
kochst	kochst	verb	Duolingo
kocht	kocht	verb	Duolingo
koffer	koffer	noun	Duolingo
kofferausgabe	kofferausgabe	noun	Duolingo
Kofferraum	kofferraum	noun	Duolingo
kohl	kohl	noun	Duolingo
kollege	kollege	noun	Duolingo
kollegen	kollegen	noun	Duolingo
kollegin	kollegin	noun	Duolingo
komisch	komisch	adjective	Duolingo
komischen	komischen	adjective	Duolingo
komischer	komischer	adjective	Duolingo
komm	komm	interjection	Duolingo
komme	komme	verb	Duolingo
kommen	kommen	verb	Duolingo
kommode	kommode	noun	Duolingo
kommst	kommst	verb	Duolingo
kommt	kommt	verb	Duolingo
komödie	komodie	noun	Duolingo
komplett	komplett	adjective	Duolingo
komplette	komplette	adjective	Duolingo
kompliziert	kompliziert	adjective	Duolingo
konditorei	konditorei	noun	Duolingo
können	konnen	verb	Duolingo
konnte	konnte	verb	Duolingo
könnten	konnten	verb	Duolingo
könntest	konntest	verb	Duolingo
konntet	konntet	verb	Duolingo
konsole	konsole	noun	Duolingo
Kontakt	kontakt	noun	Duolingo
kontinent	kontinent	noun	Duolingo
konto	konto	noun	Duolingo
kontonummer	kontonummer	noun	Duolingo
Kontrollen	kontrollen	noun	Duolingo
konzert	konzert	noun	Duolingo
konzerte	konzerte	noun	Duolingo
konzerten	konzerten	noun	Duolingo
kopf	kopf	noun	Duolingo
kopfhörer	kopfhorer	noun	Duolingo
kopfkissen	kopfkissen	noun	Duolingo
kopfschmerzen	kopfschmerzen	noun	Duolingo
korrupt	korrupt	adjective	Duolingo
kosmetik	kosmetik	noun	Duolingo
kosten	kosten	verb	Duolingo
kostenlos	kostenlos	adjective	Duolingo
kostenlose	kostenlose	adjective	Duolingo
kostenlosen	kostenlosen	adjective	Duolingo
kostet	kostet	verb	Duolingo
kostüme	kostume	noun	Duolingo
kränk	krank		Duolingo
krank	krank	adjective	Duolingo
kranken	kranken	adjective	Duolingo
krankenhaus	krankenhaus	noun	Duolingo
krankenpfleger	krankenpfleger	noun	Duolingo
krankenschwester	krankenschwester	noun	Duolingo
krawatte	krawatte	noun	Duolingo
kreditkarte	kreditkarte	noun	Duolingo
kreditkarten	kreditkarten	noun	Duolingo
kreuzfahrt	kreuzfahrt	noun	Duolingo
kreuzung	kreuzung	noun	Duolingo
krimis	krimis	noun	Duolingo
küche	kuche	noun	Duolingo
kuchen	kuchen	noun	Duolingo
küchensachen	kuchensachen	noun	Duolingo
küchenwaage	kuchenwaage	noun	Duolingo
kugel	kugel	noun	Duolingo
kugelschreiber	kugelschreiber	noun	Duolingo
kuh	kuh	noun	Duolingo
kühe	kuhe	noun	Duolingo
kühl	kuhl	adjective	Duolingo
kühlschrank	kuhlschrank	noun	Duolingo
kuli	kuli	noun	Duolingo
kulis	kulis	noun	Duolingo
kultur	kultur	noun	Duolingo
kunden	kunden	noun	Duolingo
kunst	kunst	noun	Duolingo
künstler	kunstler	noun	Duolingo
künstlerin	kunstlerin	noun	Duolingo
kunstmuseum	kunstmuseum	noun	Duolingo
kurs	kurs	noun	Duolingo
kurse	kurse	noun	Duolingo
kürz	kurz		Duolingo
kurz	kurz	adjective	Duolingo
kürzeren	kurzeren		Duolingo
kürzlich	kurzlich	adjective	Duolingo
Kuss	kuss	noun	Duolingo
küste	kuste	noun	Duolingo
l	l	adjective	Duolingo
labor	labor	noun	Duolingo
lachs	lachs	noun	Duolingo
lade	lade		Duolingo
ladegerät	ladegerat	noun	Duolingo
laden	laden	noun	Duolingo
lampe	lampe	noun	Duolingo
lampen	lampen	noun	Duolingo
land	land	noun	Duolingo
länder	lander	noun	Duolingo
landkarte	landkarte	noun	Duolingo
landschaft	landschaft	noun	Duolingo
läng	lang		Duolingo
lang	lang	adjective	Duolingo
lang	lang	adverb	Duolingo
lange	lange	adjective	Duolingo
lange	lange	adverb	Duolingo
lange nicht gesehen	lange nicht gesehen		Duolingo
langen	langen	adjective	Duolingo
länger	langer	adjective	Duolingo
langer tag	langer tag		Duolingo
langsam	langsam	adjective	Duolingo
langsam	langsam	adverb	Duolingo
langsamer	langsamer	adjective	Duolingo
längst	langst		Duolingo
langweilig	langweilig	adjective	Duolingo
laptop	laptop	noun	Duolingo
lass uns	lass uns		Duolingo
laufe	laufe	verb	Duolingo
laufen	laufen	verb	Duolingo
läufst	laufst	verb	Duolingo
läuft	lauft	verb	Duolingo
laut	laut	adjective	Duolingo
laut	laut	preposition	Duolingo
lauten	lauten	adjective	Duolingo
lauter	lauter	adjective	Duolingo
lebe	lebe	verb	Duolingo
leben	leben	noun	Duolingo
leben	leben	verb	Duolingo
lebenslauf	lebenslauf	noun	Duolingo
lebensmittel	lebensmittel	noun	Duolingo
leberwurst	leberwurst	noun	Duolingo
lebst	lebst	verb	Duolingo
lebt	lebt	verb	Duolingo
lecker	lecker	adjective	Duolingo
leckerer	leckerer	adjective	Duolingo
leder	leder	noun	Duolingo
lederjacke	lederjacke	noun	Duolingo
ledig	ledig	adjective	Duolingo
leer	leer	adjective	Duolingo
leg	leg	verb	Duolingo
lehrer	lehrer	noun	Duolingo
lehrerin	lehrerin	noun	Duolingo
lehrern	lehrern	noun	Duolingo
leicht	leicht		Duolingo
leicht	leicht	adjective	Duolingo
leichter	leichter	adjective	Duolingo
leid	leid	noun	Duolingo
leider	leider	adverb	Duolingo
leine	leine	noun	Duolingo
leise	leise	adjective	Duolingo
leiser	leiser	adjective	Duolingo
leistungen	leistungen	noun	Duolingo
leitung	leitung	noun	Duolingo
Leoparden	leoparden	noun	Duolingo
lerne	lerne	verb	Duolingo
lernen	lernen	verb	Duolingo
lernst	lernst	verb	Duolingo
lernt	lernt	verb	Duolingo
lese	lese	verb	Duolingo
lesen	lesen	noun	Duolingo
lesen	lesen	verb	Duolingo
lest	lest	verb	Duolingo
letzte	letzte	determiner	Duolingo
letzten	letzten	adjective	Duolingo
letzten	letzten	determiner	Duolingo
letzter	letzter	adjective	Duolingo
letztes	letztes		Duolingo
letztes mal	letztes mal		Duolingo
leuchtturm	leuchtturm	noun	Duolingo
leute	leute	noun	Duolingo
leuten	leuten	noun	Duolingo
licht	licht	noun	Duolingo
lieb	lieb	adjective	Duolingo
liebe	liebe	adjective	Duolingo
liebe	liebe	verb	Duolingo
lieber	lieber	adjective	Duolingo
lieber	lieber	adverb	Duolingo
lieblings	lieblings	noun	Duolingo
lieblingsband	lieblingsband	noun	Duolingo
lieblingsessen	lieblingsessen	noun	Duolingo
lieblingslied	lieblingslied	noun	Duolingo
lieblingsrestaurant	lieblingsrestaurant		Duolingo
lieblingsteam	lieblingsteam	noun	Duolingo
lieblingstier	lieblingstier	noun	Duolingo
liebst	liebst		Duolingo
liebst	liebst	verb	Duolingo
liebt	liebt	verb	Duolingo
lied	lied	noun	Duolingo
lieder	lieder	noun	Duolingo
lieferservice	lieferservice	noun	Duolingo
liest	liest	verb	Duolingo
lila	lila	adjective	Duolingo
limonade	limonade	noun	Duolingo
lineal	lineal	noun	Duolingo
linguistik	linguistik	noun	Duolingo
linie	linie	noun	Duolingo
link	link	noun	Duolingo
linken	linken	adjective	Duolingo
links	links	adverb	Duolingo
lissabon	lissabon	noun	Duolingo
liter	liter	noun	Duolingo
Literatur	literatur	noun	Duolingo
loch	loch	noun	Duolingo
löffel	loffel	noun	Duolingo
lokal	lokal	noun	Duolingo
los	los	adjective	Duolingo
los	los	adverb	Duolingo
löwe	lowe	noun	Duolingo
Löwen	lowen	noun	Duolingo
luft	luft	noun	Duolingo
luftballons	luftballons	noun	Duolingo
luftspiegelung	luftspiegelung	noun	Duolingo
lukas	lukas		Duolingo
lust	lust		Duolingo
lust	lust	noun	Duolingo
lustig	lustig	adjective	Duolingo
lustige	lustige	adjective	Duolingo
lustigen	lustigen	adjective	Duolingo
lustiger	lustiger	adjective	Duolingo
luxemburg	luxemburg	noun	Duolingo
mach	mach	verb	Duolingo
mach's gut	mach's gut		Duolingo
mache	mache	verb	Duolingo
machen	machen		Duolingo
machen	machen	verb	Duolingo
machst	machst	verb	Duolingo
macht	macht	verb	Duolingo
macht nichts	macht nichts		Duolingo
macht's gut	macht's gut		Duolingo
mächtiger	machtiger	adjective	Duolingo
mädchen	madchen	noun	Duolingo
mag	mag	verb	Duolingo
Magen	magen	noun	Duolingo
magisch	magisch	adjective	Duolingo
magst	magst	verb	Duolingo
Mahlzeit	mahlzeit	noun	Duolingo
mai	mai	noun	Duolingo
mainz	mainz	proper noun	Duolingo
maja	maja	proper noun	Duolingo
mal	mal	adverb	Duolingo
male	male	verb	Duolingo
mallorca	mallorca	proper noun	Duolingo
malst	malst	verb	Duolingo
malt	malt	verb	Duolingo
mama	mama	noun	Duolingo
mamas	mamas	noun	Duolingo
man	man	determiner	Duolingo
man	man	pronoun	Duolingo
manche	manche	determiner	Duolingo
manche	manche	pronoun	Duolingo
manchmal	manchmal	adverb	Duolingo
mango	mango	noun	Duolingo
mann	mann	noun	Duolingo
männer	manner	noun	Duolingo
männern	mannern	noun	Duolingo
mannschaft	mannschaft	noun	Duolingo
mäntel	mantel	noun	Duolingo
marathon	marathon	noun	Duolingo
märchen	marchen	noun	Duolingo
markt	markt	noun	Duolingo
marktplatz	marktplatz	noun	Duolingo
marmelade	marmelade	noun	Duolingo
märz	marz	noun	Duolingo
Marzipan	marzipan	noun	Duolingo
maschine	maschine	noun	Duolingo
maschinen	maschinen	noun	Duolingo
maschinenbau	maschinenbau	noun	Duolingo
Maske	maske	noun	Duolingo
masken	masken	noun	Duolingo
Mathe	mathe	noun	Duolingo
mathematik	mathematik	noun	Duolingo
matratze	matratze	noun	Duolingo
maultaschen	maultaschen	noun	Duolingo
maus	maus	noun	Duolingo
mäuse	mause	noun	Duolingo
mäusen	mausen	noun	Duolingo
mayo	mayo	noun	Duolingo
mecklenburg-vorpommern	mecklenburg-vorpommern		Duolingo
medizin	medizin	noun	Duolingo
meer	meer	noun	Duolingo
meerschweinchen	meerschweinchen	noun	Duolingo
mehl	mehl	noun	Duolingo
mehr	mehr		Duolingo
mehr	mehr	adverb	Duolingo
mehr	mehr	determiner	Duolingo
mehrbettzimmer	mehrbettzimmer	noun	Duolingo
mehreren	mehreren	determiner	Duolingo
mehrerer	mehrerer	determiner	Duolingo
mehrfamilienhaus	mehrfamilienhaus	noun	Duolingo
Mehrheit	mehrheit	noun	Duolingo
mehrwertsteuer	mehrwertsteuer	noun	Duolingo
meile	meile	noun	Duolingo
meilen	meilen	noun	Duolingo
mein	mein	determiner	Duolingo
mein	mein	pronoun	Duolingo
meine	meine	determiner	Duolingo
meine	meine	pronoun	Duolingo
meine damen und herren	meine damen und herren		Duolingo
meinem	meinem	determiner	Duolingo
meinem	meinem	pronoun	Duolingo
meinen	meinen	determiner	Duolingo
meinen	meinen	pronoun	Duolingo
meiner	meiner	determiner	Duolingo
meiner	meiner	pronoun	Duolingo
meinung	meinung	noun	Duolingo
meinungen	meinungen	noun	Duolingo
meist	meist		Duolingo
meist	meist	adverb	Duolingo
meisten	meisten	adjective	Duolingo
meistens	meistens	adverb	Duolingo
mensa	mensa	noun	Duolingo
mensch	mensch	noun	Duolingo
menschen	menschen	noun	Duolingo
menü	menu	noun	Duolingo
messer	messer	noun	Duolingo
meter	meter	noun	Duolingo
metzger	metzger	noun	Duolingo
metzgerei	metzgerei	noun	Duolingo
mich	mich		Duolingo
mich	mich	pronoun	Duolingo
miete	miete	noun	Duolingo
mietet	mietet	verb	Duolingo
mietwagen	mietwagen	noun	Duolingo
mikrowelle	mikrowelle	noun	Duolingo
milch	milch	noun	Duolingo
milchreis	milchreis	noun	Duolingo
million	million	noun	Duolingo
Millionen	millionen	noun	Duolingo
mindestens	mindestens	adverb	Duolingo
mineralwasser	mineralwasser	noun	Duolingo
minus	minus	adverb	Duolingo
minus	minus	preposition	Duolingo
minuten	minuten	noun	Duolingo
minze	minze	noun	Duolingo
mir	mir	pronoun	Duolingo
mir geht's gut	mir geht's gut		Duolingo
mir geht’s gut	mir geht's gut		Duolingo
mit	mit		Duolingo
mit	mit	preposition	Duolingo
mit freundlichen grüßen	mit freundlichen grussen		Duolingo
mitbewohner	mitbewohner	noun	Duolingo
mitbewohnerin	mitbewohnerin	noun	Duolingo
mitbewohnern	mitbewohnern	noun	Duolingo
mitgebracht	mitgebracht	verb	Duolingo
mitgespielt	mitgespielt	verb	Duolingo
mitglieder	mitglieder	noun	Duolingo
mitkommen	mitkommen	verb	Duolingo
mitleid	mitleid	noun	Duolingo
mitnehmen	mitnehmen		Duolingo
mitspielen	mitspielen	verb	Duolingo
Mittag	mittag	noun	Duolingo
mittagessen	mittagessen	noun	Duolingo
Mittagsmenü	mittagsmenu	noun	Duolingo
mittagszeit	mittagszeit	noun	Duolingo
mitte	mitte	noun	Duolingo
mittelmeer	mittelmeer	noun	Duolingo
mitternacht	mitternacht	noun	Duolingo
mittlerweile	mittlerweile	adverb	Duolingo
mittwoch	mittwoch	noun	Duolingo
mitzukommen	mitzukommen		Duolingo
mitzunehmen	mitzunehmen		Duolingo
möbel	mobel	noun	Duolingo
möbelhaus	mobelhaus	noun	Duolingo
möchte	mochte	verb	Duolingo
möchten	mochten	verb	Duolingo
möchtest	mochtest	verb	Duolingo
möchtet	mochtet	verb	Duolingo
Mode	mode	noun	Duolingo
modern	modern	adjective	Duolingo
modernen	modernen	adjective	Duolingo
mögen	mogen	verb	Duolingo
möglich	moglich	adjective	Duolingo
möglichen	moglichen	adjective	Duolingo
möglichkeit	moglichkeit	noun	Duolingo
möglichst	moglichst	adverb	Duolingo
mögt	mogt	verb	Duolingo
möhren	mohren	noun	Duolingo
moment	moment	noun	Duolingo
monat	monat	noun	Duolingo
monate	monate	noun	Duolingo
monaten	monaten	noun	Duolingo
monatlich	monatlich	adjective	Duolingo
mond	mond	noun	Duolingo
montag	montag	noun	Duolingo
moped	moped	noun	Duolingo
morgen	morgen	adverb	Duolingo
morgen	morgen	noun	Duolingo
morgens	morgens	adverb	Duolingo
moschee	moschee	noun	Duolingo
moskau	moskau	proper noun	Duolingo
motiviert	motiviert	adjective	Duolingo
motor	motor	noun	Duolingo
motorrad	motorrad	noun	Duolingo
motorroller	motorroller	noun	Duolingo
müde	mude	adjective	Duolingo
müll	mull	noun	Duolingo
Müllbeutel	mullbeutel	noun	Duolingo
mülleimer	mulleimer	noun	Duolingo
müller	muller	proper noun	Duolingo
münchen	munchen	noun	Duolingo
museen	museen	noun	Duolingo
museum	museum	noun	Duolingo
musik	musik	noun	Duolingo
musiker	musiker	noun	Duolingo
müsli	musli	noun	Duolingo
muss	muss	verb	Duolingo
müssen	mussen	verb	Duolingo
musste	musste	verb	Duolingo
mussten	mussten	verb	Duolingo
musstest	musstest	verb	Duolingo
musstet	musstet	verb	Duolingo
mutter	mutter	noun	Duolingo
muttersprache	muttersprache	noun	Duolingo
mütze	mutze	noun	Duolingo
nach	nach		Duolingo
nach	nach	preposition	Duolingo
nach dem signalton	nach dem signalton		Duolingo
nach der arbeit	nach der arbeit		Duolingo
nach der schule	nach der schule		Duolingo
nach hause	nach hause		Duolingo
nachbar	nachbar	noun	Duolingo
nachbarin	nachbarin	noun	Duolingo
nachbarn	nachbarn	noun	Duolingo
nachdem	nachdem	conjunction	Duolingo
nachher	nachher	adverb	Duolingo
nachmittag	nachmittag	noun	Duolingo
nachmittags	nachmittags	noun	Duolingo
nachname	nachname	noun	Duolingo
nachricht	nachricht	noun	Duolingo
nachrichten	nachrichten	noun	Duolingo
nachsehen	nachsehen		Duolingo
nächste	nachste	adjective	Duolingo
nächsten	nachsten	adjective	Duolingo
nächster	nachster	adjective	Duolingo
nächstes	nachstes	adjective	Duolingo
nächstes	nachstes	determiner	Duolingo
nächstes mal	nachstes mal		Duolingo
nacht	nacht	noun	Duolingo
nächte	nachte	noun	Duolingo
nachtisch	nachtisch	noun	Duolingo
nachts	nachts	adverb	Duolingo
nacken	nacken	noun	Duolingo
nahe	nahe	adjective	Duolingo
näher	naher	adjective	Duolingo
naja	naja	interjection	Duolingo
name	name	noun	Duolingo
namen	namen	noun	Duolingo
namibia	namibia	noun	Duolingo
nase	nase	noun	Duolingo
nass	nass	adjective	Duolingo
nationalpark	nationalpark	noun	Duolingo
natur	natur	noun	Duolingo
natürlich	naturlich	adverb	Duolingo
nebel	nebel	noun	Duolingo
neben	neben	preposition	Duolingo
nebenan	nebenan	adverb	Duolingo
nebenfach	nebenfach	noun	Duolingo
neblig	neblig	adjective	Duolingo
neffe	neffe	noun	Duolingo
nein	nein	adverb	Duolingo
nervös	nervos	adjective	Duolingo
nett	nett	adjective	Duolingo
nette	nette	adjective	Duolingo
netten	netten	adjective	Duolingo
netter	netter		Duolingo
nettes	nettes	adjective	Duolingo
neu	neu	adjective	Duolingo
neue	neue	adjective	Duolingo
neue kleidung	neue kleidung		Duolingo
neue wohnung	neue wohnung		Duolingo
neuem	neuem	adjective	Duolingo
neuen	neuen	adjective	Duolingo
neuen film	neuen film		Duolingo
neuen grill	neuen grill		Duolingo
neuen job	neuen job		Duolingo
neuen pass	neuen pass		Duolingo
neuer	neuer	adjective	Duolingo
neues	neues	adjective	Duolingo
neuesten	neuesten	adjective	Duolingo
neulich	neulich	adjective	Duolingo
neumann	neumann	proper noun	Duolingo
neun	neun	numeral	Duolingo
neununddreißig	neununddreissig	numeral	Duolingo
neunundneunzig	neunundneunzig	numeral	Duolingo
neunzehn	neunzehn	numeral	Duolingo
neunzehnhundertachtzig	neunzehnhundertachtzig	numeral	Duolingo
neunzehnten	neunzehnten	adjective	Duolingo
neunzig	neunzig	numeral	Duolingo
neuschwanstein	neuschwanstein	proper noun	Duolingo
neuseeland	neuseeland	noun	Duolingo
nicht	nicht		Duolingo
nicht	nicht	adverb	Duolingo
nicht einmal	nicht einmal		Duolingo
nicht mehr	nicht mehr		Duolingo
nicht wahr	nicht wahr		Duolingo
nichte	nichte	noun	Duolingo
nichts	nichts	pronoun	Duolingo
nichts an	nichts an		Duolingo
nickerchen	nickerchen	noun	Duolingo
nie	nie	adverb	Duolingo
niemals	niemals	adverb	Duolingo
niemand	niemand	determiner	Duolingo
niemand	niemand	pronoun	Duolingo
niemandem	niemandem	pronoun	Duolingo
niemanden	niemanden	pronoun	Duolingo
nimm	nimm	verb	Duolingo
nirgends	nirgends	adverb	Duolingo
nirgendwo	nirgendwo	adverb	Duolingo
noch	noch		Duolingo
noch	noch	adverb	Duolingo
noch einmal	noch einmal		Duolingo
noch nicht	noch nicht		Duolingo
noch nie	noch nie		Duolingo
nochmals	nochmals	adverb	Duolingo
nordamerika	nordamerika	noun	Duolingo
norden	norden	noun	Duolingo
nordrhein-westfalen	nordrhein-westfalen		Duolingo
normal	normal	adjective	Duolingo
normalen	normalen	adjective	Duolingo
normalerweise	normalerweise	adverb	Duolingo
notaufnahme	notaufnahme	noun	Duolingo
note	note	noun	Duolingo
noten	noten	noun	Duolingo
notiert	notiert	verb	Duolingo
notizbuch	notizbuch	noun	Duolingo
notwendig	notwendig	adjective	Duolingo
notwendigen	notwendigen	adjective	Duolingo
november	november	noun	Duolingo
nudel	nudel	noun	Duolingo
nudelholz	nudelholz	noun	Duolingo
nudeln	nudeln	noun	Duolingo
null	null		Duolingo
null	null	numeral	Duolingo
nummer	nummer	noun	Duolingo
nun	nun	adverb	Duolingo
nur	nur	adverb	Duolingo
nussallergie	nussallergie	noun	Duolingo
nützlich	nutzlich	adjective	Duolingo
ob	ob	conjunction	Duolingo
Obdachlosen	obdachlosen	noun	Duolingo
oben	oben	adverb	Duolingo
obst	obst	noun	Duolingo
obstsalat	obstsalat	noun	Duolingo
obwohl	obwohl	conjunction	Duolingo
oder	oder	conjunction	Duolingo
ofen	ofen	noun	Duolingo
offen	offen	adjective	Duolingo
offene	offene	adjective	Duolingo
offenen	offenen	adjective	Duolingo
öffentliche	offentliche	adjective	Duolingo
öffentlichen	offentlichen	adjective	Duolingo
öffentliches	offentliches	adjective	Duolingo
öffnen	offnen	verb	Duolingo
öffnungszeiten	offnungszeiten	noun	Duolingo
öft	oft		Duolingo
oft	oft	adjective	Duolingo
oft	oft	adverb	Duolingo
öfter	ofter	adverb	Duolingo
oh	oh	interjection	Duolingo
ohne	ohne	conjunction	Duolingo
ohne	ohne	preposition	Duolingo
ohren	ohren	noun	Duolingo
ohrringe	ohrringe	noun	Duolingo
ohrringen	ohrringen	noun	Duolingo
ok	ok		Duolingo
oktober	oktober	noun	Duolingo
oktoberfest	oktoberfest	noun	Duolingo
öl	ol	noun	Duolingo
olé	ole	interjection	Duolingo
oma	oma	noun	Duolingo
omelett	omelett	noun	Duolingo
onkel	onkel	noun	Duolingo
online	online	adverb	Duolingo
opa	opa	noun	Duolingo
oper	oper	noun	Duolingo
operation	operation	noun	Duolingo
orange	orange	adjective	Duolingo
orange	orange	noun	Duolingo
orangen	orangen	noun	Duolingo
orangensaft	orangensaft	noun	Duolingo
ordentlich	ordentlich	adjective	Duolingo
ordner	ordner	noun	Duolingo
Organisation	organisation	noun	Duolingo
organisiert	organisiert	verb	Duolingo
original	original	adjective	Duolingo
ort	ort	noun	Duolingo
osten	osten	noun	Duolingo
ostern	ostern	noun	Duolingo
österreich	osterreich	proper noun	Duolingo
ostsee	ostsee	noun	Duolingo
paar	paar	determiner	Duolingo
paar	paar	noun	Duolingo
packung	packung	noun	Duolingo
packungen	packungen	noun	Duolingo
paket	paket	noun	Duolingo
pakete	pakete	noun	Duolingo
panda	panda	noun	Duolingo
panik	panik	noun	Duolingo
papa	papa	noun	Duolingo
papagei	papagei	noun	Duolingo
papageien	papageien	noun	Duolingo
papas	papas	noun	Duolingo
papier	papier	noun	Duolingo
parfüm	parfum	noun	Duolingo
park	park	noun	Duolingo
parkplatz	parkplatz	noun	Duolingo
parks	parks	noun	Duolingo
Partei	partei	noun	Duolingo
Parteien	parteien	noun	Duolingo
partner	partner	noun	Duolingo
partnerin	partnerin	noun	Duolingo
partnerschaft	partnerschaft	noun	Duolingo
partnerschaften	partnerschaften	noun	Duolingo
party	party	noun	Duolingo
pass	pass	noun	Duolingo
pass auf	pass auf	verb	Duolingo
passen	passen	verb	Duolingo
passende	passende	adjective	Duolingo
passenden	passenden	adjective	Duolingo
passfoto	passfoto	noun	Duolingo
passiert	passiert		Duolingo
passiert	passiert	adjective	Duolingo
passiert	passiert	verb	Duolingo
passt	passt	verb	Duolingo
pasteten	pasteten	noun	Duolingo
pause	pause	noun	Duolingo
pausen	pausen	noun	Duolingo
Pausenbrot	pausenbrot	noun	Duolingo
per	per	preposition	Duolingo
perfekt	perfekt	adjective	Duolingo
perfekt	perfekt	adverb	Duolingo
person	person	noun	Duolingo
personal	personal	noun	Duolingo
personen	personen	noun	Duolingo
persönlich	personlich	adjective	Duolingo
persönliche	personliche	adjective	Duolingo
persönlichen	personlichen	adjective	Duolingo
pfanne	pfanne	noun	Duolingo
pfeffer	pfeffer	noun	Duolingo
pferd	pferd	noun	Duolingo
pferde	pferde	noun	Duolingo
pflanze	pflanze	noun	Duolingo
pflanzen	pflanzen	noun	Duolingo
pflaster	pflaster	noun	Duolingo
Pflaumen	pflaumen	noun	Duolingo
philosophie	philosophie	noun	Duolingo
physik	physik	noun	Duolingo
picknick	picknick	noun	Duolingo
pilze	pilze	noun	Duolingo
pinguin	pinguin	noun	Duolingo
pinguine	pinguine	noun	Duolingo
pink	pink	adjective	Duolingo
piraten	piraten	noun	Duolingo
pizza	pizza	noun	Duolingo
pizzas	pizzas	noun	Duolingo
plan	plan	noun	Duolingo
pläne	plane	noun	Duolingo
plane	plane	verb	Duolingo
planen	planen	verb	Duolingo
planst	planst	verb	Duolingo
plastik	plastik	noun	Duolingo
platz	platz	noun	Duolingo
plötzlich	plotzlich	adjective	Duolingo
plötzlich	plotzlich	adverb	Duolingo
plus	plus	adverb	Duolingo
podcasts	podcasts	noun	Duolingo
Polen	polen	noun	Duolingo
politik	politik	noun	Duolingo
politischen	politischen	adjective	Duolingo
polizei	polizei	noun	Duolingo
polizist	polizist	noun	Duolingo
polizistin	polizistin	noun	Duolingo
polnisch	polnisch	noun	Duolingo
pommes	pommes	noun	Duolingo
popcorn	popcorn	noun	Duolingo
popmusik	popmusik	noun	Duolingo
positiv	positiv	adjective	Duolingo
post	post	noun	Duolingo
poster	poster	noun	Duolingo
postkarte	postkarte	noun	Duolingo
postleitzahl	postleitzahl	noun	Duolingo
Prag	prag	proper noun	Duolingo
praktikant	praktikant	noun	Duolingo
praktikanten	praktikanten	noun	Duolingo
praktikantin	praktikantin	noun	Duolingo
praktikum	praktikum	noun	Duolingo
praktisch	praktisch	adjective	Duolingo
Präsentation	prasentation	noun	Duolingo
praxis	praxis	noun	Duolingo
preis	preis	noun	Duolingo
prima	prima	adjective	Duolingo
prima	prima	adverb	Duolingo
prinz	prinz	noun	Duolingo
prinzen	prinzen	noun	Duolingo
prinzessin	prinzessin	noun	Duolingo
privat	privat	adjective	Duolingo
private	private	adjective	Duolingo
privaten	privaten	adjective	Duolingo
pro	pro	preposition	Duolingo
probiert	probiert	verb	Duolingo
problem	problem	noun	Duolingo
probleme	probleme	noun	Duolingo
professor	professor	noun	Duolingo
professorin	professorin	noun	Duolingo
projekt	projekt	noun	Duolingo
proseminar	proseminar	noun	Duolingo
prospekt	prospekt	noun	Duolingo
prost	prost		Duolingo
prozent	prozent	noun	Duolingo
prüfung	prufung	noun	Duolingo
prüfungen	prufungen	noun	Duolingo
pst	pst	interjection	Duolingo
psychologie	psychologie	noun	Duolingo
pudding	pudding	noun	Duolingo
Pudel	pudel	noun	Duolingo
pullover	pullover	noun	Duolingo
pullovern	pullovern	noun	Duolingo
Punkt	punkt	noun	Duolingo
pünktlich	punktlich	adjective	Duolingo
Puppe	puppe	noun	Duolingo
putzen	putzen	verb	Duolingo
putzt	putzt	verb	Duolingo
puzzle	puzzle	noun	Duolingo
puzzles	puzzles	noun	Duolingo
quadratmeter	quadratmeter	noun	Duolingo
quatsch	quatsch	noun	Duolingo
Quiz	quiz	noun	Duolingo
radiergummi	radiergummi	noun	Duolingo
radio	radio	noun	Duolingo
radtour	radtour	noun	Duolingo
rasen	rasen	noun	Duolingo
Rastplatz	rastplatz	noun	Duolingo
rathaus	rathaus	noun	Duolingo
ratschlag	ratschlag	noun	Duolingo
ratte	ratte	noun	Duolingo
ratten	ratten	noun	Duolingo
rauche	rauche	verb	Duolingo
rauchen	rauchen	verb	Duolingo
rauchst	rauchst	verb	Duolingo
raucht	raucht	verb	Duolingo
raum	raum	noun	Duolingo
raus	raus	adverb	Duolingo
realistische	realistische	adjective	Duolingo
rechnung	rechnung	noun	Duolingo
rechnungen	rechnungen	noun	Duolingo
recht	recht	adjective	Duolingo
rechts	rechts	adverb	Duolingo
rechtschreibung	rechtschreibung	noun	Duolingo
rechtzeitig	rechtzeitig	adjective	Duolingo
rede	rede	verb	Duolingo
reduziert	reduziert	adjective	Duolingo
referat	referat	noun	Duolingo
regal	regal	noun	Duolingo
regale	regale	noun	Duolingo
regelmäßig	regelmassig	adjective	Duolingo
regelmäßig	regelmassig	adverb	Duolingo
regen	regen	noun	Duolingo
regenmantel	regenmantel	noun	Duolingo
regenschirm	regenschirm	noun	Duolingo
Regierung	regierung	noun	Duolingo
Region	region	noun	Duolingo
regional	regional	adjective	Duolingo
regnet	regnet	verb	Duolingo
reich	reich	adjective	Duolingo
reiche	reiche	adjective	Duolingo
reicher	reicher	adjective	Duolingo
Reichstagsgebäude	reichstagsgebaude	noun	Duolingo
reicht	reicht	verb	Duolingo
reifen	reifen	noun	Duolingo
reifenpanne	reifenpanne	noun	Duolingo
reihe	reihe	noun	Duolingo
rein	rein		Duolingo
rein	rein	adverb	Duolingo
reinkommen	reinkommen	verb	Duolingo
reis	reis	noun	Duolingo
reise	reise	noun	Duolingo
reiseadapter	reiseadapter	noun	Duolingo
reisebüro	reiseburo	noun	Duolingo
reiseführer	reisefuhrer	noun	Duolingo
Reisetasche	reisetasche	noun	Duolingo
Reisetaschen	reisetaschen	noun	Duolingo
reisezentrum	reisezentrum	noun	Duolingo
relativ	relativ	adjective	Duolingo
renne	renne	verb	Duolingo
rennen	rennen	verb	Duolingo
rennst	rennst	verb	Duolingo
rennt	rennt	verb	Duolingo
reparaturen	reparaturen	noun	Duolingo
Reportage	reportage	noun	Duolingo
reserviert	reserviert	verb	Duolingo
restaurant	restaurant	noun	Duolingo
restaurants	restaurants	noun	Duolingo
rezept	rezept	noun	Duolingo
rezeption	rezeption	noun	Duolingo
rhein	rhein	noun	Duolingo
rheinland-pfalz	rheinland-pfalz		Duolingo
richtig	richtig	adjective	Duolingo
richtige	richtige	adjective	Duolingo
riesenrad	riesenrad	noun	Duolingo
riesig	riesig	adjective	Duolingo
riesige	riesige	adjective	Duolingo
riesigen	riesigen	adjective	Duolingo
Rinderbraten	rinderbraten	noun	Duolingo
rindfleisch	rindfleisch	noun	Duolingo
ring	ring	noun	Duolingo
ringe	ringe	noun	Duolingo
roboter	roboter	noun	Duolingo
rock	rock	noun	Duolingo
röcke	rocke	noun	Duolingo
rockkonzert	rockkonzert	noun	Duolingo
rollschuhe	rollschuhe	noun	Duolingo
rolltreppe	rolltreppe	noun	Duolingo
roman	roman	noun	Duolingo
romantisch	romantisch	adjective	Duolingo
Röntgenbild	rontgenbild	noun	Duolingo
rosa	rosa	adjective	Duolingo
rosa	rosa	adverb	Duolingo
rose	rose	noun	Duolingo
rosen	rosen	noun	Duolingo
rot	rot	adjective	Duolingo
rote	rote	adjective	Duolingo
roten	roten	adjective	Duolingo
rotwein	rotwein	noun	Duolingo
router	router	noun	Duolingo
rücken	rucken	noun	Duolingo
rucksack	rucksack	noun	Duolingo
rückwärts	ruckwarts	adverb	Duolingo
ruf	ruf		Duolingo
ruf	ruf	verb	Duolingo
rugby	rugby	noun	Duolingo
rügen	rugen	proper noun	Duolingo
ruhe	ruhe	noun	Duolingo
ruhig	ruhig	adjective	Duolingo
rund	rund	adjective	Duolingo
Runde	runde	noun	Duolingo
Runden	runden	noun	Duolingo
runtergefallen	runtergefallen	verb	Duolingo
russisch	russisch	noun	Duolingo
russischen	russischen	adjective	Duolingo
russland	russland	proper noun	Duolingo
s	s	adjective	Duolingo
s-bahn	s-bahn		Duolingo
s-bahn	s-bahn	noun	Duolingo
saal	saal	noun	Duolingo
sache	sache	noun	Duolingo
sachen	sachen	noun	Duolingo
sachsen-anhalt	sachsen-anhalt		Duolingo
saft	saft	noun	Duolingo
sag	sag	verb	Duolingo
sag bescheid	sag bescheid		Duolingo
sage	sage	verb	Duolingo
sagen	sagen	verb	Duolingo
sagt	sagt		Duolingo
sagt	sagt	verb	Duolingo
saison	saison	noun	Duolingo
sakko	sakko	noun	Duolingo
salami	salami	noun	Duolingo
salat	salat	noun	Duolingo
salate	salate	noun	Duolingo
salz	salz	noun	Duolingo
salzig	salzig	adjective	Duolingo
samstag	samstag	noun	Duolingo
samstagabend	samstagabend	noun	Duolingo
samstags	samstags	adverb	Duolingo
sandalen	sandalen	noun	Duolingo
sandwich	sandwich	noun	Duolingo
sandwiches	sandwiches	noun	Duolingo
satt	satt	adjective	Duolingo
satz	satz	noun	Duolingo
sauber	sauber	adjective	Duolingo
sauer	sauer	adjective	Duolingo
sauerkraut	sauerkraut	noun	Duolingo
sauna	sauna	noun	Duolingo
schach	schach	noun	Duolingo
schade	schade		Duolingo
schade	schade	interjection	Duolingo
Schaden	schaden	noun	Duolingo
schaf	schaf	noun	Duolingo
schafe	schafe	noun	Duolingo
schäferhund	schaferhund	noun	Duolingo
schal	schal	noun	Duolingo
schalter	schalter	noun	Duolingo
scharf	scharf	adjective	Duolingo
scharfe	scharfe	adjective	Duolingo
scharfen	scharfen	adjective	Duolingo
scharfer	scharfer	adjective	Duolingo
schatz	schatz	noun	Duolingo
schauspieler	schauspieler	noun	Duolingo
schauspielerin	schauspielerin	noun	Duolingo
scheck	scheck	noun	Duolingo
Scheibe	scheibe	noun	Duolingo
scheint	scheint	verb	Duolingo
schere	schere	noun	Duolingo
schick	schick	adjective	Duolingo
schiff	schiff	noun	Duolingo
schiffe	schiffe	noun	Duolingo
schild	schild	noun	Duolingo
schildkröte	schildkrote	noun	Duolingo
Schildkröten	schildkroten	noun	Duolingo
schinken	schinken	noun	Duolingo
schlaf gut	schlaf gut		Duolingo
schlafanzug	schlafanzug	noun	Duolingo
schlafe	schlafe	verb	Duolingo
schlafen	schlafen	verb	Duolingo
schläfst	schlafst	verb	Duolingo
schläft	schlaft	verb	Duolingo
schlafzimmer	schlafzimmer	noun	Duolingo
schlagsahne	schlagsahne	noun	Duolingo
schlagzeug	schlagzeug	noun	Duolingo
schlange	schlange		Duolingo
schlange	schlange	noun	Duolingo
schlau	schlau	adjective	Duolingo
schlecht	schlecht	adjective	Duolingo
schlecht	schlecht	adverb	Duolingo
schlechter	schlechter	adjective	Duolingo
schleswig-holstein	schleswig-holstein		Duolingo
schließlich	schliesslich	adverb	Duolingo
schließt	schliesst	verb	Duolingo
schlimm	schlimm	adjective	Duolingo
Schloss	schloss	noun	Duolingo
schloss schönbrunn	schloss schonbrunn	noun	Duolingo
schluss	schluss	noun	Duolingo
schlüssel	schlussel	noun	Duolingo
schmecken	schmecken	verb	Duolingo
schmeckt	schmeckt	verb	Duolingo
schmidt	schmidt	proper noun	Duolingo
schmuck	schmuck	noun	Duolingo
schmutzig	schmutzig	adjective	Duolingo
schmutzigen	schmutzigen	adjective	Duolingo
schnecke	schnecke	noun	Duolingo
schnee	schnee	noun	Duolingo
schneemann	schneemann	noun	Duolingo
schneidebrett	schneidebrett	noun	Duolingo
schneider	schneider	pronoun	Duolingo
schneit	schneit	verb	Duolingo
schnell	schnell	adjective	Duolingo
schnell	schnell	adverb	Duolingo
schneller	schneller	adjective	Duolingo
schnitzel	schnitzel	noun	Duolingo
schokolade	schokolade	noun	Duolingo
schön	schon		Duolingo
schön	schon	adjective	Duolingo
schon	schon	adverb	Duolingo
schon immer	schon immer		Duolingo
schöne	schone	adjective	Duolingo
schönen	schonen	adjective	Duolingo
schöner	schoner	adjective	Duolingo
schönes	schones	adjective	Duolingo
schönsten	schonsten	adjective	Duolingo
schrank	schrank	noun	Duolingo
schränke	schranke	noun	Duolingo
schränken	schranken	noun	Duolingo
schrecklich	schrecklich	adjective	Duolingo
schreibblock	schreibblock	noun	Duolingo
schreibe	schreibe	verb	Duolingo
schreiben	schreiben	verb	Duolingo
schreibst	schreibst	verb	Duolingo
schreibt	schreibt	verb	Duolingo
schreibtisch	schreibtisch	noun	Duolingo
schublade	schublade	noun	Duolingo
schuh	schuh	noun	Duolingo
schuhe	schuhe	noun	Duolingo
schuhen	schuhen	noun	Duolingo
Schulabschluss	schulabschluss	noun	Duolingo
Schuld	schuld	noun	Duolingo
Schulden	schulden	noun	Duolingo
schuldig	schuldig	adjective	Duolingo
schule	schule	noun	Duolingo
schüler	schuler	noun	Duolingo
Schulranzen	schulranzen	noun	Duolingo
schürze	schurze	noun	Duolingo
schüssel	schussel	noun	Duolingo
schüsseln	schusseln	noun	Duolingo
schwäch	schwach		Duolingo
schwach	schwach	adjective	Duolingo
schwager	schwager	noun	Duolingo
schwägerin	schwagerin	noun	Duolingo
schwanger	schwanger	adjective	Duolingo
schwarz	schwarz	adjective	Duolingo
schwarze	schwarze	adjective	Duolingo
schwarzfahren	schwarzfahren		Duolingo
schwarzwald	schwarzwald	noun	Duolingo
schweden	schweden	proper noun	Duolingo
schwedisch	schwedisch	noun	Duolingo
schwein	schwein	noun	Duolingo
schweine	schweine	noun	Duolingo
Schweinebraten	schweinebraten	noun	Duolingo
schweinefleisch	schweinefleisch	noun	Duolingo
schweiz	schweiz	proper noun	Duolingo
schwer	schwer	adjective	Duolingo
schwer	schwer	adverb	Duolingo
schwerer	schwerer	adjective	Duolingo
schwerin	schwerin	proper noun	Duolingo
schwester	schwester	noun	Duolingo
schwestern	schwestern	noun	Duolingo
Schwiegereltern	schwiegereltern	noun	Duolingo
schwierig	schwierig	adjective	Duolingo
schwimmbad	schwimmbad	noun	Duolingo
schwimmbecken	schwimmbecken	noun	Duolingo
schwimme	schwimme	verb	Duolingo
schwimmen	schwimmen	noun	Duolingo
schwimmen	schwimmen	verb	Duolingo
schwimmsachen	schwimmsachen	noun	Duolingo
schwimmst	schwimmst	verb	Duolingo
schwimmt	schwimmt	verb	Duolingo
schwindelig	schwindelig	adjective	Duolingo
Sechs	sechs	noun	Duolingo
sechs	sechs	numeral	Duolingo
sechshundert	sechshundert	numeral	Duolingo
sechshundertsechsundsechzig	sechshundertsechsundsechzig	numeral	Duolingo
sechsunddreißig	sechsunddreissig	numeral	Duolingo
sechsundfünfzig	sechsundfunfzig	numeral	Duolingo
sechsundsiebzig	sechsundsiebzig	numeral	Duolingo
sechzehn	sechzehn	numeral	Duolingo
sechzig	sechzig	numeral	Duolingo
see	see	noun	Duolingo
sehe	sehe	verb	Duolingo
sehen	sehen	verb	Duolingo
sehr	sehr	adverb	Duolingo
sehr gern	sehr gern		Duolingo
seht	seht	verb	Duolingo
sei	sei	verb	Duolingo
seid	seid	verb	Duolingo
Seide	seide	noun	Duolingo
seien	seien	verb	Duolingo
seife	seife	noun	Duolingo
sein	sein	determiner	Duolingo
sein	sein	pronoun	Duolingo
sein	sein	verb	Duolingo
seine	seine	determiner	Duolingo
seine	seine	pronoun	Duolingo
seinem	seinem	determiner	Duolingo
seinen	seinen	determiner	Duolingo
seinen	seinen	pronoun	Duolingo
seiner	seiner	determiner	Duolingo
seit	seit	preposition	Duolingo
seitdem	seitdem	conjunction	Duolingo
seite	seite	noun	Duolingo
sekt	sekt	noun	Duolingo
sekunde	sekunde	noun	Duolingo
selber	selber	adverb	Duolingo
selbst	selbst	adverb	Duolingo
selbstständig	selbststandig	adjective	Duolingo
selbstverständlich	selbstverstandlich	adjective	Duolingo
selten	selten	adjective	Duolingo
selten	selten	adverb	Duolingo
seltsam	seltsam	adjective	Duolingo
semester	semester	noun	Duolingo
semesterende	semesterende	noun	Duolingo
seminar	seminar	noun	Duolingo
senf	senf	noun	Duolingo
senioren	senioren	noun	Duolingo
september	september	noun	Duolingo
Serviette	serviette	noun	Duolingo
sessel	sessel	noun	Duolingo
shampoo	shampoo	noun	Duolingo
shorts	shorts	noun	Duolingo
sich	sich		Duolingo
sicher	sicher		Duolingo
sicher	sicher	adjective	Duolingo
sicher	sicher	adverb	Duolingo
sichtbar	sichtbar	adjective	Duolingo
sie	sie	pronoun	Duolingo
sieben	sieben	numeral	Duolingo
siebenhundert	siebenhundert	numeral	Duolingo
siebenunddreißig	siebenunddreissig	numeral	Duolingo
siebenundsechzig	siebenundsechzig	numeral	Duolingo
siebten	siebten	adjective	Duolingo
siebzehn	siebzehn	numeral	Duolingo
siebzig	siebzig	numeral	Duolingo
sieger	sieger	noun	Duolingo
siehst	siehst	verb	Duolingo
sieht	sieht	verb	Duolingo
silber	silber	noun	Duolingo
silvester	silvester	noun	Duolingo
Silvesterparty	silvesterparty	noun	Duolingo
simkarte	simkarte	noun	Duolingo
sind	sind	verb	Duolingo
singe	singe	verb	Duolingo
singst	singst	verb	Duolingo
singt	singt	verb	Duolingo
sinn	sinn	noun	Duolingo
sinnvoll	sinnvoll	adjective	Duolingo
situation	situation	noun	Duolingo
sitz	sitz	noun	Duolingo
sitzplatz	sitzplatz	noun	Duolingo
sitzplätze	sitzplatze	noun	Duolingo
sitzt	sitzt	verb	Duolingo
skateboard	skateboard	noun	Duolingo
ski	ski	noun	Duolingo
smartphone	smartphone	noun	Duolingo
sms	sms	noun	Duolingo
snowboard	snowboard	noun	Duolingo
so	so	adverb	Duolingo
so ein Pech	so ein pech		Duolingo
sobald	sobald	conjunction	Duolingo
socke	socke	noun	Duolingo
socken	socken	noun	Duolingo
sodass	sodass	conjunction	Duolingo
soeben	soeben	adverb	Duolingo
sofa	sofa	noun	Duolingo
sofern	sofern	conjunction	Duolingo
sofort	sofort	adverb	Duolingo
software	software	noun	Duolingo
sogar	sogar	adverb	Duolingo
sohn	sohn	noun	Duolingo
söhne	sohne	noun	Duolingo
sohnes	sohnes	noun	Duolingo
solange	solange	conjunction	Duolingo
soll	soll	verb	Duolingo
sollen	sollen	verb	Duolingo
sollte	sollte	verb	Duolingo
sollten	sollten	verb	Duolingo
solltest	solltest	verb	Duolingo
solltet	solltet	verb	Duolingo
somit	somit	adverb	Duolingo
sommer	sommer	noun	Duolingo
sommerjob	sommerjob	noun	Duolingo
sondern	sondern	adverb	Duolingo
sondern	sondern	conjunction	Duolingo
Song	song	noun	Duolingo
sonne	sonne	noun	Duolingo
sonnenbrand	sonnenbrand	noun	Duolingo
sonnenbrille	sonnenbrille	noun	Duolingo
sonnencreme	sonnencreme	noun	Duolingo
sonnig	sonnig	adjective	Duolingo
sonntag	sonntag	noun	Duolingo
sonntags	sonntags	adverb	Duolingo
sonst	sonst	adverb	Duolingo
sonst noch etwas	sonst noch etwas		Duolingo
sorgen	sorgen	noun	Duolingo
sorry	sorry	interjection	Duolingo
sorte	sorte	noun	Duolingo
soße	sosse	noun	Duolingo
soßen	sossen	noun	Duolingo
soweit	soweit	adverb	Duolingo
sowie	sowie	conjunction	Duolingo
sowohl	sowohl	conjunction	Duolingo
soziale	soziale	adjective	Duolingo
sozialen	sozialen	adjective	Duolingo
soziales	soziales	adjective	Duolingo
spa	spa	noun	Duolingo
Spaghetti	spaghetti	noun	Duolingo
spanisch	spanisch	noun	Duolingo
spargel	spargel	noun	Duolingo
spargelzeit	spargelzeit	noun	Duolingo
spaß	spass	noun	Duolingo
spät	spat	adjective	Duolingo
später	spater	adjective	Duolingo
später	spater	adverb	Duolingo
spätestens	spatestens	adverb	Duolingo
spazieren	spazieren	verb	Duolingo
spazieren gehen	spazieren gehen		Duolingo
spaziergang	spaziergang	noun	Duolingo
Speck	speck	noun	Duolingo
speisekarte	speisekarte	noun	Duolingo
speisewagen	speisewagen	noun	Duolingo
spenden	spenden	noun	Duolingo
speziellen	speziellen	adjective	Duolingo
spiegel	spiegel	noun	Duolingo
spiel	spiel	noun	Duolingo
spiele	spiele	noun	Duolingo
spiele	spiele	verb	Duolingo
spielen	spielen	verb	Duolingo
spielplatz	spielplatz	noun	Duolingo
spielst	spielst	verb	Duolingo
spielt	spielt	verb	Duolingo
spielzeug	spielzeug	noun	Duolingo
spielzeuge	spielzeuge	noun	Duolingo
spinat	spinat	noun	Duolingo
spinne	spinne	noun	Duolingo
spinnen	spinnen	noun	Duolingo
spitze	spitze	adjective	Duolingo
sport	sport	noun	Duolingo
sporthalle	sporthalle	noun	Duolingo
sportlich	sportlich	adjective	Duolingo
sportverein	sportverein	noun	Duolingo
Sprache	sprache	noun	Duolingo
sprachen	sprachen	noun	Duolingo
spreche	spreche	verb	Duolingo
sprechen	sprechen		Duolingo
sprechen	sprechen	verb	Duolingo
sprecht	sprecht	verb	Duolingo
sprichst	sprichst	verb	Duolingo
spricht	spricht	verb	Duolingo
spülbecken	spulbecken	noun	Duolingo
spülmaschine	spulmaschine	noun	Duolingo
staatsangehörigkeit	staatsangehorigkeit	noun	Duolingo
stadion	stadion	noun	Duolingo
stadt	stadt	noun	Duolingo
städte	stadte	noun	Duolingo
stadtführung	stadtfuhrung	noun	Duolingo
stadtmuseum	stadtmuseum	noun	Duolingo
stadtplan	stadtplan	noun	Duolingo
stadtviertel	stadtviertel		Duolingo
stadtzentrum	stadtzentrum	noun	Duolingo
staffel	staffel	noun	Duolingo
stall	stall	noun	Duolingo
Stand	stand	noun	Duolingo
ständig	standig	adjective	Duolingo
stärk	stark		Duolingo
stark	stark	adjective	Duolingo
starke	starke	adjective	Duolingo
starken	starken	adjective	Duolingo
stärken	starken	noun	Duolingo
stärker	starker	adjective	Duolingo
station	station	noun	Duolingo
statt	statt		Duolingo
statt	statt	preposition	Duolingo
stattdessen	stattdessen	adverb	Duolingo
stau	stau	noun	Duolingo
steckdose	steckdose	noun	Duolingo
steffi	steffi	proper noun	Duolingo
steht	steht		Duolingo
steif	steif	adjective	Duolingo
stein	stein	noun	Duolingo
stern	stern	noun	Duolingo
sterne	sterne	noun	Duolingo
stiefel	stiefel	noun	Duolingo
stiefeln	stiefeln	noun	Duolingo
stiefmutter	stiefmutter	noun	Duolingo
stiefvater	stiefvater	noun	Duolingo
Stimmen	stimmen	noun	Duolingo
stimmung	stimmung	noun	Duolingo
stipendium	stipendium	noun	Duolingo
stock	stock	noun	Duolingo
Stoff	stoff	noun	Duolingo
stollen	stollen	noun	Duolingo
stolz	stolz	adjective	Duolingo
stoppschild	stoppschild	noun	Duolingo
stornieren	stornieren	verb	Duolingo
strand	strand	noun	Duolingo
straße	strasse	noun	Duolingo
straßen	strassen	noun	Duolingo
straßenbahn	strassenbahn	noun	Duolingo
streit	streit	noun	Duolingo
streng	streng	adjective	Duolingo
stress	stress	noun	Duolingo
stressig	stressig	adjective	Duolingo
Strümpfe	strumpfe	noun	Duolingo
strumpfhose	strumpfhose	noun	Duolingo
strumpfhosen	strumpfhosen	noun	Duolingo
stück	stuck	noun	Duolingo
student	student	noun	Duolingo
studenten	studenten	noun	Duolingo
studentenausweis	studentenausweis	noun	Duolingo
studentenwohnheim	studentenwohnheim	noun	Duolingo
studentin	studentin	noun	Duolingo
studieren	studieren	verb	Duolingo
studierst	studierst	verb	Duolingo
studiert	studiert	verb	Duolingo
studium	studium	noun	Duolingo
stuhl	stuhl	noun	Duolingo
stühle	stuhle	noun	Duolingo
Stunde	stunde	noun	Duolingo
stunden	stunden	noun	Duolingo
stundenplan	stundenplan	noun	Duolingo
sturm	sturm	noun	Duolingo
suchen	suchen	verb	Duolingo
suchst	suchst	verb	Duolingo
sucht	sucht	verb	Duolingo
südafrika	sudafrika	noun	Duolingo
südamerika	sudamerika	noun	Duolingo
süden	suden	noun	Duolingo
super	super	adjective	Duolingo
supermarkt	supermarkt	noun	Duolingo
suppe	suppe	noun	Duolingo
suppen	suppen	noun	Duolingo
surfbrett	surfbrett	noun	Duolingo
surfe	surfe	verb	Duolingo
surfst	surfst	verb	Duolingo
surft	surft	verb	Duolingo
süß	suss	adjective	Duolingo
süße träume	susse traume		Duolingo
süßer	susser	adjective	Duolingo
süßes	susses	adjective	Duolingo
süßigkeiten	sussigkeiten	noun	Duolingo
syrien	syrien	noun	Duolingo
t-shirt	t-shirt	noun	Duolingo
t-shirts	t-shirts	noun	Duolingo
tablette	tablette	noun	Duolingo
Tafel	tafel	noun	Duolingo
tag	tag	noun	Duolingo
tage	tage	noun	Duolingo
tagebuch	tagebuch	noun	Duolingo
tagen	tagen	noun	Duolingo
täglich	taglich	adjective	Duolingo
täglich	taglich	adverb	Duolingo
tank	tank	noun	Duolingo
Tankstelle	tankstelle	noun	Duolingo
tante	tante	noun	Duolingo
tanzen	tanzen	verb	Duolingo
tänzer	tanzer	noun	Duolingo
tanzt	tanzt	verb	Duolingo
tapfer	tapfer	adjective	Duolingo
tasche	tasche	noun	Duolingo
taschen	taschen	noun	Duolingo
taschengeld	taschengeld	noun	Duolingo
taschenrechner	taschenrechner	noun	Duolingo
tasse	tasse	noun	Duolingo
tassen	tassen	noun	Duolingo
tastatur	tastatur	noun	Duolingo
Tatsache	tatsache	noun	Duolingo
tatsächlich	tatsachlich	adjective	Duolingo
tatsächlich	tatsachlich	adverb	Duolingo
tauben	tauben	noun	Duolingo
tausend	tausend	numeral	Duolingo
taxi	taxi	noun	Duolingo
taxifahrt	taxifahrt	noun	Duolingo
taxistand	taxistand	noun	Duolingo
Team	team	noun	Duolingo
technischen	technischen	adjective	Duolingo
technoparty	technoparty	noun	Duolingo
tee	tee	noun	Duolingo
Teekanne	teekanne	noun	Duolingo
teig	teig	noun	Duolingo
teil	teil		Duolingo
teil	teil	noun	Duolingo
teilnehmen	teilnehmen		Duolingo
teilzeit	teilzeit	noun	Duolingo
telefon	telefon	noun	Duolingo
telefone	telefone	noun	Duolingo
telefonieren	telefonieren	verb	Duolingo
telefonnummer	telefonnummer	noun	Duolingo
telefonnummern	telefonnummern	noun	Duolingo
teller	teller	noun	Duolingo
temperaturen	temperaturen	noun	Duolingo
tennis	tennis	noun	Duolingo
teppich	teppich	noun	Duolingo
termin	termin	noun	Duolingo
termine	termine	noun	Duolingo
teuer	teuer	adjective	Duolingo
teuren	teuren	adjective	Duolingo
teurer	teurer	adjective	Duolingo
theater	theater	noun	Duolingo
thema	thema	noun	Duolingo
themen	themen	noun	Duolingo
theoretische	theoretische	adjective	Duolingo
Tickets	tickets	noun	Duolingo
tief	tief	adjective	Duolingo
tier	tier	noun	Duolingo
tierarzt	tierarzt	noun	Duolingo
tierärztin	tierarztin	noun	Duolingo
tiere	tiere	noun	Duolingo
tieren	tieren	noun	Duolingo
tiergarten	tiergarten	noun	Duolingo
tierheim	tierheim	noun	Duolingo
Tipp	tipp	noun	Duolingo
Tipps	tipps	noun	Duolingo
tisch	tisch	noun	Duolingo
tische	tische	noun	Duolingo
toast	toast	noun	Duolingo
toaster	toaster	noun	Duolingo
tochter	tochter	noun	Duolingo
Tofu	tofu	noun	Duolingo
toilette	toilette	noun	Duolingo
toiletten	toiletten	noun	Duolingo
toll	toll	adjective	Duolingo
tomate	tomate	noun	Duolingo
tomaten	tomaten	noun	Duolingo
topf	topf	noun	Duolingo
tor	tor	noun	Duolingo
torte	torte	noun	Duolingo
total	total	adjective	Duolingo
total	total	adverb	Duolingo
touristen	touristen	noun	Duolingo
trage	trage	verb	Duolingo
tragen	tragen	verb	Duolingo
trägst	tragst	verb	Duolingo
trägt	tragt	verb	Duolingo
training	training	noun	Duolingo
trampolin	trampolin	noun	Duolingo
trauben	trauben	noun	Duolingo
traum	traum	noun	Duolingo
traumberuf	traumberuf	noun	Duolingo
traurig	traurig	adjective	Duolingo
treffe	treffe	verb	Duolingo
treffen	treffen	noun	Duolingo
treffen	treffen	verb	Duolingo
treppe	treppe	noun	Duolingo
triffst	triffst	verb	Duolingo
trifft	trifft	verb	Duolingo
Trikots	trikots	noun	Duolingo
trink	trink	verb	Duolingo
trinke	trinke	verb	Duolingo
trinken	trinken	verb	Duolingo
trinkgeld	trinkgeld	noun	Duolingo
trinkst	trinkst	verb	Duolingo
trinkt	trinkt	verb	Duolingo
trocken	trocken	adjective	Duolingo
trockne	trockne		Duolingo
trockner	trockner	noun	Duolingo
trotzdem	trotzdem	adverb	Duolingo
tschechische republik	tschechische republik		Duolingo
tschüss	tschuss	interjection	Duolingo
Tuch	tuch	noun	Duolingo
tun	tun	verb	Duolingo
tür	tur	noun	Duolingo
türkei	turkei	proper noun	Duolingo
türkisch	turkisch	noun	Duolingo
Turm	turm	noun	Duolingo
turnschuhe	turnschuhe	noun	Duolingo
tut	tut	verb	Duolingo
tut mir leid	tut mir leid		Duolingo
tut weh	tut weh		Duolingo
tüte	tute	noun	Duolingo
tüten	tuten	noun	Duolingo
typ	typ	noun	Duolingo
u-bahn	u-bahn		Duolingo
u-bahn	u-bahn	noun	Duolingo
u-bahnstation	u-bahnstation	noun	Duolingo
über	uber		Duolingo
über	uber	adverb	Duolingo
über	uber	preposition	Duolingo
überall	uberall	adverb	Duolingo
übergeben	ubergeben	verb	Duolingo
überhaupt	uberhaupt	adverb	Duolingo
übermorgen	ubermorgen	adverb	Duolingo
überrascht	uberrascht	adjective	Duolingo
überraschung	uberraschung	noun	Duolingo
übers	ubers	preposition	Duolingo
überschrift	uberschrift	noun	Duolingo
überschwemmt	uberschwemmt	verb	Duolingo
Überschwemmung	uberschwemmung	noun	Duolingo
überzeugt	uberzeugt	verb	Duolingo
übrig	ubrig	adjective	Duolingo
übrigen	ubrigen	adjective	Duolingo
übrigens	ubrigens	adverb	Duolingo
übung	ubung	noun	Duolingo
übungen	ubungen	noun	Duolingo
ufo	ufo	noun	Duolingo
uhr	uhr	noun	Duolingo
um	um		Duolingo
um	um	conjunction	Duolingo
um	um	preposition	Duolingo
um die ecke	um die ecke		Duolingo
um wie viel uhr	um wie viel uhr		Duolingo
um zu	um zu		Duolingo
umgezogen	umgezogen	adjective	Duolingo
umkleidekabinen	umkleidekabinen	noun	Duolingo
ums	ums	preposition	Duolingo
umtauschen	umtauschen		Duolingo
umwelt	umwelt	noun	Duolingo
umweltschutz	umweltschutz	noun	Duolingo
umziehen	umziehen	verb	Duolingo
umzug	umzug	noun	Duolingo
unabhängig	unabhangig	adjective	Duolingo
unbedingt	unbedingt	adjective	Duolingo
unbedingt	unbedingt	adverb	Duolingo
unbekannt	unbekannt	adjective	Duolingo
und	und	conjunction	Duolingo
unentschieden	unentschieden	adjective	Duolingo
unerträglich	unertraglich	adjective	Duolingo
unfall	unfall	noun	Duolingo
ungarischer	ungarischer	adjective	Duolingo
ungarn	ungarn	noun	Duolingo
ungefähr	ungefahr	adjective	Duolingo
ungefähr	ungefahr	adverb	Duolingo
ungeheuer	ungeheuer	noun	Duolingo
ungerade	ungerade	adjective	Duolingo
unglaublich	unglaublich	adjective	Duolingo
unglücklich	unglucklich	adjective	Duolingo
unheimlich	unheimlich	adjective	Duolingo
unhöflich	unhoflich	adjective	Duolingo
uniform	uniform	noun	Duolingo
universität	universitat	noun	Duolingo
universität münchen	universitat munchen	noun	Duolingo
universität wien	universitat wien	noun	Duolingo
unmöglich	unmoglich	adjective	Duolingo
unordentlich	unordentlich	adjective	Duolingo
uns	uns		Duolingo
uns	uns	pronoun	Duolingo
unser	unser	determiner	Duolingo
unser	unser	pronoun	Duolingo
unsere	unsere	determiner	Duolingo
unsere	unsere	pronoun	Duolingo
unserem	unserem	determiner	Duolingo
unserem	unserem	pronoun	Duolingo
unseren	unseren	determiner	Duolingo
unseren	unseren	pronoun	Duolingo
unserer	unserer	pronoun	Duolingo
unsichtbar	unsichtbar	adjective	Duolingo
unsinn	unsinn	noun	Duolingo
unten	unten	adverb	Duolingo
unter	unter	preposition	Duolingo
unterricht	unterricht	noun	Duolingo
unterschied	unterschied	noun	Duolingo
unterschiedliche	unterschiedliche	adjective	Duolingo
unterschreiben	unterschreiben	verb	Duolingo
unterschrift	unterschrift	noun	Duolingo
unterwäsche	unterwasche	noun	Duolingo
unterwegs	unterwegs	adverb	Duolingo
unvorbereitet	unvorbereitet	adjective	Duolingo
urlaub	urlaub		Duolingo
urlaub	urlaub	noun	Duolingo
usb	usb		Duolingo
vase	vase	noun	Duolingo
vater	vater	noun	Duolingo
vatertag	vatertag	noun	Duolingo
vegan	vegan	adjective	Duolingo
vegetarier	vegetarier	noun	Duolingo
venedig	venedig	noun	Duolingo
ventilator	ventilator	noun	Duolingo
verabredet	verabredet	adjective	Duolingo
verantwortlich	verantwortlich	adjective	Duolingo
verärgert	verargert	adjective	Duolingo
verbessert	verbessert	verb	Duolingo
verbindung	verbindung	noun	Duolingo
verboten	verboten	adjective	Duolingo
Verein	verein	noun	Duolingo
verfügbar	verfugbar	adjective	Duolingo
verfügbaren	verfugbaren	adjective	Duolingo
vergangenen	vergangenen	adjective	Duolingo
vergessen	vergessen	verb	Duolingo
vergiss	vergiss	verb	Duolingo
verhalten	verhalten	verb	Duolingo
Verhältnis	verhaltnis	noun	Duolingo
verheiratet	verheiratet	adjective	Duolingo
verkehr	verkehr	noun	Duolingo
verkehrsmittel	verkehrsmittel	noun	Duolingo
verkleidet	verkleidet	verb	Duolingo
verlässt	verlasst	verb	Duolingo
verletzt	verletzt	verb	Duolingo
verliebt	verliebt	adjective	Duolingo
verliebt	verliebt	verb	Duolingo
verpasse	verpasse	verb	Duolingo
verpassen	verpassen	verb	Duolingo
verpasst	verpasst		Duolingo
verpasst	verpasst	verb	Duolingo
verpflichtet	verpflichtet	adjective	Duolingo
verreist	verreist		Duolingo
verrückt	verruckt	adjective	Duolingo
verrücktes	verrucktes	adjective	Duolingo
verschiedene	verschiedene	adjective	Duolingo
verschiedenen	verschiedenen	adjective	Duolingo
versichert	versichert	adjective	Duolingo
verspätet	verspatet	verb	Duolingo
verspätung	verspatung	noun	Duolingo
versprochen	versprochen	verb	Duolingo
verstanden	verstanden	verb	Duolingo
Verstecken	verstecken	noun	Duolingo
verstehe	verstehe	verb	Duolingo
verstehen	verstehen	verb	Duolingo
verstehst	verstehst	verb	Duolingo
versteht	versteht	verb	Duolingo
versucht	versucht	verb	Duolingo
Vertrag	vertrag	noun	Duolingo
verursacht	verursacht	verb	Duolingo
verwählt	verwahlt	verb	Duolingo
verwandelt	verwandelt	verb	Duolingo
verwandten	verwandten	noun	Duolingo
verzeihen sie	verzeihen sie		Duolingo
video	video	noun	Duolingo
videos	videos	noun	Duolingo
videospiele	videospiele	noun	Duolingo
viel	viel	adverb	Duolingo
viel	viel	determiner	Duolingo
viel Glück	viel gluck		Duolingo
viel spaß	viel spass		Duolingo
viel zu tun	viel zu tun		Duolingo
viele	viele	adjective	Duolingo
viele	viele	determiner	Duolingo
viele	viele	pronoun	Duolingo
vielen	vielen	determiner	Duolingo
vielen dank	vielen dank		Duolingo
vieler	vieler	determiner	Duolingo
vielfalt	vielfalt	noun	Duolingo
vielleicht	vielleicht	adverb	Duolingo
vier	vier	numeral	Duolingo
viereck	viereck	noun	Duolingo
vierhundert	vierhundert	numeral	Duolingo
viertel	viertel	noun	Duolingo
viertel	viertel	verb	Duolingo
viertelstunde	viertelstunde	noun	Duolingo
vierten	vierten	adjective	Duolingo
vierunddreißig	vierunddreissig	numeral	Duolingo
vierundzwanzig	vierundzwanzig	numeral	Duolingo
vierzehn	vierzehn	numeral	Duolingo
vierzig	vierzig	numeral	Duolingo
virus	virus	noun	Duolingo
visum	visum	noun	Duolingo
vogel	vogel	noun	Duolingo
vögeln	vogeln	noun	Duolingo
vokabeln	vokabeln	noun	Duolingo
voll	voll	adjective	Duolingo
voller	voller	adjective	Duolingo
volleyball	volleyball	noun	Duolingo
völlig	vollig	adjective	Duolingo
vollzeit	vollzeit	noun	Duolingo
vom	vom		Duolingo
vom	vom	preposition	Duolingo
vom bahnhof	vom bahnhof		Duolingo
von	von	preposition	Duolingo
von	von	pronoun	Duolingo
von wann bis wann	von wann bis wann		Duolingo
vor	vor		Duolingo
vor	vor	preposition	Duolingo
vor allem	vor allem		Duolingo
vor Kurzem	vor kurzem		Duolingo
voraus	voraus	adverb	Duolingo
vorbei	vorbei	adverb	Duolingo
vorbereiten	vorbereiten		Duolingo
vorgeschlagen	vorgeschlagen	adjective	Duolingo
vorgestellt	vorgestellt		Duolingo
vorgestern	vorgestern	adverb	Duolingo
vorhang	vorhang	noun	Duolingo
vorhänge	vorhange	noun	Duolingo
vorher	vorher	adverb	Duolingo
vorlesen	vorlesen	verb	Duolingo
vorlesung	vorlesung	noun	Duolingo
vorname	vorname	noun	Duolingo
vorne	vorne	adverb	Duolingo
vorschlag	vorschlag	noun	Duolingo
vorschlagen	vorschlagen	verb	Duolingo
vorsichtig	vorsichtig	adjective	Duolingo
vorstellen	vorstellen		Duolingo
Vorstellungsgespräch	vorstellungsgesprach	noun	Duolingo
vorteile	vorteile	noun	Duolingo
vorwärts	vorwarts	adverb	Duolingo
vorzeigen	vorzeigen		Duolingo
wach	wach	adjective	Duolingo
Wahl	wahl	noun	Duolingo
wahr	wahr	adjective	Duolingo
während	wahrend	conjunction	Duolingo
während	wahrend	preposition	Duolingo
wahrscheinlich	wahrscheinlich	adjective	Duolingo
wahrscheinlich	wahrscheinlich	adverb	Duolingo
wald	wald	noun	Duolingo
wand	wand	noun	Duolingo
wandere	wandere	verb	Duolingo
wandern	wandern	verb	Duolingo
wanderst	wanderst	verb	Duolingo
wandert	wandert	verb	Duolingo
wann	wann		Duolingo
wann	wann	adverb	Duolingo
war	war		Duolingo
war	war	verb	Duolingo
wäre	ware	verb	Duolingo
waren	waren	verb	Duolingo
wäret	waret	verb	Duolingo
wärm	warm		Duolingo
warm	warm	adjective	Duolingo
wärmer	warmer	adjective	Duolingo
Warschau	warschau	proper noun	Duolingo
warst	warst	verb	Duolingo
warten	warten	verb	Duolingo
wartezimmer	wartezimmer	noun	Duolingo
warum	warum		Duolingo
warum	warum	adverb	Duolingo
was	was	pronoun	Duolingo
was für	was fur		Duolingo
was gibt's neues	was gibt's neues		Duolingo
wäsche	wasche	noun	Duolingo
wasche	wasche	verb	Duolingo
waschen	waschen	verb	Duolingo
waschmaschine	waschmaschine	noun	Duolingo
wäschst	waschst	verb	Duolingo
wäscht	wascht	verb	Duolingo
wasser	wasser	noun	Duolingo
wasserflasche	wasserflasche	noun	Duolingo
wasserkocher	wasserkocher	noun	Duolingo
wassermelone	wassermelone	noun	Duolingo
weber	weber	proper noun	Duolingo
website	website	noun	Duolingo
wecker	wecker	noun	Duolingo
weder	weder	conjunction	Duolingo
weg	weg		Duolingo
weg	weg	adverb	Duolingo
weg	weg	noun	Duolingo
wegbeschreibung	wegbeschreibung	noun	Duolingo
wegen	wegen	preposition	Duolingo
weh	weh		Duolingo
weh	weh	verb	Duolingo
weich	weich	adjective	Duolingo
weihnachten	weihnachten	noun	Duolingo
weil	weil	conjunction	Duolingo
wein	wein	noun	Duolingo
weine	weine	verb	Duolingo
weiß	weiss	adjective	Duolingo
weiß	weiss	proper noun	Duolingo
weiß	weiss	verb	Duolingo
weißbier	weissbier	noun	Duolingo
weiße	weisse	adjective	Duolingo
weißen	weissen	adjective	Duolingo
weißes	weisses	adjective	Duolingo
weißt	weisst	verb	Duolingo
weißwein	weisswein	noun	Duolingo
weit	weit	adjective	Duolingo
weit weg	weit weg		Duolingo
weiter	weiter		Duolingo
weiter	weiter	adverb	Duolingo
weitere	weitere	adjective	Duolingo
weiterer	weiterer	adjective	Duolingo
weiteres	weiteres	adjective	Duolingo
weiterhin	weiterhin	adverb	Duolingo
welche	welche	conjunction	Duolingo
welche	welche	determiner	Duolingo
welche farbe	welche farbe		Duolingo
welchem	welchem	determiner	Duolingo
welchen	welchen	determiner	Duolingo
welcher	welcher	determiner	Duolingo
welches	welches	determiner	Duolingo
welt	welt	noun	Duolingo
wem	wem		Duolingo
wem	wem	pronoun	Duolingo
wen	wen		Duolingo
wen	wen	pronoun	Duolingo
wenig	wenig	adverb	Duolingo
wenig	wenig	determiner	Duolingo
weniger	weniger	adverb	Duolingo
weniger als	weniger als		Duolingo
wenigstens	wenigstens	adverb	Duolingo
wenn	wenn	conjunction	Duolingo
wer	wer	conjunction	Duolingo
wer	wer	pronoun	Duolingo
werde	werde	verb	Duolingo
wert	wert	adjective	Duolingo
wertvoll	wertvoll	adjective	Duolingo
wesentlich	wesentlich	adjective	Duolingo
wesentlichen	wesentlichen	adjective	Duolingo
wessen	wessen		Duolingo
wessen	wessen	pronoun	Duolingo
westen	westen	noun	Duolingo
wettbewerb	wettbewerb	noun	Duolingo
wetter	wetter	noun	Duolingo
wettervorhersage	wettervorhersage	noun	Duolingo
wichtig	wichtig	adjective	Duolingo
wichtige	wichtige	adjective	Duolingo
wichtigen	wichtigen	adjective	Duolingo
wichtiger	wichtiger	adjective	Duolingo
wichtiger tag	wichtiger tag		Duolingo
wichtigsten	wichtigsten	adjective	Duolingo
wie	wie		Duolingo
wie	wie	adverb	Duolingo
wie	wie	conjunction	Duolingo
wie	wie	pronoun	Duolingo
wie bitte	wie bitte		Duolingo
wie geht's	wie geht's		Duolingo
wie geht’s	wie geht's		Duolingo
wie ist es	wie ist es		Duolingo
wie lange	wie lange		Duolingo
wie läuft's bei	wie lauft's bei		Duolingo
wie oft	wie oft		Duolingo
wie spät	wie spat		Duolingo
wie viel	wie viel		Duolingo
wie viel uhr	wie viel uhr		Duolingo
wie viele	wie viele		Duolingo
wie wäre es mit	wie ware es mit		Duolingo
wieder	wieder	adverb	Duolingo
wieder da	wieder da		Duolingo
wiederholen	wiederholen	verb	Duolingo
wiederzusehen	wiederzusehen		Duolingo
wien	wien	proper noun	Duolingo
wiese	wiese	noun	Duolingo
wiesn-herz	wiesn-herz	noun	Duolingo
wieso	wieso	adverb	Duolingo
wieviel	wieviel	adverb	Duolingo
will	will	verb	Duolingo
willkommen	willkommen	adjective	Duolingo
wind	wind	noun	Duolingo
windig	windig	adjective	Duolingo
winter	winter	noun	Duolingo
winterstiefel	winterstiefel	noun	Duolingo
wir	wir	pronoun	Duolingo
wird	wird	verb	Duolingo
wirklich	wirklich	adjective	Duolingo
wirklich	wirklich	adverb	Duolingo
wirst	wirst	verb	Duolingo
witz	witz	noun	Duolingo
witze	witze	noun	Duolingo
witzig	witzig	adjective	Duolingo
witziger	witziger	adjective	Duolingo
wlan	wlan	noun	Duolingo
wo	wo	adverb	Duolingo
woche	woche	noun	Duolingo
wochen	wochen	noun	Duolingo
wochenende	wochenende	noun	Duolingo
wochenmarkt	wochenmarkt	noun	Duolingo
wöchentlich	wochentlich	adjective	Duolingo
wöchentlich	wochentlich	adverb	Duolingo
wofür	wofur		Duolingo
wofür	wofur	adverb	Duolingo
woher	woher		Duolingo
woher	woher	adverb	Duolingo
wohin	wohin		Duolingo
wohin	wohin	adverb	Duolingo
wohl	wohl		Duolingo
wohl	wohl	adverb	Duolingo
wohnen	wohnen	verb	Duolingo
wohnst	wohnst	verb	Duolingo
wohnung	wohnung	noun	Duolingo
Wohnungen	wohnungen	noun	Duolingo
wohnzimmer	wohnzimmer	noun	Duolingo
wollen	wollen	verb	Duolingo
wollt	wollt	verb	Duolingo
wollte	wollte	verb	Duolingo
wolltest	wolltest	verb	Duolingo
womit	womit		Duolingo
womit	womit	adverb	Duolingo
wonach	wonach		Duolingo
wonach	wonach	adverb	Duolingo
woran	woran		Duolingo
woran	woran	adverb	Duolingo
worauf	worauf	adverb	Duolingo
woraus	woraus		Duolingo
wort	wort	noun	Duolingo
wörter	worter	noun	Duolingo
wörterbuch	worterbuch	noun	Duolingo
worüber	woruber		Duolingo
worüber	woruber	adverb	Duolingo
worum	worum		Duolingo
worum	worum	adverb	Duolingo
wovon	wovon		Duolingo
wovon	wovon	adverb	Duolingo
wow	wow	interjection	Duolingo
wozu	wozu	adverb	Duolingo
wunderbar	wunderbar	adjective	Duolingo
wunderschön	wunderschon	adjective	Duolingo
Wunsch	wunsch	noun	Duolingo
Wünsche	wunsche	noun	Duolingo
wünschte	wunschte	verb	Duolingo
würde	wurde	verb	Duolingo
würden	wurden	verb	Duolingo
wurm	wurm	noun	Duolingo
wurst	wurst	noun	Duolingo
würstchen	wurstchen	noun	Duolingo
wusste	wusste	verb	Duolingo
wusstest	wusstest	verb	Duolingo
yoga	yoga	noun	Duolingo
yogamatte	yogamatte	noun	Duolingo
zahl	zahl	verb	Duolingo
zahle	zahle	verb	Duolingo
zahlen	zahlen	verb	Duolingo
zahlst	zahlst	verb	Duolingo
zahnarzt	zahnarzt	noun	Duolingo
zahnärztin	zahnarztin	noun	Duolingo
zahnbürste	zahnburste	noun	Duolingo
zähne	zahne	noun	Duolingo
zahnschmerzen	zahnschmerzen	noun	Duolingo
zahnspange	zahnspange	noun	Duolingo
zeh	zeh	noun	Duolingo
zehn	zehn	numeral	Duolingo
zehntausend	zehntausend	numeral	Duolingo
zehnte	zehnte	adjective	Duolingo
zehnten	zehnten	adjective	Duolingo
zeichentrickfilme	zeichentrickfilme	noun	Duolingo
zeichne	zeichne	verb	Duolingo
zeichnung	zeichnung	noun	Duolingo
zeige	zeige	verb	Duolingo
zeigt	zeigt	verb	Duolingo
zeit	zeit	noun	Duolingo
zeitschrift	zeitschrift	noun	Duolingo
zeitschriften	zeitschriften	noun	Duolingo
zeitung	zeitung	noun	Duolingo
zeitungen	zeitungen	noun	Duolingo
zelt	zelt	noun	Duolingo
zentrum	zentrum	noun	Duolingo
zerbrochen	zerbrochen	verb	Duolingo
Zettel	zettel	noun	Duolingo
zeugnis	zeugnis	noun	Duolingo
ziege	ziege	noun	Duolingo
ziel	ziel	noun	Duolingo
ziemlich	ziemlich	adverb	Duolingo
ziffer	ziffer	noun	Duolingo
zig	zig	pronoun	Duolingo
zigarette	zigarette	noun	Duolingo
zigaretten	zigaretten	noun	Duolingo
zimmer	zimmer	noun	Duolingo
zirkus	zirkus	noun	Duolingo
zitrone	zitrone	noun	Duolingo
zoll	zoll	noun	Duolingo
zoo	zoo	noun	Duolingo
zu	zu		Duolingo
zu	zu	adverb	Duolingo
zu	zu	conjunction	Duolingo
zu	zu	preposition	Duolingo
zu abend	zu abend		Duolingo
zu fuß	zu fuss		Duolingo
zu hause	zu hause		Duolingo
zu mittag	zu mittag		Duolingo
zu weihnachten	zu weihnachten		Duolingo
zucker	zucker	noun	Duolingo
zuerst	zuerst	adverb	Duolingo
zufällig	zufallig	adverb	Duolingo
zufälliger	zufalliger	adjective	Duolingo
zufrieden	zufrieden	adjective	Duolingo
zug	zug	noun	Duolingo
Zugang	zugang	noun	Duolingo
zugehört	zugehort		Duolingo
zugemacht	zugemacht	verb	Duolingo
zugleich	zugleich	adverb	Duolingo
zugtür	zugtur	noun	Duolingo
zukunft	zukunft	noun	Duolingo
zuletzt	zuletzt	adverb	Duolingo
zum	zum		Duolingo
zum	zum	preposition	Duolingo
zum	zum	pronoun	Duolingo
zum abendessen	zum abendessen		Duolingo
zum arzt	zum arzt		Duolingo
zum beispiel	zum beispiel		Duolingo
zum flughafen	zum flughafen		Duolingo
zum friseur	zum friseur		Duolingo
zum frühstück	zum fruhstuck		Duolingo
zum glück	zum gluck		Duolingo
zum halben preis	zum halben preis		Duolingo
zum mittagessen	zum mittagessen		Duolingo
zum oktoberfest	zum oktoberfest		Duolingo
zum schalter	zum schalter		Duolingo
zum strand	zum strand		Duolingo
zum zahnarzt	zum zahnarzt		Duolingo
zumachen	zumachen		Duolingo
zumindest	zumindest	adverb	Duolingo
zur	zur		Duolingo
zur	zur	preposition	Duolingo
zur	zur	pronoun	Duolingo
zur bank	zur bank		Duolingo
zur botschaft	zur botschaft		Duolingo
zur friseurin	zur friseurin		Duolingo
zur party	zur party		Duolingo
zur polizistin	zur polizistin		Duolingo
zürich	zurich	proper noun	Duolingo
zurück	zuruck		Duolingo
zurück	zuruck	adverb	Duolingo
zurückbekommen	zuruckbekommen		Duolingo
zurückgeben	zuruckgeben		Duolingo
zurückgerufen	zuruckgerufen	verb	Duolingo
zurückkommen	zuruckkommen		Duolingo
zurzeit	zurzeit	adverb	Duolingo
zusammen	zusammen	adverb	Duolingo
zusätzliche	zusatzliche	adjective	Duolingo
zusätzlichen	zusatzlichen	adjective	Duolingo
zuständig	zustandig	adjective	Duolingo
zuständigen	zustandigen	adjective	Duolingo
zustimmen	zustimmen	verb	Duolingo
zuvor	zuvor	adverb	Duolingo
zwanzig	zwanzig	numeral	Duolingo
zwei	zwei	numeral	Duolingo
zweifellos	zweifellos	adjective	Duolingo
zweihundert	zweihundert	numeral	Duolingo
zweimal	zweimal	adverb	Duolingo
zweitausend	zweitausend	numeral	Duolingo
zweitausendundfünfzehn	zweitausendundfunfzehn	numeral	Duolingo
zweite	zweite	adjective	Duolingo
zweiten	zweiten	adjective	Duolingo
zweitens	zweitens	adverb	Duolingo
zweiundachtzig	zweiundachtzig	numeral	Duolingo
zweiunddreißig	zweiunddreissig	numeral	Duolingo
zweiundvierzig	zweiundvierzig	numeral	Duolingo
zweiundzwanzig	zweiundzwanzig	numeral	Duolingo
zwiebel	zwiebel	noun	Duolingo
zwiebeln	zwiebeln	noun	Duolingo
zwischen	zwischen	preposition	Duolingo
zwölf	zwolf	numeral	Duolingo
zwölften	zwolften	adjective	Duolingo
zypern	zypern	noun	Duolingo
