learnable	normalized	partOfSpeech	source
1887	1887		Duolingo
1905	1905		Duolingo
abelo	abelo		Duolingo
abeloj	abeloj		Duolingo
abelon	abelon		Duolingo
absolute	absolute		Duolingo
aĉetas	acetas		Duolingo
aĉeti	aceti		Duolingo
aĉetis	acetis		Duolingo
adamo	adamo		Duolingo
adreso	adreso		Duolingo
adreson	adreson		Duolingo
afabla	afabla		Duolingo
afablaj	afablaj		Duolingo
afero	afero		Duolingo
afiŝi	afisi		Duolingo
afiŝis	afisis		Duolingo
afiŝo	afiso		Duolingo
afiŝoj	afisoj		Duolingo
afiŝon	afison		Duolingo
afiŝos	afisos		Duolingo
afriko	afriko		Duolingo
agas	agas		Duolingo
agi	agi		Duolingo
aĝo	ago		Duolingo
aĝon	agon		Duolingo
agrabla	agrabla		Duolingo
agrablan	agrablan		Duolingo
ajlo	ajlo		Duolingo
ajlon	ajlon		Duolingo
ajn	ajn		Duolingo
akceptas	akceptas		Duolingo
akcepti	akcepti		Duolingo
akiri	akiri		Duolingo
akiris	akiris		Duolingo
akrajn	akrajn		Duolingo
akran	akran		Duolingo
aktoro	aktoro		Duolingo
aktoroj	aktoroj		Duolingo
aktuale	aktuale		Duolingo
akurate	akurate		Duolingo
akvo	akvo		Duolingo
akvon	akvon		Duolingo
al	al		Duolingo
albumo	albumo		Duolingo
albumon	albumon		Duolingo
aldonis	aldonis		Duolingo
aldonu	aldonu		Duolingo
alia	alia		Duolingo
aliaj	aliaj		Duolingo
alian	alian		Duolingo
alie	alie		Duolingo
aliflanke	aliflanke		Duolingo
aligatoro	aligatoro		Duolingo
aligatoroj	aligatoroj		Duolingo
aligatorojn	aligatorojn		Duolingo
aliĝi	aligi		Duolingo
aliĝu	aligu		Duolingo
alklaki	alklaki		Duolingo
alklakis	alklakis		Duolingo
almenaŭ	almenau		Duolingo
alŝutas	alsutas		Duolingo
alŝuti	alsuti		Duolingo
alŝutis	alsutis		Duolingo
alŝutus	alsutus		Duolingo
alta	alta		Duolingo
altaj	altaj		Duolingo
alvenis	alvenis		Duolingo
alvenos	alvenos		Duolingo
amas	amas		Duolingo
ambaŭ	ambau		Duolingo
ami	ami		Duolingo
amikino	amikino		Duolingo
amikinoj	amikinoj		Duolingo
amiko	amiko		Duolingo
amikoj	amikoj		Duolingo
amis	amis		Duolingo
amos	amos		Duolingo
amuzi	amuzi		Duolingo
amuzis	amuzis		Duolingo
analizi	analizi		Duolingo
ananaso	ananaso		Duolingo
ananasoj	ananasoj		Duolingo
ananasojn	ananasojn		Duolingo
ananason	ananason		Duolingo
anaso	anaso		Duolingo
anason	anason		Duolingo
angla	angla		Duolingo
anglan	anglan		Duolingo
ankaŭ	ankau		Duolingo
ankoraŭ	ankorau		Duolingo
ano	ano		Duolingo
anoj	anoj		Duolingo
anstataŭ	anstatau		Duolingo
antaŭ	antau		Duolingo
antaŭe	antaue		Duolingo
antaŭen	antauen		Duolingo
antikva	antikva		Duolingo
antikvajn	antikvajn		Duolingo
apartamento	apartamento		Duolingo
apartamentoj	apartamentoj		Duolingo
apartamenton	apartamenton		Duolingo
aparte	aparte		Duolingo
apartigis	apartigis		Duolingo
apartigu	apartigu		Duolingo
apenaŭ	apenau		Duolingo
aperi	aperi		Duolingo
aperigis	aperigis		Duolingo
aperigos	aperigos		Duolingo
aperis	aperis		Duolingo
apetito	apetito		Duolingo
apetiton	apetiton		Duolingo
apliki	apliki		Duolingo
aprilo	aprilo		Duolingo
apud	apud		Duolingo
araneo	araneo		Duolingo
araneoj	araneoj		Duolingo
araneojn	araneojn		Duolingo
arbaro	arbaro		Duolingo
arbo	arbo		Duolingo
arboj	arboj		Duolingo
argentinanoj	argentinanoj		Duolingo
argentino	argentino		Duolingo
arkitekto	arkitekto		Duolingo
arkitektoj	arkitektoj		Duolingo
aro	aro		Duolingo
artikoj	artikoj		Duolingo
artisto	artisto		Duolingo
artistoj	artistoj		Duolingo
arto	arto		Duolingo
arton	arton		Duolingo
asocio	asocio		Duolingo
asocion	asocion		Duolingo
aspektas	aspektas		Duolingo
aspektis	aspektis		Duolingo
atendas	atendas		Duolingo
atendi	atendi		Duolingo
atendu	atendu		Duolingo
atenta	atenta		Duolingo
atentaj	atentaj		Duolingo
atingi	atingi		Duolingo
atingos	atingos		Duolingo
aŭ	au		Duolingo
aŭdas	audas		Duolingo
aŭdi	audi		Duolingo
aŭdis	audis		Duolingo
aŭdos	audos		Duolingo
aŭgusto	augusto		Duolingo
aŭskultas	auskultas		Duolingo
aŭskulti	auskulti		Duolingo
aŭskultu	auskultu		Duolingo
aŭstralio	australio		Duolingo
aŭto	auto		Duolingo
aŭtoj	autoj		Duolingo
aŭtomate	automate		Duolingo
aŭtomato	automato		Duolingo
aŭton	auton		Duolingo
aŭtuno	autuno		Duolingo
avenuo	avenuo		Duolingo
avino	avino		Duolingo
avo	avo		Duolingo
avoj	avoj		Duolingo
avojn	avojn		Duolingo
azio	azio		Duolingo
babilas	babilas		Duolingo
babilejo	babilejo		Duolingo
babilejon	babilejon		Duolingo
babilu	babilu		Duolingo
babilus	babilus		Duolingo
balai	balai		Duolingo
balailon	balailon		Duolingo
baldaŭ	baldau		Duolingo
baleno	baleno		Duolingo
balenojn	balenojn		Duolingo
bananoj	bananoj		Duolingo
bananojn	bananojn		Duolingo
banas	banas		Duolingo
banĉambro	bancambro		Duolingo
banis	banis		Duolingo
bantukoj	bantukoj		Duolingo
bantukojn	bantukojn		Duolingo
bantukon	bantukon		Duolingo
baterio	baterio		Duolingo
baterioj	baterioj		Duolingo
baterion	baterion		Duolingo
bebo	bebo		Duolingo
beboj	beboj		Duolingo
bedaŭras	bedauras		Duolingo
bela	bela		Duolingo
belaj	belaj		Duolingo
belajn	belajn		Duolingo
belan	belan		Duolingo
bele	bele		Duolingo
besto	besto		Duolingo
bestoĝardeno	bestogardeno		Duolingo
bestoĝardenon	bestogardenon		Duolingo
bestoj	bestoj		Duolingo
bestojn	bestojn		Duolingo
beston	beston		Duolingo
bezonas	bezonas		Duolingo
bezonis	bezonis		Duolingo
bezonos	bezonos		Duolingo
bieno	bieno		Duolingo
bienoj	bienoj		Duolingo
bieron	bieron		Duolingo
bildo	bildo		Duolingo
bildon	bildon		Duolingo
birdo	birdo		Duolingo
birdoj	birdoj		Duolingo
birdojn	birdojn		Duolingo
birdon	birdon		Duolingo
biskvitoj	biskvitoj		Duolingo
biskvitojn	biskvitojn		Duolingo
blanka	blanka		Duolingo
blankan	blankan		Duolingo
blinda	blinda		Duolingo
blua	blua		Duolingo
bluaj	bluaj		Duolingo
bluajn	bluajn		Duolingo
bluan	bluan		Duolingo
bofratino	bofratino		Duolingo
bofrato	bofrato		Duolingo
bogepatroj	bogepatroj		Duolingo
bona	bona		Duolingo
bonaj	bonaj		Duolingo
bonajn	bonajn		Duolingo
bonan	bonan		Duolingo
bonan matenon	bonan matenon		Duolingo
bonan nokton	bonan nokton		Duolingo
bonan tagon	bonan tagon		Duolingo
bonan vesperon	bonan vesperon		Duolingo
bone	bone		Duolingo
bonega	bonega		Duolingo
bonegan	bonegan		Duolingo
bongusta	bongusta		Duolingo
bongustan	bongustan		Duolingo
bongustas	bongustas		Duolingo
bonulo	bonulo		Duolingo
bonuloj	bonuloj		Duolingo
bonvenigas	bonvenigas		Duolingo
bonvenigos	bonvenigos		Duolingo
bonvenon	bonvenon		Duolingo
bonvolu	bonvolu		Duolingo
bopatrino	bopatrino		Duolingo
bopatrinon	bopatrinon		Duolingo
bopatron	bopatron		Duolingo
botelo	botelo		Duolingo
boteloj	boteloj		Duolingo
boto	boto		Duolingo
botoj	botoj		Duolingo
botojn	botojn		Duolingo
boton	boton		Duolingo
bovaĵo	bovajo		Duolingo
bovaĵon	bovajon		Duolingo
bovino	bovino		Duolingo
bovinoj	bovinoj		Duolingo
bovinojn	bovinojn		Duolingo
bovlo	bovlo		Duolingo
bovlojn	bovlojn		Duolingo
brakhorloĝo	brakhorlogo		Duolingo
brakhorloĝoj	brakhorlogoj		Duolingo
brakhorloĝon	brakhorlogon		Duolingo
brako	brako		Duolingo
brakoj	brakoj		Duolingo
brazilanoj	brazilanoj		Duolingo
brazilo	brazilo		Duolingo
brazilon	brazilon		Duolingo
bretaro	bretaro		Duolingo
bretaron	bretaron		Duolingo
breto	breto		Duolingo
breton	breton		Duolingo
brilas	brilas		Duolingo
britio	britio		Duolingo
brosas	brosas		Duolingo
brosis	brosis		Duolingo
broso	broso		Duolingo
broson	broson		Duolingo
bruligis	bruligis		Duolingo
bruligu	bruligu		Duolingo
brulis	brulis		Duolingo
bruna	bruna		Duolingo
brunaj	brunaj		Duolingo
brunan	brunan		Duolingo
brusto	brusto		Duolingo
buntaj	buntaj		Duolingo
buntajn	buntajn		Duolingo
buŝo	buso		Duolingo
busoj	busoj		Duolingo
buŝon	buson		Duolingo
butero	butero		Duolingo
buteron	buteron		Duolingo
butiko	butiko		Duolingo
butikon	butikon		Duolingo
butonojn	butonojn		Duolingo
butonon	butonon		Duolingo
ĉambro	cambro		Duolingo
ĉambroj	cambroj		Duolingo
ĉambron	cambron		Duolingo
ĉapelo	capelo		Duolingo
ĉapelojn	capelojn		Duolingo
ĉapelon	capelon		Duolingo
ĉapo	capo		Duolingo
ĉapon	capon		Duolingo
ĉar	car		Duolingo
ĉe	ce		Duolingo
ĉeestas	ceestas		Duolingo
ĉeesti	ceesti		Duolingo
ĉeestu	ceestu		Duolingo
ĉefa	cefa		Duolingo
ĉefe	cefe		Duolingo
ĉefo	cefo		Duolingo
ĉefon	cefon		Duolingo
ĉefurbo	cefurbo		Duolingo
ĉeĥa	ceha		Duolingo
ĉeĥan	cehan		Duolingo
ĉeĥio	cehio		Duolingo
celis	celis		Duolingo
celon	celon		Duolingo
ĉemizo	cemizo		Duolingo
ĉemizon	cemizon		Duolingo
cent	cent		Duolingo
centra	centra		Duolingo
centro	centro		Duolingo
cepoj	cepoj		Duolingo
cepojn	cepojn		Duolingo
cepon	cepon		Duolingo
certa	certa		Duolingo
certe	certe		Duolingo
ĉesis	cesis		Duolingo
ĉesu	cesu		Duolingo
ĉevalo	cevalo		Duolingo
ĉevaloj	cevaloj		Duolingo
ĉevalojn	cevalojn		Duolingo
ĉevalon	cevalon		Duolingo
ĉi	ci		Duolingo
ĉi-nokte	ci-nokte		Duolingo
ĉia	cia		Duolingo
ĉiaj	ciaj		Duolingo
ĉiam	ciam		Duolingo
ĉie	cie		Duolingo
ĉiel	ciel		Duolingo
ĉielarko	cielarko		Duolingo
ĉielarkon	cielarkon		Duolingo
ĉielo	cielo		Duolingo
ĉielon	cielon		Duolingo
ĉien	cien		Duolingo
ĉies	cies		Duolingo
ĉilio	cilio		Duolingo
ĉinio	cinio		Duolingo
ĉinion	cinion		Duolingo
ĉinoj	cinoj		Duolingo
ĉio	cio		Duolingo
ĉion	cion		Duolingo
ĉirkaŭ	cirkau		Duolingo
ĉiu	ciu		Duolingo
ĉiuj	ciuj		Duolingo
ĉiujare	ciujare		Duolingo
ĉiutage	ciutage		Duolingo
ĉokolada	cokolada		Duolingo
ĉokoladaj	cokoladaj		Duolingo
ĉokoladan	cokoladan		Duolingo
ĉokoladon	cokoladon		Duolingo
ĉu	cu		Duolingo
da	da		Duolingo
dancas	dancas		Duolingo
danci	danci		Duolingo
dancis	dancis		Duolingo
dancisto	dancisto		Duolingo
dancistoj	dancistoj		Duolingo
danco	danco		Duolingo
dancojn	dancojn		Duolingo
dancon	dancon		Duolingo
danĝera	dangera		Duolingo
danĝeraj	dangeraj		Duolingo
danĝerajn	dangerajn		Duolingo
danĝere	dangere		Duolingo
dankas	dankas		Duolingo
danki	danki		Duolingo
dankon	dankon		Duolingo
dato	dato		Duolingo
daton	daton		Duolingo
daŭras	dauras		Duolingo
daŭri	dauri		Duolingo
daŭrigi	daurigi		Duolingo
daŭros	dauros		Duolingo
de	de		Duolingo
decembro	decembro		Duolingo
decembron	decembron		Duolingo
decidi	decidi		Duolingo
decidis	decidis		Duolingo
decidos	decidos		Duolingo
dek	dek		Duolingo
dekan	dekan		Duolingo
dekono	dekono		Duolingo
dekstra	dekstra		Duolingo
dekstran	dekstran		Duolingo
dekstren	dekstren		Duolingo
demandas	demandas		Duolingo
demandis	demandis		Duolingo
demando	demando		Duolingo
demandoj	demandoj		Duolingo
demandojn	demandojn		Duolingo
demandon	demandon		Duolingo
demandos	demandos		Duolingo
demetas	demetas		Duolingo
denove	denove		Duolingo
dento	dento		Duolingo
dentojn	dentojn		Duolingo
des	des		Duolingo
deserto	deserto		Duolingo
desertojn	desertojn		Duolingo
deserton	deserton		Duolingo
detaloj	detaloj		Duolingo
devas	devas		Duolingo
devigas	devigas		Duolingo
devigis	devigis		Duolingo
devigos	devigos		Duolingo
devintus	devintus		Duolingo
devus	devus		Duolingo
dezerto	dezerto		Duolingo
dezertoj	dezertoj		Duolingo
deziras	deziras		Duolingo
diamanto	diamanto		Duolingo
diamantoj	diamantoj		Duolingo
difinas	difinas		Duolingo
difinon	difinon		Duolingo
dika	dika		Duolingo
dimanĉe	dimance		Duolingo
dimanĉo	dimanco		Duolingo
diplomato	diplomato		Duolingo
diplomatoj	diplomatoj		Duolingo
diplomatojn	diplomatojn		Duolingo
diras	diras		Duolingo
direkto	direkto		Duolingo
diri	diri		Duolingo
diris	diris		Duolingo
diros	diros		Duolingo
disiĝi	disigi		Duolingo
disiĝis	disigis		Duolingo
disvastigis	disvastigis		Duolingo
disvastigus	disvastigus		Duolingo
diveni	diveni		Duolingo
divenis	divenis		Duolingo
divenu	divenu		Duolingo
diversaj	diversaj		Duolingo
diversajn	diversajn		Duolingo
do	do		Duolingo
dolaroj	dolaroj		Duolingo
dolarojn	dolarojn		Duolingo
dolĉa	dolca		Duolingo
dolĉaj	dolcaj		Duolingo
dolĉan	dolcan		Duolingo
doloras	doloras		Duolingo
doloro	doloro		Duolingo
doloron	doloron		Duolingo
domo	domo		Duolingo
domoj	domoj		Duolingo
domojn	domojn		Duolingo
donacojn	donacojn		Duolingo
donacon	donacon		Duolingo
donas	donas		Duolingo
doni	doni		Duolingo
donu	donu		Duolingo
dormas	dormas		Duolingo
dormĉambro	dormcambro		Duolingo
dormĉambron	dormcambron		Duolingo
dormetas	dormetas		Duolingo
dormeti	dormeti		Duolingo
dormeto	dormeto		Duolingo
dormis	dormis		Duolingo
dormos	dormos		Duolingo
dormu	dormu		Duolingo
dorso	dorso		Duolingo
dorson	dorson		Duolingo
dosiero	dosiero		Duolingo
dosieroj	dosieroj		Duolingo
dosierujo	dosierujo		Duolingo
dosierujon	dosierujon		Duolingo
du	du		Duolingo
dua	dua		Duolingo
dubas	dubas		Duolingo
dudek	dudek		Duolingo
dudek-dua	dudek-dua		Duolingo
dudek-tria	dudek-tria		Duolingo
dudek-unua	dudek-unua		Duolingo
dudeka	dudeka		Duolingo
dudekan	dudekan		Duolingo
dufoje	dufoje		Duolingo
dum	dum		Duolingo
dungas	dungas		Duolingo
dungi	dungi		Duolingo
dungis	dungis		Duolingo
duo	duo		Duolingo
duono	duono		Duolingo
duonon	duonon		Duolingo
duŝas	dusas		Duolingo
duŝis	dusis		Duolingo
duŝos	dusos		Duolingo
ebena	ebena		Duolingo
ebenan	ebenan		Duolingo
ebla	ebla		Duolingo
eble	eble		Duolingo
eblo	eblo		Duolingo
ebloj	ebloj		Duolingo
eĉ	ec		Duolingo
edziĝi	edzigi		Duolingo
edziniĝis	edzinigis		Duolingo
edzino	edzino		Duolingo
edzo	edzo		Duolingo
efektive	efektive		Duolingo
egalas	egalas		Duolingo
ege	ege		Duolingo
ejo	ejo		Duolingo
ek	ek		Duolingo
ekde	ekde		Duolingo
ekrano	ekrano		Duolingo
ekranoj	ekranoj		Duolingo
ekranon	ekranon		Duolingo
ekster	ekster		Duolingo
ekzemple	ekzemple		Duolingo
ekzercas	ekzercas		Duolingo
ekzerci	ekzerci		Duolingo
ekzistas	ekzistas		Duolingo
el	el		Duolingo
eliri	eliri		Duolingo
eliris	eliris		Duolingo
eliros	eliros		Duolingo
elsaluti	elsaluti		Duolingo
elsalutu	elsalutu		Duolingo
elŝutas	elsutas		Duolingo
elŝuti	elsuti		Duolingo
elŝutos	elsutos		Duolingo
elŝutus	elsutus		Duolingo
emociojn	emociojn		Duolingo
en	en		Duolingo
enhavas	enhavas		Duolingo
enirejo	enirejo		Duolingo
enirejon	enirejon		Duolingo
eniri	eniri		Duolingo
eniru	eniru		Duolingo
enlitiĝas	enlitigas		Duolingo
enlitiĝi	enlitigi		Duolingo
ensaluti	ensaluti		Duolingo
ensalutis	ensalutis		Duolingo
entute	entute		Duolingo
enuas	enuas		Duolingo
enuiga	enuiga		Duolingo
enuigis	enuigis		Duolingo
enuigu	enuigu		Duolingo
enuis	enuis		Duolingo
enuos	enuos		Duolingo
erari	erari		Duolingo
eraro	eraro		Duolingo
eraroj	eraroj		Duolingo
esperanta	esperanta		Duolingo
esperantan	esperantan		Duolingo
esperantisto	esperantisto		Duolingo
esperantistoj	esperantistoj		Duolingo
esperanto	esperanto		Duolingo
esperanton	esperanton		Duolingo
esperas	esperas		Duolingo
esperis	esperis		Duolingo
esprimi	esprimi		Duolingo
esprimu	esprimu		Duolingo
estas	estas		Duolingo
esti	esti		Duolingo
estis	estis		Duolingo
estos	estos		Duolingo
estraro	estraro		Duolingo
estro	estro		Duolingo
estron	estron		Duolingo
estu	estu		Duolingo
estus	estus		Duolingo
eta	eta		Duolingo
etaĝo	etago		Duolingo
etaĝojn	etagojn		Duolingo
etajn	etajn		Duolingo
eterna	eterna		Duolingo
eterne	eterne		Duolingo
eŭroj	euroj		Duolingo
eŭrojn	eurojn		Duolingo
eŭropajn	europajn		Duolingo
eŭropano	europano		Duolingo
eŭropanoj	europanoj		Duolingo
eŭropo	europo		Duolingo
evidenta	evidenta		Duolingo
evidente	evidente		Duolingo
facila	facila		Duolingo
facile	facile		Duolingo
fadeno	fadeno		Duolingo
fadenon	fadenon		Duolingo
fakte	fakte		Duolingo
fakto	fakto		Duolingo
faktoj	faktoj		Duolingo
faktojn	faktojn		Duolingo
falas	falas		Duolingo
faldas	faldas		Duolingo
faldi	faldi		Duolingo
faligis	faligis		Duolingo
faligu	faligu		Duolingo
falis	falis		Duolingo
fama	fama		Duolingo
familia	familia		Duolingo
familian	familian		Duolingo
familianoj	familianoj		Duolingo
familio	familio		Duolingo
familion	familion		Duolingo
faras	faras		Duolingo
farbis	farbis		Duolingo
farbu	farbu		Duolingo
fare	fare		Duolingo
fari	fari		Duolingo
fariĝi	farigi		Duolingo
fariĝos	farigos		Duolingo
farinte	farinte		Duolingo
faris	faris		Duolingo
faros	faros		Duolingo
fartas	fartas		Duolingo
farti	farti		Duolingo
fartis	fartis		Duolingo
fartos	fartos		Duolingo
faru	faru		Duolingo
februaro	februaro		Duolingo
feliĉa	felica		Duolingo
feliĉaj	felicaj		Duolingo
feliĉajn	felicajn		Duolingo
feliĉigi	felicigi		Duolingo
feliĉigis	felicigis		Duolingo
fenestro	fenestro		Duolingo
fenestroj	fenestroj		Duolingo
fermas	fermas		Duolingo
fermi	fermi		Duolingo
fermu	fermu		Duolingo
festi	festi		Duolingo
festo	festo		Duolingo
festojn	festojn		Duolingo
festos	festos		Duolingo
fidas	fidas		Duolingo
fidi	fidi		Duolingo
fiera	fiera		Duolingo
fieras	fieras		Duolingo
filino	filino		Duolingo
filinoj	filinoj		Duolingo
filinon	filinon		Duolingo
filmo	filmo		Duolingo
filmoj	filmoj		Duolingo
filmojn	filmojn		Duolingo
filo	filo		Duolingo
filoj	filoj		Duolingo
filojn	filojn		Duolingo
filon	filon		Duolingo
finas	finas		Duolingo
finfine	finfine		Duolingo
fingro	fingro		Duolingo
fingroj	fingroj		Duolingo
fini	fini		Duolingo
finiĝi	finigi		Duolingo
finiĝos	finigos		Duolingo
fininte	fininte		Duolingo
fino	fino		Duolingo
fiŝaĵo	fisajo		Duolingo
fiŝaĵon	fisajon		Duolingo
fiŝo	fiso		Duolingo
fiŝoj	fisoj		Duolingo
fiŝojn	fisojn		Duolingo
fiŝon	fison		Duolingo
flago	flago		Duolingo
flagojn	flagojn		Duolingo
flagon	flagon		Duolingo
flanko	flanko		Duolingo
flankoj	flankoj		Duolingo
flaras	flaras		Duolingo
flari	flari		Duolingo
flava	flava		Duolingo
flavaj	flavaj		Duolingo
flavajn	flavajn		Duolingo
flavan	flavan		Duolingo
flegisto	flegisto		Duolingo
flegistoj	flegistoj		Duolingo
floro	floro		Duolingo
floroj	floroj		Duolingo
florojn	florojn		Duolingo
floron	floron		Duolingo
flue	flue		Duolingo
flugas	flugas		Duolingo
flugi	flugi		Duolingo
foje	foje		Duolingo
fojo	fojo		Duolingo
fojojn	fojojn		Duolingo
folio	folio		Duolingo
foliojn	foliojn		Duolingo
fondaĵo	fondajo		Duolingo
for	for		Duolingo
forestas	forestas		Duolingo
forgesis	forgesis		Duolingo
forgesos	forgesos		Duolingo
forigos	forigos		Duolingo
forigu	forigu		Duolingo
forkoj	forkoj		Duolingo
forkojn	forkojn		Duolingo
forta	forta		Duolingo
fortajn	fortajn		Duolingo
fortan	fortan		Duolingo
foto	foto		Duolingo
frago	frago		Duolingo
fragoj	fragoj		Duolingo
fragojn	fragojn		Duolingo
franca	franca		Duolingo
francan	francan		Duolingo
francio	francio		Duolingo
franco	franco		Duolingo
francoj	francoj		Duolingo
fratino	fratino		Duolingo
fratinoj	fratinoj		Duolingo
frato	frato		Duolingo
fratoj	fratoj		Duolingo
fraton	fraton		Duolingo
frazo	frazo		Duolingo
frazoj	frazoj		Duolingo
frazojn	frazojn		Duolingo
frazon	frazon		Duolingo
fridujo	fridujo		Duolingo
fridujon	fridujon		Duolingo
fromaĝo	fromago		Duolingo
fromaĝon	fromagon		Duolingo
frua	frua		Duolingo
frue	frue		Duolingo
frukto	frukto		Duolingo
fruktoj	fruktoj		Duolingo
fruktojn	fruktojn		Duolingo
frunton	frunton		Duolingo
funkcias	funkcias		Duolingo
gaja	gaja		Duolingo
gajaj	gajaj		Duolingo
gaje	gaje		Duolingo
gantoj	gantoj		Duolingo
gantojn	gantojn		Duolingo
ganton	ganton		Duolingo
ĝardeno	gardeno		Duolingo
ĝardenojn	gardenojn		Duolingo
ĝardenon	gardenon		Duolingo
gardisto	gardisto		Duolingo
gardistoj	gardistoj		Duolingo
gasto	gasto		Duolingo
gastoj	gastoj		Duolingo
gastojn	gastojn		Duolingo
gazeto	gazeto		Duolingo
gazeton	gazeton		Duolingo
geamikoj	geamikoj		Duolingo
geavoj	geavoj		Duolingo
geavojn	geavojn		Duolingo
geedziĝos	geedzigos		Duolingo
gefiloj	gefiloj		Duolingo
gefilojn	gefilojn		Duolingo
gefratoj	gefratoj		Duolingo
ĝemelaj	gemelaj		Duolingo
ĝemeloj	gemeloj		Duolingo
ĝenas	genas		Duolingo
ĝenerala	generala		Duolingo
ĝenerale	generale		Duolingo
genevojn	genevojn		Duolingo
ĝenu	genu		Duolingo
genuo	genuo		Duolingo
genuoj	genuoj		Duolingo
gepatroj	gepatroj		Duolingo
germana	germana		Duolingo
germanan	germanan		Duolingo
germanio	germanio		Duolingo
germano	germano		Duolingo
germanoj	germanoj		Duolingo
gesto	gesto		Duolingo
gestoj	gestoj		Duolingo
gestojn	gestojn		Duolingo
ĝi	gi		Duolingo
ĝia	gia		Duolingo
ĝin	gin		Duolingo
ĝinzo	ginzo		Duolingo
ĝinzojn	ginzojn		Duolingo
ĝinzon	ginzon		Duolingo
ĝis	gis		Duolingo
ĝis la revido	gis la revido		Duolingo
glacio	glacio		Duolingo
glaso	glaso		Duolingo
glasoj	glasoj		Duolingo
glasojn	glasojn		Duolingo
glason	glason		Duolingo
ĝoja	goja		Duolingo
ĝojas	gojas		Duolingo
gorĝo	gorgo		Duolingo
granda	granda		Duolingo
grandaj	grandaj		Duolingo
grandajn	grandajn		Duolingo
grandega	grandega		Duolingo
grandegaj	grandegaj		Duolingo
grandigi	grandigi		Duolingo
graso	graso		Duolingo
grason	grason		Duolingo
gratulon	gratulon		Duolingo
grava	grava		Duolingo
gravaj	gravaj		Duolingo
gravajn	gravajn		Duolingo
gravas	gravas		Duolingo
graveda	graveda		Duolingo
grimpi	grimpi		Duolingo
griza	griza		Duolingo
grizaj	grizaj		Duolingo
grizan	grizan		Duolingo
grupo	grupo		Duolingo
grupoj	grupoj		Duolingo
grupon	grupon		Duolingo
ĝuas	guas		Duolingo
ĝusta	gusta		Duolingo
ĝustaj	gustaj		Duolingo
gustas	gustas		Duolingo
ĝuste	guste		Duolingo
guston	guston		Duolingo
gustumas	gustumas		Duolingo
gustumi	gustumi		Duolingo
ĝuus	guus		Duolingo
ha	ha		Duolingo
haltas	haltas		Duolingo
haltejo	haltejo		Duolingo
haltejoj	haltejoj		Duolingo
haltu	haltu		Duolingo
hararo	hararo		Duolingo
hararon	hararon		Duolingo
haroj	haroj		Duolingo
harojn	harojn		Duolingo
haŭto	hauto		Duolingo
haŭton	hauton		Duolingo
havas	havas		Duolingo
haveno	haveno		Duolingo
havenojn	havenojn		Duolingo
havi	havi		Duolingo
havis	havis		Duolingo
havos	havos		Duolingo
havu	havu		Duolingo
havus	havus		Duolingo
hejme	hejme		Duolingo
hejmen	hejmen		Duolingo
hejmo	hejmo		Duolingo
hela	hela		Duolingo
helan	helan		Duolingo
helpantoj	helpantoj		Duolingo
helpanton	helpanton		Duolingo
helpi	helpi		Duolingo
helpis	helpis		Duolingo
helpo	helpo		Duolingo
helpon	helpon		Duolingo
helpos	helpos		Duolingo
hezitas	hezitas		Duolingo
hezitis	hezitis		Duolingo
hieraŭ	hierau		Duolingo
hispana	hispana		Duolingo
hispanan	hispanan		Duolingo
hispanio	hispanio		Duolingo
ho	ho		Duolingo
hodiaŭ	hodiau		Duolingo
homo	homo		Duolingo
homoj	homoj		Duolingo
horloĝo	horlogo		Duolingo
horloĝoj	horlogoj		Duolingo
horloĝojn	horlogojn		Duolingo
horloĝon	horlogon		Duolingo
horo	horo		Duolingo
horoj	horoj		Duolingo
horon	horon		Duolingo
humoro	humoro		Duolingo
hundido	hundido		Duolingo
hundidojn	hundidojn		Duolingo
hundidon	hundidon		Duolingo
hundo	hundo		Duolingo
hundoj	hundoj		Duolingo
hundojn	hundojn		Duolingo
ial	ial		Duolingo
iam	iam		Duolingo
ian	ian		Duolingo
ideo	ideo		Duolingo
ideojn	ideojn		Duolingo
ideon	ideon		Duolingo
ido	ido		Duolingo
idoj	idoj		Duolingo
idojn	idojn		Duolingo
ie	ie		Duolingo
iel	iel		Duolingo
ien	ien		Duolingo
ies	ies		Duolingo
iĝas	igas		Duolingo
iĝis	igis		Duolingo
ijk	ijk		Duolingo
ili	ili		Duolingo
ilia	ilia		Duolingo
iliaj	iliaj		Duolingo
ilin	ilin		Duolingo
ilo	ilo		Duolingo
ilojn	ilojn		Duolingo
ilon	ilon		Duolingo
imagi	imagi		Duolingo
imagu	imagu		Duolingo
impresi	impresi		Duolingo
impresis	impresis		Duolingo
individuo	individuo		Duolingo
individuoj	individuoj		Duolingo
infano	infano		Duolingo
infanoj	infanoj		Duolingo
infanojn	infanojn		Duolingo
informu	informu		Duolingo
inĝeniero	ingeniero		Duolingo
inĝenieroj	ingenieroj		Duolingo
inkluzive	inkluzive		Duolingo
insekto	insekto		Duolingo
insektoj	insektoj		Duolingo
insektojn	insektojn		Duolingo
instruas	instruas		Duolingo
instruis	instruis		Duolingo
instruisto	instruisto		Duolingo
instruistoj	instruistoj		Duolingo
insulo	insulo		Duolingo
inter	inter		Duolingo
interesa	interesa		Duolingo
interese	interese		Duolingo
interesiĝis	interesigis		Duolingo
interesiĝu	interesigu		Duolingo
internacia	internacia		Duolingo
interreto	interreto		Duolingo
intertempe	intertempe		Duolingo
invitis	invitis		Duolingo
invitu	invitu		Duolingo
io	io		Duolingo
iom	iom		Duolingo
iomete	iomete		Duolingo
ion	ion		Duolingo
iras	iras		Duolingo
iri	iri		Duolingo
iris	iris		Duolingo
iros	iros		Duolingo
itala	itala		Duolingo
italan	italan		Duolingo
italio	italio		Duolingo
italion	italion		Duolingo
italoj	italoj		Duolingo
iu	iu		Duolingo
iun	iun		Duolingo
ja	ja		Duolingo
jako	jako		Duolingo
jakon	jakon		Duolingo
ĵaluza	jaluza		Duolingo
ĵaluzas	jaluzas		Duolingo
jam	jam		Duolingo
januaro	januaro		Duolingo
japanan	japanan		Duolingo
japanio	japanio		Duolingo
japanion	japanion		Duolingo
japanoj	japanoj		Duolingo
jara	jara		Duolingo
jarcento	jarcento		Duolingo
jardeko	jardeko		Duolingo
jardekoj	jardekoj		Duolingo
jardekojn	jardekojn		Duolingo
jaro	jaro		Duolingo
jaroj	jaroj		Duolingo
jarojn	jarojn		Duolingo
ĵaŭde	jaude		Duolingo
ĵaŭdo	jaudo		Duolingo
ĵaŭdon	jaudon		Duolingo
je	je		Duolingo
jen	jen		Duolingo
jes	jes		Duolingo
ju	ju		Duolingo
juĝisto	jugisto		Duolingo
juĝistoj	jugistoj		Duolingo
julio	julio		Duolingo
juna	juna		Duolingo
junaj	junaj		Duolingo
junio	junio		Duolingo
junulara	junulara		Duolingo
junularo	junularo		Duolingo
junulo	junulo		Duolingo
junuloj	junuloj		Duolingo
jupo	jupo		Duolingo
jupojn	jupojn		Duolingo
jupon	jupon		Duolingo
ĵurnalo	jurnalo		Duolingo
ĵurnalojn	jurnalojn		Duolingo
ĵurnalon	jurnalon		Duolingo
ĵus	jus		Duolingo
juveloj	juveloj		Duolingo
kadro	kadro		Duolingo
kadrojn	kadrojn		Duolingo
kadron	kadron		Duolingo
kafejo	kafejo		Duolingo
kafejoj	kafejoj		Duolingo
kafejojn	kafejojn		Duolingo
kafo	kafo		Duolingo
kaj	kaj		Duolingo
kalendaro	kalendaro		Duolingo
kalendarojn	kalendarojn		Duolingo
kalendaron	kalendaron		Duolingo
kalsono	kalsono		Duolingo
kalsonon	kalsonon		Duolingo
kanadanoj	kanadanoj		Duolingo
kanado	kanado		Duolingo
kantas	kantas		Duolingo
kanti	kanti		Duolingo
kantisto	kantisto		Duolingo
kantistoj	kantistoj		Duolingo
kanto	kanto		Duolingo
kantoj	kantoj		Duolingo
kantojn	kantojn		Duolingo
kantos	kantos		Duolingo
kantu	kantu		Duolingo
kapabla	kapabla		Duolingo
kapablajn	kapablajn		Duolingo
kapablas	kapablas		Duolingo
kapo	kapo		Duolingo
kapon	kapon		Duolingo
kaptas	kaptas		Duolingo
kapti	kapti		Duolingo
kaptis	kaptis		Duolingo
kaptos	kaptos		Duolingo
kara	kara		Duolingo
karieron	karieron		Duolingo
karoto	karoto		Duolingo
karotojn	karotojn		Duolingo
karoton	karoton		Duolingo
kaŝis	kasis		Duolingo
kastelojn	kastelojn		Duolingo
kastelon	kastelon		Duolingo
katido	katido		Duolingo
katidojn	katidojn		Duolingo
kato	kato		Duolingo
katoj	katoj		Duolingo
kaŭzis	kauzis		Duolingo
ke	ke		Duolingo
kelkajn	kelkajn		Duolingo
kelkfoje	kelkfoje		Duolingo
kelnerino	kelnerino		Duolingo
kelnerinoj	kelnerinoj		Duolingo
kelnero	kelnero		Duolingo
kelneroj	kelneroj		Duolingo
kesto	kesto		Duolingo
keston	keston		Duolingo
kia	kia		Duolingo
kiajn	kiajn		Duolingo
kial	kial		Duolingo
kiam	kiam		Duolingo
kian	kian		Duolingo
kie	kie		Duolingo
kiel	kiel		Duolingo
kiel vi fartas	kiel vi fartas		Duolingo
kien	kien		Duolingo
kies	kies		Duolingo
kilogramo	kilogramo		Duolingo
kilogramojn	kilogramojn		Duolingo
kilogramon	kilogramon		Duolingo
kilometro	kilometro		Duolingo
kilometroj	kilometroj		Duolingo
kilometrojn	kilometrojn		Duolingo
kinejo	kinejo		Duolingo
kinejoj	kinejoj		Duolingo
kio	kio		Duolingo
kiom	kiom		Duolingo
kioma	kioma		Duolingo
kion	kion		Duolingo
kisas	kisas		Duolingo
kisi	kisi		Duolingo
kisis	kisis		Duolingo
kisos	kisos		Duolingo
kiu	kiu		Duolingo
kiuj	kiuj		Duolingo
kiujn	kiujn		Duolingo
kiun	kiun		Duolingo
klara	klara		Duolingo
klaraj	klaraj		Duolingo
klare	klare		Duolingo
klavaro	klavaro		Duolingo
klavaron	klavaron		Duolingo
klinas	klinas		Duolingo
kliniĝas	klinigas		Duolingo
kliniĝis	klinigis		Duolingo
klinis	klinis		Duolingo
klubano	klubano		Duolingo
klubanoj	klubanoj		Duolingo
klubo	klubo		Duolingo
klubon	klubon		Duolingo
knabino	knabino		Duolingo
knabinoj	knabinoj		Duolingo
knabinojn	knabinojn		Duolingo
knabo	knabo		Duolingo
knaboj	knaboj		Duolingo
kokaĵo	kokajo		Duolingo
kokaĵon	kokajon		Duolingo
kokino	kokino		Duolingo
kokinoj	kokinoj		Duolingo
kokinojn	kokinojn		Duolingo
kokinon	kokinon		Duolingo
koko	koko		Duolingo
kokoj	kokoj		Duolingo
kolegino	kolegino		Duolingo
kolegoj	kolegoj		Duolingo
kolegojn	kolegojn		Duolingo
kolektas	kolektas		Duolingo
koleras	koleras		Duolingo
koleros	koleros		Duolingo
kolerus	kolerus		Duolingo
kolombiano	kolombiano		Duolingo
kolombio	kolombio		Duolingo
kolorblinda	kolorblinda		Duolingo
koloro	koloro		Duolingo
kolorojn	kolorojn		Duolingo
koloron	koloron		Duolingo
kombi	kombi		Duolingo
kombilon	kombilon		Duolingo
kombis	kombis		Duolingo
komencanto	komencanto		Duolingo
komencas	komencas		Duolingo
komenciĝas	komencigas		Duolingo
komenciĝi	komencigi		Duolingo
komenciĝos	komencigos		Duolingo
komencis	komencis		Duolingo
komenco	komenco		Duolingo
komencos	komencos		Duolingo
komforta	komforta		Duolingo
komparas	komparas		Duolingo
kompari	kompari		Duolingo
kompatas	kompatas		Duolingo
komprenas	komprenas		Duolingo
komprenebla	komprenebla		Duolingo
kompreneble	kompreneble		Duolingo
komprenis	komprenis		Duolingo
komprenos	komprenos		Duolingo
komputilo	komputilo		Duolingo
komputiloj	komputiloj		Duolingo
konas	konas		Duolingo
koncernas	koncernas		Duolingo
koncerto	koncerto		Duolingo
koncerton	koncerton		Duolingo
kongreso	kongreso		Duolingo
kongresoj	kongresoj		Duolingo
kongreson	kongreson		Duolingo
koni	koni		Duolingo
konscias	konscias		Duolingo
konsentas	konsentas		Duolingo
konsentis	konsentis		Duolingo
konsentite	konsentite		Duolingo
konsentu	konsentu		Duolingo
konsideros	konsideros		Duolingo
konsilas	konsilas		Duolingo
konsilis	konsilis		Duolingo
konsilon	konsilon		Duolingo
konsilu	konsilu		Duolingo
konsistas	konsistas		Duolingo
konsistis	konsistis		Duolingo
kontenta	kontenta		Duolingo
kontinento	kontinento		Duolingo
kontinentoj	kontinentoj		Duolingo
kontraŭ	kontrau		Duolingo
kontraŭe	kontraue		Duolingo
koramikino	koramikino		Duolingo
koramiko	koramiko		Duolingo
koramikojn	koramikojn		Duolingo
koramikon	koramikon		Duolingo
korbo	korbo		Duolingo
korbon	korbon		Duolingo
koro	koro		Duolingo
koron	koron		Duolingo
korpo	korpo		Duolingo
korpon	korpon		Duolingo
kostas	kostas		Duolingo
kostis	kostis		Duolingo
kostumojn	kostumojn		Duolingo
kostumon	kostumon		Duolingo
kovras	kovras		Duolingo
kovris	kovris		Duolingo
kovru	kovru		Duolingo
kredas	kredas		Duolingo
kredu	kredu		Duolingo
krei	krei		Duolingo
kreis	kreis		Duolingo
kreskas	kreskas		Duolingo
kreskigi	kreskigi		Duolingo
kreskigis	kreskigis		Duolingo
krokodilo	krokodilo		Duolingo
krokodiloj	krokodiloj		Duolingo
krokodilojn	krokodilojn		Duolingo
krom	krom		Duolingo
krome	krome		Duolingo
kruro	kruro		Duolingo
krurojn	krurojn		Duolingo
ktp	ktp		Duolingo
kubuto	kubuto		Duolingo
kubutoj	kubutoj		Duolingo
kubutojn	kubutojn		Duolingo
kudras	kudras		Duolingo
kuiras	kuiras		Duolingo
kuirejo	kuirejo		Duolingo
kuirejon	kuirejon		Duolingo
kuiri	kuiri		Duolingo
kuiristo	kuiristo		Duolingo
kuiristoj	kuiristoj		Duolingo
kuiristojn	kuiristojn		Duolingo
kuiru	kuiru		Duolingo
kuko	kuko		Duolingo
kukojn	kukojn		Duolingo
kukon	kukon		Duolingo
kulero	kulero		Duolingo
kuleroj	kuleroj		Duolingo
kulerojn	kulerojn		Duolingo
kulpa	kulpa		Duolingo
kulpaj	kulpaj		Duolingo
kulturo	kulturo		Duolingo
kulturon	kulturon		Duolingo
kun	kun		Duolingo
kune	kune		Duolingo
kuniklo	kuniklo		Duolingo
kunikloj	kunikloj		Duolingo
kuniklojn	kuniklojn		Duolingo
kunulino	kunulino		Duolingo
kunulo	kunulo		Duolingo
kuracisto	kuracisto		Duolingo
kuracistoj	kuracistoj		Duolingo
kuraciston	kuraciston		Duolingo
kuraĝa	kuraga		Duolingo
kuraĝaj	kuragaj		Duolingo
kuras	kuras		Duolingo
kuri	kuri		Duolingo
kuŝas	kusas		Duolingo
kuseno	kuseno		Duolingo
kusenoj	kusenoj		Duolingo
kutime	kutime		Duolingo
kuzino	kuzino		Duolingo
kuzo	kuzo		Duolingo
kvankam	kvankam		Duolingo
kvanto	kvanto		Duolingo
kvar	kvar		Duolingo
kvara	kvara		Duolingo
kvarcent	kvarcent		Duolingo
kvardek	kvardek		Duolingo
kvarono	kvarono		Duolingo
kvaronoj	kvaronoj		Duolingo
kvaronon	kvaronon		Duolingo
kvartalo	kvartalo		Duolingo
kvazaŭ	kvazau		Duolingo
kvin	kvin		Duolingo
kvina	kvina		Duolingo
kvindek	kvindek		Duolingo
la	la		Duolingo
laboras	laboras		Duolingo
laborejo	laborejo		Duolingo
labori	labori		Duolingo
laboris	laboris		Duolingo
laboristo	laboristo		Duolingo
laboristoj	laboristoj		Duolingo
laboristojn	laboristojn		Duolingo
laboron	laboron		Duolingo
laboros	laboros		Duolingo
laca	laca		Duolingo
lacaj	lacaj		Duolingo
lakto	lakto		Duolingo
lakton	lakton		Duolingo
laktuko	laktuko		Duolingo
laktukon	laktukon		Duolingo
lampo	lampo		Duolingo
lampon	lampon		Duolingo
lando	lando		Duolingo
landoj	landoj		Duolingo
landojn	landojn		Duolingo
landon	landon		Duolingo
lango	lango		Duolingo
langon	langon		Duolingo
lano	lano		Duolingo
lanon	lanon		Duolingo
larĝa	larga		Duolingo
lasi	lasi		Duolingo
lasis	lasis		Duolingo
lasta	lasta		Duolingo
lastatempe	lastatempe		Duolingo
lasu	lasu		Duolingo
laŭ	lau		Duolingo
laŭta	lauta		Duolingo
laŭtan	lautan		Duolingo
laŭte	laute		Duolingo
legante	legante		Duolingo
legas	legas		Duolingo
legi	legi		Duolingo
leginte	leginte		Duolingo
legis	legis		Duolingo
legomo	legomo		Duolingo
legomoj	legomoj		Duolingo
legomojn	legomojn		Duolingo
legos	legos		Duolingo
lernantoj	lernantoj		Duolingo
lernas	lernas		Duolingo
lernejano	lernejano		Duolingo
lernejanojn	lernejanojn		Duolingo
lernejestro	lernejestro		Duolingo
lernejestroj	lernejestroj		Duolingo
lernejo	lernejo		Duolingo
lernejon	lernejon		Duolingo
lerni	lerni		Duolingo
lernis	lernis		Duolingo
lernu	lernu		Duolingo
lerta	lerta		Duolingo
lertan	lertan		Duolingo
letero	letero		Duolingo
leteroj	leteroj		Duolingo
leterojn	leterojn		Duolingo
leteron	leteron		Duolingo
leviĝas	levigas		Duolingo
leviĝi	levigi		Duolingo
leviĝis	levigis		Duolingo
leviĝos	levigos		Duolingo
levis	levis		Duolingo
levos	levos		Duolingo
li	li		Duolingo
lia	lia		Duolingo
liaj	liaj		Duolingo
libera	libera		Duolingo
liberaj	liberaj		Duolingo
libro	libro		Duolingo
librojn	librojn		Duolingo
libron	libron		Duolingo
lidja	lidja		Duolingo
ligilo	ligilo		Duolingo
ligilojn	ligilojn		Duolingo
ligilon	ligilon		Duolingo
ligis	ligis		Duolingo
ligna	ligna		Duolingo
ligno	ligno		Duolingo
lin	lin		Duolingo
lingvo	lingvo		Duolingo
lingvoj	lingvoj		Duolingo
lingvojn	lingvojn		Duolingo
lingvon	lingvon		Duolingo
lipojn	lipojn		Duolingo
literaturo	literaturo		Duolingo
litkovrilo	litkovrilo		Duolingo
litkovriloj	litkovriloj		Duolingo
litkovrilon	litkovrilon		Duolingo
lito	lito		Duolingo
liton	liton		Duolingo
litotuko	litotuko		Duolingo
litotukoj	litotukoj		Duolingo
litotukojn	litotukojn		Duolingo
litro	litro		Duolingo
litrojn	litrojn		Duolingo
litron	litron		Duolingo
loĝantaro	logantaro		Duolingo
loĝas	logas		Duolingo
loĝejo	logejo		Duolingo
loĝejon	logejon		Duolingo
loĝi	logi		Duolingo
loĝis	logis		Duolingo
loĝos	logos		Duolingo
loko	loko		Duolingo
londono	londono		Duolingo
londonon	londonon		Duolingo
longa	longa		Duolingo
longaj	longaj		Duolingo
longajn	longajn		Duolingo
longan	longan		Duolingo
ludanto	ludanto		Duolingo
ludantoj	ludantoj		Duolingo
ludas	ludas		Duolingo
ludi	ludi		Duolingo
ludis	ludis		Duolingo
ludos	ludos		Duolingo
lundo	lundo		Duolingo
lundon	lundon		Duolingo
luno	luno		Duolingo
lunon	lunon		Duolingo
maizon	maizon		Duolingo
majo	majo		Duolingo
malalta	malalta		Duolingo
malaltaj	malaltaj		Duolingo
malaltajn	malaltajn		Duolingo
malamas	malamas		Duolingo
malamiko	malamiko		Duolingo
malamikoj	malamikoj		Duolingo
malantaŭ	malantau		Duolingo
malantaŭen	malantauen		Duolingo
malbela	malbela		Duolingo
malbelaj	malbelaj		Duolingo
malbona	malbona		Duolingo
malbonan	malbonan		Duolingo
malbone	malbone		Duolingo
maldekstra	maldekstra		Duolingo
maldekstran	maldekstran		Duolingo
maldekstre	maldekstre		Duolingo
maldekstren	maldekstren		Duolingo
maldika	maldika		Duolingo
male	male		Duolingo
malebligi	malebligi		Duolingo
malebligis	malebligis		Duolingo
malfacila	malfacila		Duolingo
malfacilaj	malfacilaj		Duolingo
malfeliĉa	malfelica		Duolingo
malfermas	malfermas		Duolingo
malfermi	malfermi		Duolingo
malfermu	malfermu		Duolingo
malforta	malforta		Duolingo
malfrue	malfrue		Duolingo
malĝojas	malgojas		Duolingo
malgranda	malgranda		Duolingo
malgrandaj	malgrandaj		Duolingo
malgrandajn	malgrandajn		Duolingo
malgraŭ	malgrau		Duolingo
malhela	malhela		Duolingo
malhelan	malhelan		Duolingo
malhelpi	malhelpi		Duolingo
malhelpis	malhelpis		Duolingo
malhelpos	malhelpos		Duolingo
maljuna	maljuna		Duolingo
maljunaj	maljunaj		Duolingo
maljunulo	maljunulo		Duolingo
malkonsentas	malkonsentas		Duolingo
malkonsenti	malkonsenti		Duolingo
malkontenta	malkontenta		Duolingo
malliberejo	malliberejo		Duolingo
mallonga	mallonga		Duolingo
mallongan	mallongan		Duolingo
malmola	malmola		Duolingo
malmolaj	malmolaj		Duolingo
malmultekostaj	malmultekostaj		Duolingo
malmultekostan	malmultekostan		Duolingo
malnova	malnova		Duolingo
malplej	malplej		Duolingo
malplena	malplena		Duolingo
malpli	malpli		Duolingo
malpravas	malpravas		Duolingo
malpravi	malpravi		Duolingo
malprofunda	malprofunda		Duolingo
malproksima	malproksima		Duolingo
malproksime	malproksime		Duolingo
malpura	malpura		Duolingo
malrapide	malrapide		Duolingo
malriĉa	malrica		Duolingo
malriĉaj	malricaj		Duolingo
malŝalti	malsalti		Duolingo
malŝaltu	malsaltu		Duolingo
malsana	malsana		Duolingo
malsanas	malsanas		Duolingo
malsaniĝas	malsanigas		Duolingo
malsaniĝis	malsanigis		Duolingo
malsata	malsata		Duolingo
malsatajn	malsatajn		Duolingo
malseka	malseka		Duolingo
malsimilaj	malsimilaj		Duolingo
maltrafis	maltrafis		Duolingo
malvarma	malvarma		Duolingo
malvarmaj	malvarmaj		Duolingo
malvarman	malvarman		Duolingo
malvarme	malvarme		Duolingo
manĝaĵo	mangajo		Duolingo
manĝaĵoj	mangajoj		Duolingo
manĝaĵojn	mangajojn		Duolingo
manĝaĵon	mangajon		Duolingo
manĝante	mangante		Duolingo
manĝas	mangas		Duolingo
manĝebla	mangebla		Duolingo
manĝeblajn	mangeblajn		Duolingo
manĝi	mangi		Duolingo
manĝigis	mangigis		Duolingo
manĝigos	mangigos		Duolingo
manĝilaro	mangilaro		Duolingo
manĝilaron	mangilaron		Duolingo
manĝis	mangis		Duolingo
manĝo	mango		Duolingo
manĝoj	mangoj		Duolingo
manĝojn	mangojn		Duolingo
manĝon	mangon		Duolingo
manĝos	mangos		Duolingo
maniko	maniko		Duolingo
manikoj	manikoj		Duolingo
manikojn	manikojn		Duolingo
manikon	manikon		Duolingo
mankis	mankis		Duolingo
manko	manko		Duolingo
mano	mano		Duolingo
manojn	manojn		Duolingo
mantelo	mantelo		Duolingo
mantelojn	mantelojn		Duolingo
mantelon	mantelon		Duolingo
mapo	mapo		Duolingo
marbordo	marbordo		Duolingo
mardo	mardo		Duolingo
marŝas	marsas		Duolingo
marto	marto		Duolingo
maŝino	masino		Duolingo
matene	matene		Duolingo
matenmanĝas	matenmangas		Duolingo
matenmanĝi	matenmangi		Duolingo
matenmanĝo	matenmango		Duolingo
matenmanĝon	matenmangon		Duolingo
mateno	mateno		Duolingo
matenon	matenon		Duolingo
matraco	matraco		Duolingo
matracon	matracon		Duolingo
meblo	meblo		Duolingo
mebloj	mebloj		Duolingo
meblojn	meblojn		Duolingo
meksikanoj	meksikanoj		Duolingo
meksiko	meksiko		Duolingo
mem	mem		Duolingo
membroj	membroj		Duolingo
memoras	memoras		Duolingo
memorigi	memorigi		Duolingo
memorigis	memorigis		Duolingo
memoris	memoris		Duolingo
memoron	memoron		Duolingo
memoros	memoros		Duolingo
menciis	menciis		Duolingo
mendas	mendas		Duolingo
mendi	mendi		Duolingo
mendis	mendis		Duolingo
mendos	mendos		Duolingo
mentono	mentono		Duolingo
mentonon	mentonon		Duolingo
menuo	menuo		Duolingo
menuojn	menuojn		Duolingo
menuon	menuon		Duolingo
merkredo	merkredo		Duolingo
merkredon	merkredon		Duolingo
mesaĝojn	mesagojn		Duolingo
mesaĝon	mesagon		Duolingo
metas	metas		Duolingo
meti	meti		Duolingo
metrojn	metrojn		Duolingo
metron	metron		Duolingo
metroo	metroo		Duolingo
metroon	metroon		Duolingo
metu	metu		Duolingo
metus	metus		Duolingo
mi	mi		Duolingo
mia	mia		Duolingo
miaj	miaj		Duolingo
miksas	miksas		Duolingo
mil	mil		Duolingo
miliardo	miliardo		Duolingo
miliono	miliono		Duolingo
milionoj	milionoj		Duolingo
milionon	milionon		Duolingo
milito	milito		Duolingo
militoj	militoj		Duolingo
milojn	milojn		Duolingo
min	min		Duolingo
minus	minus		Duolingo
minuto	minuto		Duolingo
minutoj	minutoj		Duolingo
miras	miras		Duolingo
mirinda	mirinda		Duolingo
mirinde	mirinde		Duolingo
miris	miris		Duolingo
moderna	moderna		Duolingo
modernan	modernan		Duolingo
mojosa	mojosa		Duolingo
mojosajn	mojosajn		Duolingo
mojosan	mojosan		Duolingo
mojosas	mojosas		Duolingo
mokis	mokis		Duolingo
moku	moku		Duolingo
mola	mola		Duolingo
molaj	molaj		Duolingo
molan	molan		Duolingo
momento	momento		Duolingo
momenton	momenton		Duolingo
monato	monato		Duolingo
monatoj	monatoj		Duolingo
mondo	mondo		Duolingo
mono	mono		Duolingo
monon	monon		Duolingo
monto	monto		Duolingo
montoj	montoj		Duolingo
montras	montras		Duolingo
montri	montri		Duolingo
monujo	monujo		Duolingo
monujon	monujon		Duolingo
morgaŭ	morgau		Duolingo
morti	morti		Duolingo
mortigis	mortigis		Duolingo
mortigu	mortigu		Duolingo
motoro	motoro		Duolingo
movi	movi		Duolingo
moviĝas	movigas		Duolingo
movis	movis		Duolingo
movu	movu		Duolingo
multaj	multaj		Duolingo
multajn	multajn		Duolingo
multe	multe		Duolingo
multekosta	multekosta		Duolingo
multekostan	multekostan		Duolingo
muro	muro		Duolingo
muroj	muroj		Duolingo
muŝo	muso		Duolingo
musoj	musoj		Duolingo
musojn	musojn		Duolingo
muŝon	muson		Duolingo
muzikisto	muzikisto		Duolingo
muzikistoj	muzikistoj		Duolingo
muzikistojn	muzikistojn		Duolingo
muziko	muziko		Duolingo
muzikon	muzikon		Duolingo
najbarinon	najbarinon		Duolingo
najbaroj	najbaroj		Duolingo
najbarojn	najbarojn		Duolingo
naski	naski		Duolingo
naskiĝis	naskigis		Duolingo
naskiĝtago	naskigtago		Duolingo
naskiĝtagon	naskigtagon		Duolingo
naskis	naskis		Duolingo
naŭ	nau		Duolingo
naŭcent	naucent		Duolingo
nazo	nazo		Duolingo
nazon	nazon		Duolingo
ne	ne		Duolingo
necesa	necesa		Duolingo
necesaj	necesaj		Duolingo
necese	necese		Duolingo
necesejo	necesejo		Duolingo
necesejoj	necesejoj		Duolingo
necesejon	necesejon		Duolingo
nedankinde	nedankinde		Duolingo
neeble	neeble		Duolingo
neĝas	negas		Duolingo
neĝis	negis		Duolingo
neĝo	nego		Duolingo
neĝos	negos		Duolingo
nek	nek		Duolingo
nekredebla	nekredebla		Duolingo
nekredeble	nekredeble		Duolingo
neniajn	neniajn		Duolingo
nenial	nenial		Duolingo
neniam	neniam		Duolingo
nenian	nenian		Duolingo
nenie	nenie		Duolingo
neniel	neniel		Duolingo
nenien	nenien		Duolingo
nenies	nenies		Duolingo
nenio	nenio		Duolingo
nenion	nenion		Duolingo
nepinoj	nepinoj		Duolingo
nepo	nepo		Duolingo
nepre	nepre		Duolingo
nevino	nevino		Duolingo
nevo	nevo		Duolingo
ni	ni		Duolingo
nia	nia		Duolingo
niaj	niaj		Duolingo
nigra	nigra		Duolingo
nigraj	nigraj		Duolingo
nigran	nigran		Duolingo
nin	nin		Duolingo
noktaj	noktaj		Duolingo
nokte	nokte		Duolingo
nokto	nokto		Duolingo
noktoj	noktoj		Duolingo
nokton	nokton		Duolingo
nombro	nombro		Duolingo
nombroj	nombroj		Duolingo
nombrojn	nombrojn		Duolingo
nome	nome		Duolingo
nomi	nomi		Duolingo
nomiĝas	nomigas		Duolingo
nomis	nomis		Duolingo
nomo	nomo		Duolingo
nomoj	nomoj		Duolingo
nordaj	nordaj		Duolingo
nordameriko	nordameriko		Duolingo
nordamerikon	nordamerikon		Duolingo
norden	norden		Duolingo
normala	normala		Duolingo
normale	normale		Duolingo
nova	nova		Duolingo
novaj	novaj		Duolingo
novan	novan		Duolingo
novembro	novembro		Duolingo
novjaro	novjaro		Duolingo
novjaron	novjaron		Duolingo
nu	nu		Duolingo
nubo	nubo		Duolingo
nuboj	nuboj		Duolingo
nubon	nubon		Duolingo
nul	nul		Duolingo
nulo	nulo		Duolingo
nulon	nulon		Duolingo
numero	numero		Duolingo
nun	nun		Duolingo
nur	nur		Duolingo
obeas	obeas		Duolingo
obei	obei		Duolingo
objekto	objekto		Duolingo
odoras	odoras		Duolingo
oficejo	oficejo		Duolingo
ofta	ofta		Duolingo
oftaj	oftaj		Duolingo
ofte	ofte		Duolingo
ok	ok		Duolingo
okazas	okazas		Duolingo
okazis	okazis		Duolingo
okcent	okcent		Duolingo
okcidenta	okcidenta		Duolingo
okcidenten	okcidenten		Duolingo
okdek	okdek		Duolingo
oktobro	oktobro		Duolingo
okulo	okulo		Duolingo
okuloj	okuloj		Duolingo
okulojn	okulojn		Duolingo
okulvitroj	okulvitroj		Duolingo
okulvitrojn	okulvitrojn		Duolingo
okupas	okupas		Duolingo
okupiĝi	okupigi		Duolingo
ol	ol		Duolingo
oleo	oleo		Duolingo
oleoj	oleoj		Duolingo
oleon	oleon		Duolingo
ombrelo	ombrelo		Duolingo
ombrelon	ombrelon		Duolingo
oni	oni		Duolingo
onklino	onklino		Duolingo
onklinoj	onklinoj		Duolingo
onklo	onklo		Duolingo
onklojn	onklojn		Duolingo
opinias	opinias		Duolingo
opinio	opinio		Duolingo
oranĝkolora	orangkolora		Duolingo
oranĝkoloraj	orangkoloraj		Duolingo
oranĝo	orango		Duolingo
oranĝoj	orangoj		Duolingo
oranĝojn	orangojn		Duolingo
oranĝon	orangon		Duolingo
oreloj	oreloj		Duolingo
orelon	orelon		Duolingo
organizo	organizo		Duolingo
orienta	orienta		Duolingo
orienten	orienten		Duolingo
originala	originala		Duolingo
ovo	ovo		Duolingo
ovoj	ovoj		Duolingo
ovojn	ovojn		Duolingo
ovon	ovon		Duolingo
paciento	paciento		Duolingo
paĉjo	pacjo		Duolingo
pagi	pagi		Duolingo
pagis	pagis		Duolingo
paĝo	pago		Duolingo
paĝoj	pagoj		Duolingo
paĝojn	pagojn		Duolingo
paĝon	pagon		Duolingo
pakas	pakas		Duolingo
paki	paki		Duolingo
palaco	palaco		Duolingo
palacon	palacon		Duolingo
panjo	panjo		Duolingo
panjon	panjon		Duolingo
pano	pano		Duolingo
panon	panon		Duolingo
pantalono	pantalono		Duolingo
pantalonon	pantalonon		Duolingo
papero	papero		Duolingo
paperon	paperon		Duolingo
pardonas	pardonas		Duolingo
pardoni	pardoni		Duolingo
pardonpetas	pardonpetas		Duolingo
pardonpeti	pardonpeti		Duolingo
pardonu	pardonu		Duolingo
parenco	parenco		Duolingo
parenteze	parenteze		Duolingo
parizo	parizo		Duolingo
parkerigi	parkerigi		Duolingo
parkerigis	parkerigis		Duolingo
parko	parko		Duolingo
parkoj	parkoj		Duolingo
paro	paro		Duolingo
paroj	paroj		Duolingo
parolas	parolas		Duolingo
parolis	parolis		Duolingo
parolos	parolos		Duolingo
parto	parto		Duolingo
partopreni	partopreni		Duolingo
partoprenu	partoprenu		Duolingo
pasigis	pasigis		Duolingo
pasigu	pasigu		Duolingo
pasporta servo	pasporta servo		Duolingo
pastaĵojn	pastajojn		Duolingo
pasvorto	pasvorto		Duolingo
pasvortojn	pasvortojn		Duolingo
pasvorton	pasvorton		Duolingo
pato	pato		Duolingo
paton	paton		Duolingo
patrino	patrino		Duolingo
patrinoj	patrinoj		Duolingo
patrinojn	patrinojn		Duolingo
patro	patro		Duolingo
patroj	patroj		Duolingo
patron	patron		Duolingo
peco	peco		Duolingo
pecon	pecon		Duolingo
pendas	pendas		Duolingo
pendu	pendu		Duolingo
pensas	pensas		Duolingo
pentraĵo	pentrajo		Duolingo
pentraĵoj	pentrajoj		Duolingo
pentraĵojn	pentrajojn		Duolingo
pentraĵon	pentrajon		Duolingo
pentras	pentras		Duolingo
pentri	pentri		Duolingo
pentris	pentris		Duolingo
per	per		Duolingo
perdas	perdas		Duolingo
perdi	perdi		Duolingo
perdo	perdo		Duolingo
pere	pere		Duolingo
pereis	pereis		Duolingo
perfekte	perfekte		Duolingo
permesas	permesas		Duolingo
permesos	permesos		Duolingo
persone	persone		Duolingo
persono	persono		Duolingo
personoj	personoj		Duolingo
peruanon	peruanon		Duolingo
peruo	peruo		Duolingo
peruon	peruon		Duolingo
pesi	pesi		Duolingo
pesilo	pesilo		Duolingo
pesilon	pesilon		Duolingo
pesu	pesu		Duolingo
petas	petas		Duolingo
peti	peti		Duolingo
petis	petis		Duolingo
peto	peto		Duolingo
peton	peton		Duolingo
petu	petu		Duolingo
peza	peza		Duolingo
pezas	pezas		Duolingo
pezon	pezon		Duolingo
pico	pico		Duolingo
picojn	picojn		Duolingo
picon	picon		Duolingo
piedfingroj	piedfingroj		Duolingo
piedfingrojn	piedfingrojn		Duolingo
piedo	piedo		Duolingo
piedoj	piedoj		Duolingo
piĵamo	pijamo		Duolingo
piĵamoj	pijamoj		Duolingo
piĵamojn	pijamojn		Duolingo
piĵamon	pijamon		Duolingo
piv	piv		Duolingo
plaĉas	placas		Duolingo
plaĉis	placis		Duolingo
placo	placo		Duolingo
placon	placon		Duolingo
plafono	plafono		Duolingo
plafonoj	plafonoj		Duolingo
plaĝo	plago		Duolingo
plaĝojn	plagojn		Duolingo
planko	planko		Duolingo
plankon	plankon		Duolingo
planto	planto		Duolingo
plantoj	plantoj		Duolingo
plasta	plasta		Duolingo
plastajn	plastajn		Duolingo
plasto	plasto		Duolingo
plej	plej		Duolingo
plejparte	plejparte		Duolingo
plena	plena		Duolingo
plenaj	plenaj		Duolingo
plenkreskulo	plenkreskulo		Duolingo
plenkreskuloj	plenkreskuloj		Duolingo
plezure	plezure		Duolingo
plezuro	plezuro		Duolingo
pli	pli		Duolingo
pliboniĝas	plibonigas		Duolingo
pliboniĝi	plibonigi		Duolingo
plimulto	plimulto		Duolingo
plimulton	plimulton		Duolingo
ploras	ploras		Duolingo
ploris	ploris		Duolingo
plu	plu		Duolingo
pluraj	pluraj		Duolingo
plurajn	plurajn		Duolingo
plus	plus		Duolingo
pluvas	pluvas		Duolingo
pluvis	pluvis		Duolingo
pluvos	pluvos		Duolingo
po	po		Duolingo
poemojn	poemojn		Duolingo
poemon	poemon		Duolingo
poeto	poeto		Duolingo
poetoj	poetoj		Duolingo
poezio	poezio		Duolingo
poezion	poezion		Duolingo
polan	polan		Duolingo
policanoj	policanoj		Duolingo
polico	polico		Duolingo
pollando	pollando		Duolingo
poloj	poloj		Duolingo
pomo	pomo		Duolingo
pomoj	pomoj		Duolingo
pomojn	pomojn		Duolingo
pomon	pomon		Duolingo
ponton	ponton		Duolingo
popolo	popolo		Duolingo
popoloj	popoloj		Duolingo
populara	populara		Duolingo
popularaj	popularaj		Duolingo
por	por		Duolingo
por ke	por ke		Duolingo
pordo	pordo		Duolingo
pordon	pordon		Duolingo
porkaĵo	porkajo		Duolingo
porkaĵon	porkajon		Duolingo
porko	porko		Duolingo
porkoj	porkoj		Duolingo
porkojn	porkojn		Duolingo
portas	portas		Duolingo
posedaĵoj	posedajoj		Duolingo
posedas	posedas		Duolingo
poŝo	poso		Duolingo
poŝojn	posojn		Duolingo
poste	poste		Duolingo
poŝtelefono	postelefono		Duolingo
poŝtelefonon	postelefonon		Duolingo
postenon	postenon		Duolingo
posttagmeze	posttagmeze		Duolingo
posttagmezo	posttagmezo		Duolingo
posttagmezon	posttagmezon		Duolingo
postulas	postulas		Duolingo
postuli	postuli		Duolingo
postulis	postulis		Duolingo
poto	poto		Duolingo
povas	povas		Duolingo
povintus	povintus		Duolingo
povis	povis		Duolingo
povus	povus		Duolingo
praavino	praavino		Duolingo
praavinon	praavinon		Duolingo
praavo	praavo		Duolingo
prageavojn	prageavojn		Duolingo
pravas	pravas		Duolingo
precipe	precipe		Duolingo
precize	precize		Duolingo
preferas	preferas		Duolingo
preĝejo	pregejo		Duolingo
prenas	prenas		Duolingo
prenis	prenis		Duolingo
preparas	preparas		Duolingo
preparis	preparis		Duolingo
preparu	preparu		Duolingo
preskaŭ	preskau		Duolingo
preta	preta		Duolingo
preter	preter		Duolingo
prezentas	prezentas		Duolingo
prezenti	prezenti		Duolingo
prezo	prezo		Duolingo
prezoj	prezoj		Duolingo
pri	pri		Duolingo
printempe	printempe		Duolingo
printempo	printempo		Duolingo
priskribi	priskribi		Duolingo
priskribis	priskribis		Duolingo
priskribo	priskribo		Duolingo
pro	pro		Duolingo
problemo	problemo		Duolingo
problemojn	problemojn		Duolingo
profesio	profesio		Duolingo
profesion	profesion		Duolingo
profunda	profunda		Duolingo
profundan	profundan		Duolingo
programisto	programisto		Duolingo
programiston	programiston		Duolingo
programo	programo		Duolingo
programoj	programoj		Duolingo
programon	programon		Duolingo
progresas	progresas		Duolingo
progresi	progresi		Duolingo
progreso	progreso		Duolingo
prokrastu	prokrastu		Duolingo
proksima	proksima		Duolingo
proksime	proksime		Duolingo
proksimume	proksimume		Duolingo
propra	propra		Duolingo
propraj	propraj		Duolingo
proprajn	proprajn		Duolingo
propran	propran		Duolingo
provas	provas		Duolingo
provi	provi		Duolingo
provu	provu		Duolingo
publiko	publiko		Duolingo
pulmoj	pulmoj		Duolingo
pulmon	pulmon		Duolingo
pulovero	pulovero		Duolingo
puloveroj	puloveroj		Duolingo
puloverojn	puloverojn		Duolingo
puloveron	puloveron		Duolingo
pupo	pupo		Duolingo
pupon	pupon		Duolingo
pura	pura		Duolingo
purajn	purajn		Duolingo
purigi	purigi		Duolingo
purigis	purigis		Duolingo
purigos	purigos		Duolingo
radikoj	radikoj		Duolingo
radikojn	radikojn		Duolingo
rado	rado		Duolingo
radoj	radoj		Duolingo
radojn	radojn		Duolingo
rajtas	rajtas		Duolingo
rakontis	rakontis		Duolingo
rakontoj	rakontoj		Duolingo
rakonton	rakonton		Duolingo
rakontu	rakontu		Duolingo
rapide	rapide		Duolingo
razi	razi		Duolingo
razis	razis		Duolingo
recepto	recepto		Duolingo
receptoj	receptoj		Duolingo
receptojn	receptojn		Duolingo
recepton	recepton		Duolingo
reciproke	reciproke		Duolingo
regas	regas		Duolingo
reĝino	regino		Duolingo
reĝinon	reginon		Duolingo
regiono	regiono		Duolingo
reĝisoro	regisoro		Duolingo
reĝo	rego		Duolingo
reĝon	regon		Duolingo
regulo	regulo		Duolingo
reguloj	reguloj		Duolingo
regulon	regulon		Duolingo
reklamas	reklamas		Duolingo
reklamis	reklamis		Duolingo
reklamu	reklamu		Duolingo
rekonas	rekonas		Duolingo
rekonis	rekonis		Duolingo
renkontas	renkontas		Duolingo
renkonti	renkonti		Duolingo
renkontiĝas	renkontigas		Duolingo
renkontiĝis	renkontigis		Duolingo
renkontiĝos	renkontigos		Duolingo
renkontiĝu	renkontigu		Duolingo
renkontis	renkontis		Duolingo
renkontos	renkontos		Duolingo
resaniĝos	resanigos		Duolingo
resaniĝu	resanigu		Duolingo
resaniĝus	resanigus		Duolingo
respondas	respondas		Duolingo
respondi	respondi		Duolingo
respondis	respondis		Duolingo
respondo	respondo		Duolingo
respondojn	respondojn		Duolingo
respondon	respondon		Duolingo
respondos	respondos		Duolingo
restoracio	restoracio		Duolingo
restoracioj	restoracioj		Duolingo
restoracion	restoracion		Duolingo
retejo	retejo		Duolingo
retejon	retejon		Duolingo
retmesaĝo	retmesago		Duolingo
retmesaĝojn	retmesagojn		Duolingo
retmesaĝon	retmesagon		Duolingo
retpaĝo	retpago		Duolingo
retpaĝojn	retpagojn		Duolingo
retpaĝon	retpagon		Duolingo
retpoŝtadreso	retpostadreso		Duolingo
retpoŝto	retposto		Duolingo
retpoŝton	retposton		Duolingo
retumas	retumas		Duolingo
retumilo	retumilo		Duolingo
retumiloj	retumiloj		Duolingo
retumilon	retumilon		Duolingo
retumis	retumis		Duolingo
retumus	retumus		Duolingo
revas	revas		Duolingo
revenis	revenis		Duolingo
revis	revis		Duolingo
rezulto	rezulto		Duolingo
riĉa	rica		Duolingo
riĉaj	ricaj		Duolingo
ricevu	ricevu		Duolingo
ridante	ridante		Duolingo
ridas	ridas		Duolingo
ridetas	ridetas		Duolingo
ridi	ridi		Duolingo
ridos	ridos		Duolingo
rigardas	rigardas		Duolingo
rigardi	rigardi		Duolingo
rigardis	rigardis		Duolingo
rigardos	rigardos		Duolingo
rilato	rilato		Duolingo
ringo	ringo		Duolingo
ringoj	ringoj		Duolingo
ringon	ringon		Duolingo
ripetas	ripetas		Duolingo
ripetos	ripetos		Duolingo
ripozas	ripozas		Duolingo
ripozi	ripozi		Duolingo
rivero	rivero		Duolingo
rizo	rizo		Duolingo
rizon	rizon		Duolingo
robo	robo		Duolingo
robon	robon		Duolingo
roboto	roboto		Duolingo
rolas	rolas		Duolingo
roli	roli		Duolingo
rolis	rolis		Duolingo
romano	romano		Duolingo
romanojn	romanojn		Duolingo
romanon	romanon		Duolingo
rompis	rompis		Duolingo
rompos	rompos		Duolingo
rozkolora	rozkolora		Duolingo
rozkoloraj	rozkoloraj		Duolingo
rozkoloran	rozkoloran		Duolingo
rozo	rozo		Duolingo
rozon	rozon		Duolingo
rubujo	rubujo		Duolingo
rubujon	rubujon		Duolingo
ruĝa	ruga		Duolingo
ruĝaj	rugaj		Duolingo
ruĝajn	rugajn		Duolingo
ruĝan	rugan		Duolingo
ruĝiĝas	rugigas		Duolingo
ruĝiĝi	rugigi		Duolingo
rulseĝo	rulsego		Duolingo
rulseĝon	rulsegon		Duolingo
rusan	rusan		Duolingo
rusio	rusio		Duolingo
rusoj	rusoj		Duolingo
sabate	sabate		Duolingo
sabato	sabato		Duolingo
sabaton	sabaton		Duolingo
ŝafido	safido		Duolingo
ŝafidoj	safidoj		Duolingo
ŝafidojn	safidojn		Duolingo
ŝafo	safo		Duolingo
ŝafoj	safoj		Duolingo
ŝajnas	sajnas		Duolingo
ŝajnigas	sajnigas		Duolingo
ŝajnigis	sajnigis		Duolingo
ŝajnis	sajnis		Duolingo
sako	sako		Duolingo
sakojn	sakojn		Duolingo
sakon	sakon		Duolingo
salato	salato		Duolingo
salaton	salaton		Duolingo
salo	salo		Duolingo
salon	salon		Duolingo
salono	salono		Duolingo
saltas	saltas		Duolingo
ŝalti	salti		Duolingo
ŝaltis	saltis		Duolingo
ŝaltus	saltus		Duolingo
saluton	saluton		Duolingo
sama	sama		Duolingo
samajn	samajn		Duolingo
samtempe	samtempe		Duolingo
sana	sana		Duolingo
sanan	sanan		Duolingo
sandalo	sandalo		Duolingo
sandaloj	sandaloj		Duolingo
sandalojn	sandalojn		Duolingo
sandalon	sandalon		Duolingo
sandviĉo	sandvico		Duolingo
sandviĉojn	sandvicojn		Duolingo
sandviĉon	sandvicon		Duolingo
ŝanĝas	sangas		Duolingo
ŝanĝi	sangi		Duolingo
ŝanĝiĝas	sangigas		Duolingo
ŝanĝiĝi	sangigi		Duolingo
sano	sano		Duolingo
sapo	sapo		Duolingo
sapon	sapon		Duolingo
sata	sata		Duolingo
sataj	sataj		Duolingo
ŝatas	satas		Duolingo
ŝatis	satis		Duolingo
ŝatus	satus		Duolingo
sceno	sceno		Duolingo
scenon	scenon		Duolingo
scias	scias		Duolingo
scii	scii		Duolingo
scion	scion		Duolingo
scios	scios		Duolingo
scipovas	scipovas		Duolingo
se	se		Duolingo
sed	sed		Duolingo
seĝo	sego		Duolingo
seĝoj	segoj		Duolingo
seĝojn	segojn		Duolingo
seka	seka		Duolingo
sekan	sekan		Duolingo
sekigi	sekigi		Duolingo
sekretario	sekretario		Duolingo
sekretariojn	sekretariojn		Duolingo
sekretarion	sekretarion		Duolingo
sekundoj	sekundoj		Duolingo
sekundojn	sekundojn		Duolingo
sekva	sekva		Duolingo
sekvan	sekvan		Duolingo
sekve	sekve		Duolingo
sekvu	sekvu		Duolingo
semajnfino	semajnfino		Duolingo
semajnfinoj	semajnfinoj		Duolingo
semajnfinojn	semajnfinojn		Duolingo
semajno	semajno		Duolingo
semajnoj	semajnoj		Duolingo
sen	sen		Duolingo
sendas	sendas		Duolingo
sendi	sendi		Duolingo
sendis	sendis		Duolingo
sendu	sendu		Duolingo
senpaga	senpaga		Duolingo
senpagaj	senpagaj		Duolingo
senpagajn	senpagajn		Duolingo
senpage	senpage		Duolingo
sentas	sentas		Duolingo
sento	sento		Duolingo
sentoj	sentoj		Duolingo
sentojn	sentojn		Duolingo
sep	sep		Duolingo
sepa	sepa		Duolingo
sepcent	sepcent		Duolingo
sepdek	sepdek		Duolingo
septembro	septembro		Duolingo
serĉas	sercas		Duolingo
serioza	serioza		Duolingo
ses	ses		Duolingo
sescent	sescent		Duolingo
sezono	sezono		Duolingo
sezonoj	sezonoj		Duolingo
sezonon	sezonon		Duolingo
ŝi	si		Duolingo
ŝia	sia		Duolingo
ŝiaj	siaj		Duolingo
sidas	sidas		Duolingo
sidi	sidi		Duolingo
sidiĝis	sidigis		Duolingo
sidiĝu	sidigu		Duolingo
signifo	signifo		Duolingo
signifon	signifon		Duolingo
similaj	similaj		Duolingo
simpla	simpla		Duolingo
simplaj	simplaj		Duolingo
simplan	simplan		Duolingo
ŝin	sin		Duolingo
sinjorino	sinjorino		Duolingo
sinjorinoj	sinjorinoj		Duolingo
sinjoro	sinjoro		Duolingo
sinjoroj	sinjoroj		Duolingo
ŝiris	siris		Duolingo
ŝiru	siru		Duolingo
situas	situas		Duolingo
skatolo	skatolo		Duolingo
skatolon	skatolon		Duolingo
skribante	skribante		Duolingo
skribas	skribas		Duolingo
skribilo	skribilo		Duolingo
skribinte	skribinte		Duolingo
skribos	skribos		Duolingo
ŝlosi	slosi		Duolingo
ŝlosilo	slosilo		Duolingo
ŝlosiloj	slosiloj		Duolingo
ŝlosilojn	slosilojn		Duolingo
ŝlosis	slosis		Duolingo
sofia	sofia		Duolingo
sofo	sofo		Duolingo
sofoj	sofoj		Duolingo
sofon	sofon		Duolingo
soifas	soifas		Duolingo
soifis	soifis		Duolingo
soifos	soifos		Duolingo
sola	sola		Duolingo
soldato	soldato		Duolingo
soldatoj	soldatoj		Duolingo
somero	somero		Duolingo
sonoras	sonoras		Duolingo
sonorilo	sonorilo		Duolingo
sonoriloj	sonoriloj		Duolingo
sonorilojn	sonorilojn		Duolingo
sonorilon	sonorilon		Duolingo
sonoris	sonoris		Duolingo
sopiras	sopiras		Duolingo
spaco	spaco		Duolingo
spacon	spacon		Duolingo
specialajn	specialajn		Duolingo
spegulo	spegulo		Duolingo
spegulon	spegulon		Duolingo
spektantaro	spektantaro		Duolingo
spektantaroj	spektantaroj		Duolingo
spektantoj	spektantoj		Duolingo
spektantojn	spektantojn		Duolingo
spekti	spekti		Duolingo
spektis	spektis		Duolingo
spektos	spektos		Duolingo
sperta	sperta		Duolingo
spertaj	spertaj		Duolingo
spertan	spertan		Duolingo
spertas	spertas		Duolingo
spicoj	spicoj		Duolingo
spicojn	spicojn		Duolingo
spiru	spiru		Duolingo
ŝranko	sranko		Duolingo
ŝrankon	srankon		Duolingo
stacidomo	stacidomo		Duolingo
stacidomon	stacidomon		Duolingo
staras	staras		Duolingo
stato	stato		Duolingo
ŝtelas	stelas		Duolingo
ŝtelis	stelis		Duolingo
ŝtelisto	stelisto		Duolingo
ŝtelistoj	stelistoj		Duolingo
ŝteliston	steliston		Duolingo
ŝtofo	stofo		Duolingo
stranga	stranga		Duolingo
strangan	strangan		Duolingo
stratangulo	stratangulo		Duolingo
strato	strato		Duolingo
stratoj	stratoj		Duolingo
straton	straton		Duolingo
strebas	strebas		Duolingo
strigo	strigo		Duolingo
strigoj	strigoj		Duolingo
strigojn	strigojn		Duolingo
ŝtrumpetoj	strumpetoj		Duolingo
ŝtrumpetojn	strumpetojn		Duolingo
ŝtrumpoj	strumpoj		Duolingo
ŝtrumpojn	strumpojn		Duolingo
studas	studas		Duolingo
studento	studento		Duolingo
studentoj	studentoj		Duolingo
studi	studi		Duolingo
studis	studis		Duolingo
studos	studos		Duolingo
stultulo	stultulo		Duolingo
stultulon	stultulon		Duolingo
ŝtuparo	stuparo		Duolingo
ŝtuparon	stuparon		Duolingo
ŝtupo	stupo		Duolingo
ŝtupoj	stupoj		Duolingo
ŝtupojn	stupojn		Duolingo
sub	sub		Duolingo
subite	subite		Duolingo
subskribi	subskribi		Duolingo
subskribon	subskribon		Duolingo
suda	suda		Duolingo
sudameriko	sudameriko		Duolingo
sudamerikon	sudamerikon		Duolingo
suden	suden		Duolingo
suferis	suferis		Duolingo
suferos	suferos		Duolingo
sufiĉan	sufican		Duolingo
sufiĉas	suficas		Duolingo
sukceso	sukceso		Duolingo
sukceson	sukceson		Duolingo
sukero	sukero		Duolingo
sukeron	sukeron		Duolingo
suko	suko		Duolingo
sukon	sukon		Duolingo
suno	suno		Duolingo
ŝuo	suo		Duolingo
ŝuoj	suoj		Duolingo
ŝuojn	suojn		Duolingo
super	super		Duolingo
supo	supo		Duolingo
supon	supon		Duolingo
supozas	supozas		Duolingo
supozu	supozu		Duolingo
sur	sur		Duolingo
surda	surda		Duolingo
surdaj	surdaj		Duolingo
surhavas	surhavas		Duolingo
surhavi	surhavi		Duolingo
survoje	survoje		Duolingo
ŝuti	suti		Duolingo
ŝutu	sutu		Duolingo
t-ĉemizojn	t-cemizojn		Duolingo
t-ĉemizon	t-cemizon		Duolingo
tablo	tablo		Duolingo
tablon	tablon		Duolingo
tagmanĝas	tagmangas		Duolingo
tagmanĝi	tagmangi		Duolingo
tagmanĝo	tagmango		Duolingo
tagmanĝon	tagmangon		Duolingo
tagmeze	tagmeze		Duolingo
tagmezo	tagmezo		Duolingo
tago	tago		Duolingo
tagoj	tagoj		Duolingo
tagojn	tagojn		Duolingo
tagon	tagon		Duolingo
tajpi	tajpi		Duolingo
taksas	taksas		Duolingo
talenta	talenta		Duolingo
talentas	talentas		Duolingo
tamen	tamen		Duolingo
tapiŝo	tapiso		Duolingo
tapiŝon	tapison		Duolingo
taso	taso		Duolingo
tasojn	tasojn		Duolingo
tason	tason		Duolingo
teatraĵo	teatrajo		Duolingo
teatraĵojn	teatrajojn		Duolingo
teatraĵon	teatrajon		Duolingo
teatro	teatro		Duolingo
teatroj	teatroj		Duolingo
tegmento	tegmento		Duolingo
tegmentoj	tegmentoj		Duolingo
tejo	tejo		Duolingo
telefonas	telefonas		Duolingo
telefoni	telefoni		Duolingo
telefono	telefono		Duolingo
telefonoj	telefonoj		Duolingo
telefonon	telefonon		Duolingo
telero	telero		Duolingo
teleroj	teleroj		Duolingo
telerojn	telerojn		Duolingo
televidilo	televidilo		Duolingo
televidilon	televidilon		Duolingo
temas	temas		Duolingo
tempo	tempo		Duolingo
tempon	tempon		Duolingo
teni	teni		Duolingo
tenis	tenis		Duolingo
teo	teo		Duolingo
teon	teon		Duolingo
tereno	tereno		Duolingo
terenon	terenon		Duolingo
tero	tero		Duolingo
terpomoj	terpomoj		Duolingo
terpomojn	terpomojn		Duolingo
terpomon	terpomon		Duolingo
tia	tia		Duolingo
tiaj	tiaj		Duolingo
tiajn	tiajn		Duolingo
tial	tial		Duolingo
tiam	tiam		Duolingo
tie	tie		Duolingo
tiel	tiel		Duolingo
tien	tien		Duolingo
ties	ties		Duolingo
timas	timas		Duolingo
timiga	timiga		Duolingo
timigas	timigas		Duolingo
timigu	timigu		Duolingo
timis	timis		Duolingo
tio	tio		Duolingo
tiom	tiom		Duolingo
tion	tion		Duolingo
tiu	tiu		Duolingo
tiuj	tiuj		Duolingo
tiun	tiun		Duolingo
tomatan	tomatan		Duolingo
tomato	tomato		Duolingo
tomatoj	tomatoj		Duolingo
tomatojn	tomatojn		Duolingo
tra	tra		Duolingo
tradukas	tradukas		Duolingo
traduki	traduki		Duolingo
tradukis	tradukis		Duolingo
tradukisto	tradukisto		Duolingo
traduko	traduko		Duolingo
tradukon	tradukon		Duolingo
trafis	trafis		Duolingo
trafos	trafos		Duolingo
trajno	trajno		Duolingo
traktas	traktas		Duolingo
tranĉas	trancas		Duolingo
tranĉi	tranci		Duolingo
tranĉilo	trancilo		Duolingo
tranĉilon	trancilon		Duolingo
trankvila	trankvila		Duolingo
trans	trans		Duolingo
transiri	transiri		Duolingo
transiris	transiris		Duolingo
transiru	transiru		Duolingo
tre	tre		Duolingo
tri	tri		Duolingo
tria	tria		Duolingo
tridek	tridek		Duolingo
triki	triki		Duolingo
trikis	trikis		Duolingo
trinkaĵo	trinkajo		Duolingo
trinkaĵon	trinkajon		Duolingo
trinkas	trinkas		Duolingo
trinki	trinki		Duolingo
trinkis	trinkis		Duolingo
triono	triono		Duolingo
tro	tro		Duolingo
trovas	trovas		Duolingo
trovi	trovi		Duolingo
troviĝas	trovigas		Duolingo
tuj	tuj		Duolingo
tujmesaĝilo	tujmesagilo		Duolingo
tujmesaĝilon	tujmesagilon		Duolingo
turnis	turnis		Duolingo
turnu	turnu		Duolingo
turo	turo		Duolingo
turon	turon		Duolingo
tusas	tusas		Duolingo
tuŝu	tusu		Duolingo
tuta	tuta		Duolingo
tutan	tutan		Duolingo
tute	tute		Duolingo
uea	uea		Duolingo
ujo	ujo		Duolingo
ujon	ujon		Duolingo
uk	uk		Duolingo
ulo	ulo		Duolingo
uloj	uloj		Duolingo
ulon	ulon		Duolingo
uniformojn	uniformojn		Duolingo
uniformon	uniformon		Duolingo
universitato	universitato		Duolingo
universitatoj	universitatoj		Duolingo
unu	unu		Duolingo
unua	unua		Duolingo
unuafoje	unuafoje		Duolingo
urbestro	urbestro		Duolingo
urbo	urbo		Duolingo
urboj	urboj		Duolingo
urso	urso		Duolingo
ursoj	ursoj		Duolingo
urson	urson		Duolingo
usonano	usonano		Duolingo
usonanoj	usonanoj		Duolingo
usonanon	usonanon		Duolingo
usono	usono		Duolingo
usonon	usonon		Duolingo
utila	utila		Duolingo
utilaj	utilaj		Duolingo
uzantnomo	uzantnomo		Duolingo
uzantnomon	uzantnomon		Duolingo
uzas	uzas		Duolingo
uzi	uzi		Duolingo
uzis	uzis		Duolingo
uzos	uzos		Duolingo
varma	varma		Duolingo
varmajn	varmajn		Duolingo
varman	varman		Duolingo
varme	varme		Duolingo
varmega	varmega		Duolingo
varmegajn	varmegajn		Duolingo
varmeta	varmeta		Duolingo
varmetan	varmetan		Duolingo
ve	ve		Duolingo
vegana	vegana		Duolingo
vegano	vegano		Duolingo
veganoj	veganoj		Duolingo
vegetara	vegetara		Duolingo
vegetarajn	vegetarajn		Duolingo
vegetaran	vegetaran		Duolingo
vegetarano	vegetarano		Duolingo
vegetaranoj	vegetaranoj		Duolingo
vegetaranon	vegetaranon		Duolingo
vekas	vekas		Duolingo
veki	veki		Duolingo
vekiĝas	vekigas		Duolingo
vekiĝos	vekigos		Duolingo
vekis	vekis		Duolingo
venas	venas		Duolingo
vendas	vendas		Duolingo
vendejo	vendejo		Duolingo
vendejon	vendejon		Duolingo
vendi	vendi		Duolingo
vendis	vendis		Duolingo
vendisto	vendisto		Duolingo
vendistoj	vendistoj		Duolingo
vendos	vendos		Duolingo
vendredo	vendredo		Duolingo
vendredon	vendredon		Duolingo
venezuela	venezuela		Duolingo
venezuelanon	venezuelanon		Duolingo
venezuelo	venezuelo		Duolingo
veni	veni		Duolingo
venis	venis		Duolingo
venos	venos		Duolingo
ventro	ventro		Duolingo
vera	vera		Duolingo
verda	verda		Duolingo
verdajn	verdajn		Duolingo
verdan	verdan		Duolingo
vere	vere		Duolingo
verkas	verkas		Duolingo
verkis	verkis		Duolingo
verkisto	verkisto		Duolingo
verko	verko		Duolingo
vero	vero		Duolingo
veron	veron		Duolingo
verŝajne	versajne		Duolingo
verŝas	versas		Duolingo
verŝi	versi		Duolingo
vespere	vespere		Duolingo
vespermanĝas	vespermangas		Duolingo
vespermanĝo	vespermango		Duolingo
vespermanĝon	vespermangon		Duolingo
vestaĵo	vestajo		Duolingo
vestaĵoj	vestajoj		Duolingo
vestaĵojn	vestajojn		Duolingo
vesti	vesti		Duolingo
vestis	vestis		Duolingo
vestoŝranko	vestosranko		Duolingo
vetero	vetero		Duolingo
vi	vi		Duolingo
via	via		Duolingo
viaj	viaj		Duolingo
viando	viando		Duolingo
viandon	viandon		Duolingo
vico	vico		Duolingo
vidas	vidas		Duolingo
vidi	vidi		Duolingo
vidis	vidis		Duolingo
vidos	vidos		Duolingo
vigla	vigla		Duolingo
viktimo	viktimo		Duolingo
viktimoj	viktimoj		Duolingo
vilaĝo	vilago		Duolingo
vin	vin		Duolingo
vino	vino		Duolingo
vinon	vinon		Duolingo
vintro	vintro		Duolingo
violkolora	violkolora		Duolingo
virino	virino		Duolingo
virinoj	virinoj		Duolingo
virinon	virinon		Duolingo
viro	viro		Duolingo
viroj	viroj		Duolingo
virojn	virojn		Duolingo
viron	viron		Duolingo
vitro	vitro		Duolingo
vivas	vivas		Duolingo
vivi	vivi		Duolingo
vivon	vivon		Duolingo
vizaĝo	vizago		Duolingo
vizaĝon	vizagon		Duolingo
vizitas	vizitas		Duolingo
viziti	viziti		Duolingo
vizito	vizito		Duolingo
vizitojn	vizitojn		Duolingo
viziton	viziton		Duolingo
vizitos	vizitos		Duolingo
vizitu	vizitu		Duolingo
voĉo	voco		Duolingo
voĉojn	vocojn		Duolingo
voĉon	vocon		Duolingo
vojaĝas	vojagas		Duolingo
vojaĝi	vojagi		Duolingo
vojaĝo	vojago		Duolingo
vojaĝon	vojagon		Duolingo
vojo	vojo		Duolingo
volas	volas		Duolingo
volis	volis		Duolingo
volontulo	volontulo		Duolingo
volontulojn	volontulojn		Duolingo
volontulu	volontulu		Duolingo
volos	volos		Duolingo
vortaro	vortaro		Duolingo
vortaroj	vortaroj		Duolingo
vortarojn	vortarojn		Duolingo
vortaron	vortaron		Duolingo
vorto	vorto		Duolingo
vortojn	vortojn		Duolingo
vorton	vorton		Duolingo
vosto	vosto		Duolingo
vostojn	vostojn		Duolingo
voston	voston		Duolingo
zipo	zipo		Duolingo
zipojn	zipojn		Duolingo
zipon	zipon		Duolingo
zono	zono		Duolingo
zonojn	zonojn		Duolingo
zonon	zonon		Duolingo
zorgas	zorgas		Duolingo
zorgi	zorgi		Duolingo
