learnable	normalized	partOfSpeech	source
!	!		Duolingo
¡	!		Duolingo
?	?		Duolingo
¿	?		Duolingo
a	a		Duolingo
a	a	preposition	Duolingo
a continuación	a continuacion		Duolingo
a cuánto	a cuanto		Duolingo
a distancia	a distancia		Duolingo
a dónde	a donde		Duolingo
a él	a el		Duolingo
a él le	a el le		Duolingo
a él le gustan	a el le gustan		Duolingo
a ella le	a ella le		Duolingo
a ella le gusta	a ella le gusta		Duolingo
a eso de	a eso de	adverb	Duolingo
a fin de	a fin de		Duolingo
a fin de cuentas	a fin de cuentas		Duolingo
a fondo	a fondo		Duolingo
a la perfección	a la perfeccion		Duolingo
a la venta	a la venta		Duolingo
a la vez	a la vez	adverb	Duolingo
a lo largo de	a lo largo de		Duolingo
a lo largo del	a lo largo del		Duolingo
a lo mejor	a lo mejor		Duolingo
a menudo	a menudo		Duolingo
a mí	a mi		Duolingo
a mí me	a mi me		Duolingo
a mí me gusta	a mi me gusta		Duolingo
a nosotros	a nosotros		Duolingo
a pie	a pie		Duolingo
a primera hora	a primera hora		Duolingo
a primera vista	a primera vista		Duolingo
a propósito	a proposito		Duolingo
a punto de	a punto de		Duolingo
a qué distancia	a que distancia		Duolingo
a qué hora	a que hora		Duolingo
a ti	a ti		Duolingo
a ti te	a ti te		Duolingo
a ti te gustan	a ti te gustan		Duolingo
a tiempo	a tiempo		Duolingo
a través de	a traves de		Duolingo
a través del	a traves del		Duolingo
a usted	a usted		Duolingo
a ustedes	a ustedes		Duolingo
a veces	a veces		Duolingo
a ver	a ver		Duolingo
abajo	abajo	adverb	Duolingo
abandonar	abandonar	verb	Duolingo
abierta	abierta	adjective	Duolingo
abiertas	abiertas	adjective	Duolingo
abierto	abierto	adjective	Duolingo
abiertos	abiertos	adjective	Duolingo
abogada	abogada	noun	Duolingo
abogado	abogado	noun	Duolingo
abogados	abogados	noun	Duolingo
abran	abran	verb	Duolingo
abras	abras	verb	Duolingo
abrazo	abrazo	noun	Duolingo
abre	abre	verb	Duolingo
abrelatas	abrelatas	noun	Duolingo
abren	abren		Duolingo
abren	abren	verb	Duolingo
abres	abres	verb	Duolingo
abres la	abres la		Duolingo
abrí	abri	verb	Duolingo
abriendo	abriendo	verb	Duolingo
abrieron	abrieron	verb	Duolingo
abrigo	abrigo		Duolingo
abrigo	abrigo	noun	Duolingo
abrigos	abrigos	noun	Duolingo
abril	abril	noun	Duolingo
abrimos	abrimos	verb	Duolingo
abrió	abrio	verb	Duolingo
abrir	abrir	verb	Duolingo
abrirlo	abrirlo		Duolingo
abrirlos	abrirlos	pronoun	Duolingo
abriste	abriste	verb	Duolingo
abro	abro	verb	Duolingo
absolutamente	absolutamente	adverb	Duolingo
abuela	abuela		Duolingo
abuela	abuela	noun	Duolingo
abuelita	abuelita	noun	Duolingo
abuelito	abuelito	noun	Duolingo
abuelitos	abuelitos	noun	Duolingo
abuelo	abuelo		Duolingo
abuelo	abuelo	noun	Duolingo
abuelos	abuelos	noun	Duolingo
aburridas	aburridas	adjective	Duolingo
aburridísima	aburridisima	adjective	Duolingo
aburridísimo	aburridisimo	adjective	Duolingo
aburridos	aburridos	adjective	Duolingo
acá	aca	adverb	Duolingo
acaba	acaba	verb	Duolingo
acabamos de	acabamos de		Duolingo
acabar	acabar	verb	Duolingo
acabas de	acabas de		Duolingo
acabo de	acabo de		Duolingo
academia	academia	noun	Duolingo
acampaba	acampaba	verb	Duolingo
acamparán	acamparan	verb	Duolingo
acamparé	acampare	verb	Duolingo
acamparemos	acamparemos	verb	Duolingo
acampas	acampas	verb	Duolingo
acceso	acceso	noun	Duolingo
acción	accion	noun	Duolingo
acciones	acciones	noun	Duolingo
aceite	aceite	noun	Duolingo
acepta	acepta	verb	Duolingo
aceptar	aceptar	verb	Duolingo
acepto	acepto	verb	Duolingo
acerca	acerca	preposition	Duolingo
ácido	acido	adjective	Duolingo
acompañaba	acompanaba	verb	Duolingo
acompañaban	acompanaban	verb	Duolingo
acompañar	acompanar	verb	Duolingo
acompañarán	acompanaran	verb	Duolingo
acompañó	acompano	verb	Duolingo
aconseja	aconseja	verb	Duolingo
aconsejas	aconsejas	verb	Duolingo
aconsejo	aconsejo	verb	Duolingo
acordarnos	acordarnos	pronoun	Duolingo
acordarte	acordarte	pronoun	Duolingo
acostarme	acostarme	pronoun	Duolingo
acostarse	acostarse	pronoun	Duolingo
acostarte	acostarte	pronoun	Duolingo
actitud	actitud	noun	Duolingo
actitudes	actitudes	noun	Duolingo
actividad	actividad	noun	Duolingo
actividades	actividades	noun	Duolingo
activos	activos	adjective	Duolingo
acto	acto	noun	Duolingo
actor	actor	noun	Duolingo
actores	actores	noun	Duolingo
actos	actos	noun	Duolingo
actuación	actuacion	noun	Duolingo
actualmente	actualmente	adverb	Duolingo
actuar	actuar	verb	Duolingo
acuerdo	acuerdo	noun	Duolingo
adecuada	adecuada	adjective	Duolingo
adecuado	adecuado	adjective	Duolingo
adelante	adelante	adverb	Duolingo
además	ademas	adverb	Duolingo
además de	ademas de		Duolingo
adentro	adentro	adverb	Duolingo
adicional	adicional	adjective	Duolingo
adiós	adios	interjection	Duolingo
adivinaremos	adivinaremos	verb	Duolingo
administración	administracion	noun	Duolingo
adónde	adonde	adverb	Duolingo
adulta	adulta	noun	Duolingo
adultas	adultas	noun	Duolingo
adulto	adulto	noun	Duolingo
adultos	adultos	noun	Duolingo
aeropuerto	aeropuerto		Duolingo
aeropuerto	aeropuerto	noun	Duolingo
aeropuertos	aeropuertos	noun	Duolingo
afecta	afecta	verb	Duolingo
afortunadamente	afortunadamente	adverb	Duolingo
afuera	afuera	adverb	Duolingo
agencia	agencia	noun	Duolingo
agente	agente	noun	Duolingo
agentes	agentes	noun	Duolingo
agosto	agosto	noun	Duolingo
agradables	agradables	adjective	Duolingo
agradecer	agradecer	verb	Duolingo
agradezco	agradezco	verb	Duolingo
agrega	agrega	verb	Duolingo
agregar	agregar	verb	Duolingo
agregué	agregue	verb	Duolingo
agricultores	agricultores	noun	Duolingo
agricultura	agricultura	noun	Duolingo
agua	agua	noun	Duolingo
aguacate	aguacate	noun	Duolingo
aguacates	aguacates	noun	Duolingo
ah	ah	interjection	Duolingo
ahí	ahi	adverb	Duolingo
ahora	ahora	adverb	Duolingo
ahora mismo	ahora mismo		Duolingo
ahora sí	ahora si		Duolingo
ahorrar	ahorrar	verb	Duolingo
ahorros	ahorros	noun	Duolingo
aire	aire	noun	Duolingo
ajedrez	ajedrez	noun	Duolingo
ajo	ajo	noun	Duolingo
al	al	preposition	Duolingo
al aire libre	al aire libre		Duolingo
al conducir	al conducir		Duolingo
al contrario	al contrario		Duolingo
al cruzar	al cruzar		Duolingo
al entrar	al entrar		Duolingo
al escuchar	al escuchar		Duolingo
al final	al final		Duolingo
al lado	al lado		Duolingo
al llegar	al llegar		Duolingo
al menos	al menos		Duolingo
al mismo tiempo	al mismo tiempo		Duolingo
al poco tiempo	al poco tiempo	adverb	Duolingo
al rato	al rato		Duolingo
al regresar	al regresar		Duolingo
al revés	al reves		Duolingo
al salir	al salir		Duolingo
al ver	al ver		Duolingo
alcalde	alcalde	noun	Duolingo
alcaldesa	alcaldesa	noun	Duolingo
alcanza	alcanza	verb	Duolingo
alcanzar	alcanzar	verb	Duolingo
alcanzó	alcanzo	verb	Duolingo
alcohol	alcohol	noun	Duolingo
alegre	alegre	adjective	Duolingo
alegres	alegres	adjective	Duolingo
alegría	alegria	noun	Duolingo
alejadas	alejadas	adjective	Duolingo
alejados	alejados	adjective	Duolingo
alemania	alemania	proper noun	Duolingo
alfombras	alfombras	noun	Duolingo
algo	algo	pronoun	Duolingo
algo de	algo de		Duolingo
algo más	algo mas		Duolingo
alguien	alguien	pronoun	Duolingo
algún	algun	determiner	Duolingo
algún día	algun dia		Duolingo
alguna	alguna	determiner	Duolingo
alguna	alguna	pronoun	Duolingo
alguna vez	alguna vez		Duolingo
algunas	algunas	determiner	Duolingo
alguno	alguno	pronoun	Duolingo
algunos	algunos	determiner	Duolingo
algunos	algunos	pronoun	Duolingo
allá	alla	adverb	Duolingo
allí	alli	adverb	Duolingo
alma	alma	noun	Duolingo
almas	almas	noun	Duolingo
almohadas	almohadas	noun	Duolingo
almorcé	almorce	verb	Duolingo
almorzaban	almorzaban	verb	Duolingo
almorzabas	almorzabas	verb	Duolingo
almorzamos	almorzamos	verb	Duolingo
almorzar	almorzar	verb	Duolingo
almorzaron	almorzaron	verb	Duolingo
almuerza	almuerza	verb	Duolingo
almuerzan	almuerzan	verb	Duolingo
almuerzas	almuerzas	verb	Duolingo
almuerzo	almuerzo	noun	Duolingo
almuerzo	almuerzo	verb	Duolingo
alquilar	alquilar	verb	Duolingo
alquiler	alquiler	noun	Duolingo
alrededor	alrededor	adverb	Duolingo
alrededor del	alrededor del		Duolingo
alrededores	alrededores		Duolingo
alta	alta	adjective	Duolingo
altas	altas	adjective	Duolingo
alternativa	alternativa	noun	Duolingo
alternativas	alternativas	noun	Duolingo
alto	alto	adjective	Duolingo
alto	alto	adverb	Duolingo
altos	altos	adjective	Duolingo
altura	altura	noun	Duolingo
aluminio	aluminio	noun	Duolingo
ama de casa	ama de casa		Duolingo
amabilidad	amabilidad	noun	Duolingo
amables	amables	adjective	Duolingo
amar	amar	verb	Duolingo
amarilla	amarilla	adjective	Duolingo
amarillas	amarillas	adjective	Duolingo
amarillo	amarillo	adjective	Duolingo
amarillos	amarillos	adjective	Duolingo
amas de casa	amas de casa		Duolingo
ambas	ambas	determiner	Duolingo
ambas	ambas	pronoun	Duolingo
ambiente	ambiente	noun	Duolingo
ambos	ambos	determiner	Duolingo
ambos	ambos	pronoun	Duolingo
ambulancia	ambulancia	noun	Duolingo
amé	ame	verb	Duolingo
américa	america	proper noun	Duolingo
americana	americana	adjective	Duolingo
americanas	americanas	adjective	Duolingo
americano	americano	adjective	Duolingo
americanos	americanos	adjective	Duolingo
amiga	amiga	noun	Duolingo
amigas	amigas	noun	Duolingo
amigo	amigo	noun	Duolingo
amigos	amigos	noun	Duolingo
amistad	amistad	noun	Duolingo
amó	amo	verb	Duolingo
amor	amor	noun	Duolingo
amplia	amplia	adjective	Duolingo
amplio	amplio	adjective	Duolingo
añade	anade	verb	Duolingo
añadir	anadir	verb	Duolingo
análisis	analisis	noun	Duolingo
análisis de sangre	analisis de sangre		Duolingo
analizar	analizar	verb	Duolingo
anchas	anchas	adjective	Duolingo
anda	anda	verb	Duolingo
andamos	andamos	verb	Duolingo
andan	andan	verb	Duolingo
andar	andar	verb	Duolingo
andén	anden	noun	Duolingo
anduve	anduve	verb	Duolingo
anduvieron	anduvieron	verb	Duolingo
anduvimos	anduvimos	verb	Duolingo
anduviste	anduviste	verb	Duolingo
anduvo	anduvo	verb	Duolingo
ángel	angel	noun	Duolingo
ángeles	angeles	noun	Duolingo
anillo	anillo	noun	Duolingo
anillos	anillos	noun	Duolingo
animal	animal	noun	Duolingo
animales	animales	noun	Duolingo
año	ano	noun	Duolingo
año nuevo	ano nuevo		Duolingo
anoche	anoche	adverb	Duolingo
años	anos	noun	Duolingo
anteayer	anteayer	adverb	Duolingo
anteriormente	anteriormente	adverb	Duolingo
antes	antes	adverb	Duolingo
antes	antes	preposition	Duolingo
antes de que	antes de que		Duolingo
antes de tiempo	antes de tiempo		Duolingo
antibiótico	antibiotico	noun	Duolingo
antigua	antigua	adjective	Duolingo
antiguo	antiguo	adjective	Duolingo
antiguos	antiguos	adjective	Duolingo
antivirus	antivirus	noun	Duolingo
anual	anual	adjective	Duolingo
anuncio	anuncio	noun	Duolingo
anuncios	anuncios	noun	Duolingo
apaga	apaga	verb	Duolingo
apagaba	apagaba	verb	Duolingo
apagaban	apagaban	verb	Duolingo
apagadas	apagadas	adjective	Duolingo
apagados	apagados	adjective	Duolingo
apagar	apagar	verb	Duolingo
apagaste	apagaste	verb	Duolingo
apagó	apago	verb	Duolingo
aparato	aparato	noun	Duolingo
aparece	aparece	verb	Duolingo
aparecen	aparecen	verb	Duolingo
aparecer	aparecer	verb	Duolingo
apareció	aparecio	verb	Duolingo
aparentemente	aparentemente	adverb	Duolingo
apartamento	apartamento		Duolingo
apenas	apenas	adverb	Duolingo
aplicación	aplicacion	noun	Duolingo
aplicaciones	aplicaciones	noun	Duolingo
aplicar	aplicar	verb	Duolingo
aprende	aprende	verb	Duolingo
aprendemos	aprendemos	verb	Duolingo
aprenden	aprenden	verb	Duolingo
aprender	aprender	verb	Duolingo
aprenderíamos	aprenderiamos	verb	Duolingo
aprendes	aprendes	verb	Duolingo
aprendí	aprendi	verb	Duolingo
aprendiendo	aprendiendo	verb	Duolingo
aprendiendo a	aprendiendo a		Duolingo
aprendieron	aprendieron	verb	Duolingo
aprendimos	aprendimos	verb	Duolingo
aprendió	aprendio	verb	Duolingo
aprendiste	aprendiste	verb	Duolingo
aprendo	aprendo	verb	Duolingo
aprobar	aprobar	verb	Duolingo
aprobaron	aprobaron	verb	Duolingo
aprobaste	aprobaste	verb	Duolingo
aproximadamente	aproximadamente	adverb	Duolingo
aprueba	aprueba	verb	Duolingo
apruebo	apruebo	verb	Duolingo
apuntes	apuntes	noun	Duolingo
aquel	aquel	determiner	Duolingo
aquella	aquella	determiner	Duolingo
aquellas	aquellas	determiner	Duolingo
aquellos	aquellos	determiner	Duolingo
aquí	aqui		Duolingo
aquí	aqui	adverb	Duolingo
aquí mismo	aqui mismo		Duolingo
aquí tiene	aqui tiene		Duolingo
araña	arana	noun	Duolingo
árbol	arbol	noun	Duolingo
árboles	arboles	noun	Duolingo
archivos	archivos	noun	Duolingo
área	area	noun	Duolingo
áreas	areas	noun	Duolingo
arena	arena	noun	Duolingo
argentina	argentina	adjective	Duolingo
argentina	argentina	proper noun	Duolingo
argentino	argentino	adjective	Duolingo
argumento	argumento	noun	Duolingo
argumentos	argumentos	noun	Duolingo
arma	arma	noun	Duolingo
armario	armario	noun	Duolingo
armas	armas	noun	Duolingo
arquitectura	arquitectura	noun	Duolingo
arriba	arriba	adverb	Duolingo
arroba	arroba	noun	Duolingo
arroz	arroz	noun	Duolingo
arte	arte	noun	Duolingo
artes	artes	noun	Duolingo
artículo	articulo	noun	Duolingo
artículos	articulos	noun	Duolingo
artista	artista	noun	Duolingo
artistas	artistas	noun	Duolingo
asa	asa	verb	Duolingo
asaba	asaba	verb	Duolingo
asabas	asabas	verb	Duolingo
asada	asada	adjective	Duolingo
asado	asado	adjective	Duolingo
asarán	asaran	verb	Duolingo
asarás	asaras	verb	Duolingo
ascensor	ascensor	noun	Duolingo
asesina	asesina	noun	Duolingo
asesinas	asesinas	noun	Duolingo
así	asi	adverb	Duolingo
así que	asi que		Duolingo
asientos	asientos	noun	Duolingo
asignatura	asignatura	noun	Duolingo
asignaturas	asignaturas	noun	Duolingo
aspecto	aspecto	noun	Duolingo
astrología	astrologia	noun	Duolingo
asumir	asumir	verb	Duolingo
asunto	asunto	noun	Duolingo
atájaselo	atajaselo		Duolingo
ataques	ataques	noun	Duolingo
atención	atencion	noun	Duolingo
atención médica	atencion medica		Duolingo
atender	atender	verb	Duolingo
atentamente	atentamente	adverb	Duolingo
atleta	atleta	noun	Duolingo
atletas	atletas	noun	Duolingo
atletismo	atletismo	noun	Duolingo
atmósfera	atmosfera	noun	Duolingo
atractivo	atractivo	adjective	Duolingo
atrás	atras	adverb	Duolingo
atún	atun	noun	Duolingo
audiencia	audiencia	noun	Duolingo
aumentar	aumentar	verb	Duolingo
aún	aun	adverb	Duolingo
aún así	aun asi		Duolingo
aún no	aun no	adverb	Duolingo
aunque	aunque	conjunction	Duolingo
aunque sea	aunque sea		Duolingo
ausencia	ausencia	noun	Duolingo
ausencias	ausencias	noun	Duolingo
australia	australia	proper noun	Duolingo
auto	auto	noun	Duolingo
autobiografía	autobiografia	noun	Duolingo
autobús	autobus		Duolingo
autobús	autobus	noun	Duolingo
autobuses	autobuses	noun	Duolingo
autopista	autopista	noun	Duolingo
autor	autor	noun	Duolingo
autora	autora	noun	Duolingo
auxilio	auxilio	interjection	Duolingo
avanzada	avanzada	adjective	Duolingo
avanzado	avanzado	adjective	Duolingo
avena	avena	noun	Duolingo
avenida	avenida	noun	Duolingo
avenidas	avenidas	noun	Duolingo
aventura	aventura	noun	Duolingo
aventuras	aventuras	noun	Duolingo
avión	avion	noun	Duolingo
aviso	aviso	noun	Duolingo
ay	ay	interjection	Duolingo
ayer	ayer	adverb	Duolingo
ayuda	ayuda	noun	Duolingo
ayuda	ayuda	verb	Duolingo
ayudábamos	ayudabamos	verb	Duolingo
ayudabas	ayudabas	verb	Duolingo
ayúdame	ayudame		Duolingo
ayudamos	ayudamos	verb	Duolingo
ayudar	ayudar	verb	Duolingo
ayudaron	ayudaron	verb	Duolingo
ayudas	ayudas	verb	Duolingo
ayudaste	ayudaste	verb	Duolingo
ayude	ayude	verb	Duolingo
ayudo a	ayudo a		Duolingo
azúcar	azucar		Duolingo
azúcar	azucar	noun	Duolingo
azul	azul		Duolingo
azul	azul	adjective	Duolingo
azules	azules	adjective	Duolingo
bádminton	badminton	noun	Duolingo
baila	baila	verb	Duolingo
bailábamos	bailabamos	verb	Duolingo
bailaban	bailaban	verb	Duolingo
bailabas	bailabas	verb	Duolingo
bailamos	bailamos	verb	Duolingo
bailan	bailan	verb	Duolingo
bailando	bailando	verb	Duolingo
bailar	bailar	verb	Duolingo
bailarina	bailarina	noun	Duolingo
bailaron	bailaron	verb	Duolingo
bailas	bailas	verb	Duolingo
bailaste	bailaste	verb	Duolingo
baile	baile	noun	Duolingo
bailes	bailes	verb	Duolingo
bailo	bailo	verb	Duolingo
baja	baja	adjective	Duolingo
baja	baja	verb	Duolingo
bajan	bajan	verb	Duolingo
bajarte	bajarte	pronoun	Duolingo
bajas	bajas	adjective	Duolingo
bajito	bajito	adjective	Duolingo
bajo	bajo	adjective	Duolingo
bajo	bajo	preposition	Duolingo
bajo	bajo	verb	Duolingo
bajo cero	bajo cero		Duolingo
bajos	bajos	adjective	Duolingo
balcón	balcon	noun	Duolingo
ballet	ballet	noun	Duolingo
baloncesto	baloncesto	noun	Duolingo
balonmano	balonmano	noun	Duolingo
banana	banana	noun	Duolingo
bananas	bananas	noun	Duolingo
banco	banco		Duolingo
banco	banco	noun	Duolingo
bancos	bancos	noun	Duolingo
bandera	bandera	noun	Duolingo
baño	bano		Duolingo
baño	bano	noun	Duolingo
baños	banos	noun	Duolingo
bar	bar	noun	Duolingo
barata	barata	adjective	Duolingo
baratas	baratas	adjective	Duolingo
barato	barato		Duolingo
barato	barato	adjective	Duolingo
baratos	baratos	adjective	Duolingo
barba	barba	noun	Duolingo
Barcelona	barcelona	proper noun	Duolingo
barco	barco	noun	Duolingo
barcos	barcos	noun	Duolingo
barrio	barrio	noun	Duolingo
básicamente	basicamente	adverb	Duolingo
básico	basico	adjective	Duolingo
básicos	basicos	adjective	Duolingo
bastante	bastante	adverb	Duolingo
basura	basura	noun	Duolingo
basureros	basureros	noun	Duolingo
batería	bateria	noun	Duolingo
baterías	baterias	noun	Duolingo
batir	batir	verb	Duolingo
beba	beba	verb	Duolingo
bebamos	bebamos	verb	Duolingo
beban	beban	verb	Duolingo
bebas	bebas	verb	Duolingo
bebé	bebe	noun	Duolingo
bebe	bebe	verb	Duolingo
bebéis	bebeis	verb	Duolingo
bébelo	bebelo		Duolingo
bébelos	bebelos		Duolingo
bebemos	bebemos	verb	Duolingo
beben	beben		Duolingo
beben	beben	verb	Duolingo
beber	beber	verb	Duolingo
beberá	bebera	verb	Duolingo
beberán	beberan	verb	Duolingo
beberás	beberas	verb	Duolingo
beberé	bebere	verb	Duolingo
bebería	beberia	verb	Duolingo
beberían	beberian	verb	Duolingo
beberías	beberias	verb	Duolingo
beberla	beberla	pronoun	Duolingo
beberlas	beberlas	pronoun	Duolingo
beberlo	beberlo		Duolingo
bebés	bebes	noun	Duolingo
bebes	bebes	verb	Duolingo
bebí	bebi	verb	Duolingo
bebía	bebia	verb	Duolingo
bebíamos	bebiamos	verb	Duolingo
bebían	bebian	verb	Duolingo
bebías	bebias	verb	Duolingo
bebida	bebida	verb	Duolingo
bebidas	bebidas	verb	Duolingo
bebidos	bebidos	verb	Duolingo
bebiendo	bebiendo	verb	Duolingo
bebieron	bebieron	verb	Duolingo
bebimos	bebimos	verb	Duolingo
bebió	bebio	verb	Duolingo
bebiste	bebiste	verb	Duolingo
bebo	bebo	verb	Duolingo
béisbol	beisbol	noun	Duolingo
belleza	belleza	noun	Duolingo
bellísimos	bellisimos	adjective	Duolingo
beneficio	beneficio	noun	Duolingo
beneficios	beneficios	noun	Duolingo
biblioteca	biblioteca	noun	Duolingo
bibliotecas	bibliotecas	noun	Duolingo
bici	bici	noun	Duolingo
bicicleta	bicicleta		Duolingo
bicicleta	bicicleta	noun	Duolingo
bicicletas	bicicletas	noun	Duolingo
bien	bien	adverb	Duolingo
bien	bien	noun	Duolingo
bienestar	bienestar	noun	Duolingo
bienvenida	bienvenida	adjective	Duolingo
bienvenidas	bienvenidas	adjective	Duolingo
bilingüe	bilingue	adjective	Duolingo
bilingües	bilingues	adjective	Duolingo
biología	biologia	noun	Duolingo
bistec	bistec	noun	Duolingo
blanca	blanca	adjective	Duolingo
blancas	blancas	adjective	Duolingo
blanco	blanco	adjective	Duolingo
blancos	blancos	adjective	Duolingo
blog	blog	noun	Duolingo
boca	boca	noun	Duolingo
bola	bola	noun	Duolingo
bolas	bolas	noun	Duolingo
boles	boles	noun	Duolingo
boleto	boleto		Duolingo
boleto	boleto	noun	Duolingo
boletos	boletos	noun	Duolingo
bolígrafo	boligrafo		Duolingo
bolígrafo	boligrafo	noun	Duolingo
bolígrafos	boligrafos	noun	Duolingo
bolsa	bolsa	noun	Duolingo
bolsas	bolsas	noun	Duolingo
bomba	bomba	noun	Duolingo
bombas	bombas	noun	Duolingo
bonita	bonita	adjective	Duolingo
bonitas	bonitas	adjective	Duolingo
bonito	bonito		Duolingo
bonito	bonito	adjective	Duolingo
bonitos	bonitos	adjective	Duolingo
borrador	borrador	noun	Duolingo
borradores	borradores	noun	Duolingo
bosque	bosque		Duolingo
bosque	bosque	noun	Duolingo
bota	bota	noun	Duolingo
botas	botas	noun	Duolingo
botas montañeras	botas montaneras		Duolingo
botella	botella	noun	Duolingo
botellas	botellas	noun	Duolingo
boxeo	boxeo	noun	Duolingo
brazalete	brazalete	noun	Duolingo
brazaletes	brazaletes	noun	Duolingo
brazo	brazo	noun	Duolingo
brazos	brazos	noun	Duolingo
brevemente	brevemente	adverb	Duolingo
breves	breves	adjective	Duolingo
brillante	brillante	adjective	Duolingo
brindis	brindis	noun	Duolingo
británica	britanica	adjective	Duolingo
británico	britanico	adjective	Duolingo
brócoli	brocoli	noun	Duolingo
bronquitis	bronquitis	noun	Duolingo
buen	buen	adjective	Duolingo
buen provecho	buen provecho		Duolingo
buen tiempo	buen tiempo		Duolingo
buena	buena	adjective	Duolingo
buenas	buenas	adjective	Duolingo
buenas noches	buenas noches		Duolingo
buenas noches	buenas noches	interjection	Duolingo
buenas tardes	buenas tardes		Duolingo
bueno	bueno	adjective	Duolingo
bueno	bueno	interjection	Duolingo
buenos	buenos	adjective	Duolingo
buenos días	buenos dias		Duolingo
buenos días	buenos dias	interjection	Duolingo
bufanda	bufanda	noun	Duolingo
bufandas	bufandas	noun	Duolingo
búhos	buhos	noun	Duolingo
Burdeos	burdeos	proper noun	Duolingo
busca	busca	verb	Duolingo
buscan	buscan	verb	Duolingo
buscando	buscando	verb	Duolingo
buscar	buscar	verb	Duolingo
busco	busco	verb	Duolingo
busqué	busque	verb	Duolingo
búsqueda	busqueda	noun	Duolingo
buzón de voz	buzon de voz		Duolingo
caballero	caballero	noun	Duolingo
caballo	caballo	noun	Duolingo
caballos	caballos	noun	Duolingo
cabe	cabe	verb	Duolingo
caben	caben	verb	Duolingo
cabeza	cabeza	noun	Duolingo
cabezas	cabezas	noun	Duolingo
cable	cable	noun	Duolingo
cada	cada	adjective	Duolingo
cada	cada	determiner	Duolingo
cada vez más	cada vez mas	adverb	Duolingo
cadáver	cadaver	noun	Duolingo
cadena	cadena	noun	Duolingo
cadenas	cadenas	noun	Duolingo
cae	cae	verb	Duolingo
caen	caen	verb	Duolingo
caer	caer	verb	Duolingo
caerte	caerte	pronoun	Duolingo
café	cafe		Duolingo
café	cafe	noun	Duolingo
cafés	cafes	noun	Duolingo
cafetera	cafetera	noun	Duolingo
cafetería	cafeteria	noun	Duolingo
caí	cai	verb	Duolingo
caída	caida	noun	Duolingo
caja	caja	noun	Duolingo
cajeras	cajeras	noun	Duolingo
cajero	cajero	noun	Duolingo
cajeros	cajeros	noun	Duolingo
cajón	cajon	noun	Duolingo
cajones	cajones	noun	Duolingo
calcetín	calcetin	noun	Duolingo
calcetines	calcetines	noun	Duolingo
calefacción	calefaccion	noun	Duolingo
calendario	calendario	noun	Duolingo
calentamiento	calentamiento	noun	Duolingo
calidad	calidad	noun	Duolingo
calientes	calientes	adjective	Duolingo
calle	calle		Duolingo
calle	calle	noun	Duolingo
calles	calles	noun	Duolingo
calor	calor	noun	Duolingo
calurosa	calurosa	adjective	Duolingo
calurosos	calurosos	adjective	Duolingo
cama	cama	noun	Duolingo
cámara	camara	noun	Duolingo
cámaras	camaras	noun	Duolingo
camarera	camarera	noun	Duolingo
camareras	camareras	noun	Duolingo
camarero	camarero	noun	Duolingo
camareros	camareros	noun	Duolingo
camas	camas	noun	Duolingo
cambiando	cambiando	verb	Duolingo
cambiar	cambiar	verb	Duolingo
cambiaron	cambiaron	verb	Duolingo
cambio	cambio	noun	Duolingo
cambios	cambios	noun	Duolingo
camina	camina	verb	Duolingo
caminaba	caminaba	verb	Duolingo
caminábamos	caminabamos	verb	Duolingo
caminaban	caminaban	verb	Duolingo
caminamos	caminamos	verb	Duolingo
caminan	caminan	verb	Duolingo
caminando	caminando	verb	Duolingo
caminar	caminar	verb	Duolingo
caminaron	caminaron	verb	Duolingo
caminas	caminas	verb	Duolingo
caminaste	caminaste	verb	Duolingo
caminé	camine	verb	Duolingo
camino	camino	noun	Duolingo
caminó	camino	verb	Duolingo
camisa	camisa		Duolingo
camisa	camisa	noun	Duolingo
camisas	camisas	noun	Duolingo
camiseta	camiseta		Duolingo
camiseta	camiseta	noun	Duolingo
camisetas	camisetas	noun	Duolingo
campamento	campamento	noun	Duolingo
campana	campana	noun	Duolingo
campeón	campeon	noun	Duolingo
campeona	campeona	noun	Duolingo
campeonato	campeonato	noun	Duolingo
campesinos	campesinos	noun	Duolingo
campo	campo	noun	Duolingo
campos	campos	noun	Duolingo
campus	campus	noun	Duolingo
canadiense	canadiense	adjective	Duolingo
canadienses	canadienses	noun	Duolingo
canal	canal	noun	Duolingo
canales	canales	noun	Duolingo
cancelación	cancelacion	noun	Duolingo
cancelaciones	cancelaciones	noun	Duolingo
canción	cancion	noun	Duolingo
canciones	canciones	noun	Duolingo
candidato	candidato	noun	Duolingo
candidatos	candidatos	noun	Duolingo
cangrejo	cangrejo	noun	Duolingo
cansada	cansada	adjective	Duolingo
cansadas	cansadas	adjective	Duolingo
cansadísimo	cansadisimo	adjective	Duolingo
cansado	cansado	adjective	Duolingo
cansados	cansados	adjective	Duolingo
canta	canta	verb	Duolingo
cantaba	cantaba	verb	Duolingo
cantabas	cantabas	verb	Duolingo
cantamos	cantamos	verb	Duolingo
cantan	cantan	verb	Duolingo
cantando	cantando	verb	Duolingo
cantar	cantar	verb	Duolingo
cantaron	cantaron	verb	Duolingo
cantidad	cantidad	noun	Duolingo
cantó	canto	verb	Duolingo
capacidad	capacidad	noun	Duolingo
capaz	capaz	adjective	Duolingo
capital	capital	noun	Duolingo
capitán	capitan	noun	Duolingo
capitana	capitana	noun	Duolingo
capítulo	capitulo	noun	Duolingo
capítulos	capitulos	noun	Duolingo
cara	cara	adjective	Duolingo
cara	cara	noun	Duolingo
cara a cara	cara a cara		Duolingo
carácter	caracter	noun	Duolingo
carácteres	caracteres	noun	Duolingo
cárcel	carcel	noun	Duolingo
cargo	cargo	noun	Duolingo
cargos	cargos	noun	Duolingo
caribe	caribe	noun	Duolingo
cariño	carino	noun	Duolingo
carísima	carisima	adjective	Duolingo
carísimas	carisimas	adjective	Duolingo
carne	carne		Duolingo
carne	carne	noun	Duolingo
carnes	carnes	noun	Duolingo
carnicería	carniceria	noun	Duolingo
caro	caro		Duolingo
caro	caro	adjective	Duolingo
caros	caros	adjective	Duolingo
carpetas	carpetas	noun	Duolingo
carpintera	carpintera	noun	Duolingo
carpintero	carpintero	noun	Duolingo
carrera	carrera	noun	Duolingo
carreras	carreras	noun	Duolingo
carretera	carretera	noun	Duolingo
carro	carro		Duolingo
carro	carro	noun	Duolingo
carros	carros	noun	Duolingo
carta	carta	noun	Duolingo
cartas	cartas	noun	Duolingo
cartera	cartera		Duolingo
cartera	cartera	noun	Duolingo
carteras	carteras	noun	Duolingo
casa	casa		Duolingo
casa	casa	noun	Duolingo
casada	casada	verb	Duolingo
casado	casado	verb	Duolingo
casaron	casaron	verb	Duolingo
casas	casas	noun	Duolingo
casi	casi	adverb	Duolingo
casi nunca	casi nunca		Duolingo
castaño	castano	adjective	Duolingo
castillo	castillo	noun	Duolingo
categoría	categoria	noun	Duolingo
categorías	categorias	noun	Duolingo
católica	catolica	adjective	Duolingo
católico	catolico	adjective	Duolingo
catorce	catorce	numeral	Duolingo
causa	causa	noun	Duolingo
causaron	causaron	verb	Duolingo
causas	causas	noun	Duolingo
causó	causo	verb	Duolingo
cayó	cayo	verb	Duolingo
cebolla	cebolla	noun	Duolingo
cebollas	cebollas	noun	Duolingo
celebración	celebracion	noun	Duolingo
celular	celular	adjective	Duolingo
celular	celular	noun	Duolingo
celulares	celulares	noun	Duolingo
células	celulas	noun	Duolingo
cena	cena	noun	Duolingo
cenaba	cenaba	verb	Duolingo
cenábamos	cenabamos	verb	Duolingo
cenamos	cenamos	verb	Duolingo
cenan	cenan	verb	Duolingo
cenar	cenar	verb	Duolingo
cenaron	cenaron	verb	Duolingo
cenó	ceno	verb	Duolingo
centavos	centavos	noun	Duolingo
centímetros	centimetros	noun	Duolingo
centro	centro	noun	Duolingo
centroamérica	centroamerica	proper noun	Duolingo
centros	centros	noun	Duolingo
cepillarse	cepillarse	pronoun	Duolingo
cepillo	cepillo	noun	Duolingo
cepillo de dientes	cepillo de dientes		Duolingo
cepillos	cepillos	noun	Duolingo
cerca	cerca	adverb	Duolingo
cerca	cerca	preposition	Duolingo
cerca de	cerca de		Duolingo
cercano	cercano	adjective	Duolingo
cerdo	cerdo	noun	Duolingo
cerdos	cerdos	noun	Duolingo
cereal	cereal	noun	Duolingo
cereales	cereales	noun	Duolingo
cerebro	cerebro	noun	Duolingo
ceremonia	ceremonia	noun	Duolingo
cero	cero	noun	Duolingo
cerrado	cerrado		Duolingo
cerramos	cerramos	verb	Duolingo
cerrar	cerrar	verb	Duolingo
cerraron	cerraron	verb	Duolingo
cerré	cerre	verb	Duolingo
cerremos	cerremos	verb	Duolingo
cerró	cerro	verb	Duolingo
cerveza	cerveza	noun	Duolingo
césped	cesped	noun	Duolingo
champán	champan	noun	Duolingo
champanes	champanes	noun	Duolingo
champiñones	champinones	noun	Duolingo
chaqueta	chaqueta		Duolingo
chateamos	chateamos	verb	Duolingo
chateó	chateo	verb	Duolingo
chau	chau	interjection	Duolingo
chef	chef	noun	Duolingo
chica	chica	noun	Duolingo
chicas	chicas	noun	Duolingo
chico	chico	noun	Duolingo
chicos	chicos	noun	Duolingo
chilena	chilena	adjective	Duolingo
chilenos	chilenos	adjective	Duolingo
china	china	adjective	Duolingo
china	china	proper noun	Duolingo
chino	chino	adjective	Duolingo
chocolates	chocolates	noun	Duolingo
chorizo	chorizo	noun	Duolingo
chorizos	chorizos	noun	Duolingo
ciclismo	ciclismo	noun	Duolingo
cielo	cielo	noun	Duolingo
cien	cien	numeral	Duolingo
ciencia	ciencia	noun	Duolingo
ciencia ficción	ciencia ficcion		Duolingo
ciencias	ciencias	noun	Duolingo
científica	cientifica	adjective	Duolingo
científicas	cientificas	adjective	Duolingo
científico	cientifico	adjective	Duolingo
ciento	ciento	numeral	Duolingo
cierra	cierra	verb	Duolingo
cierran	cierran	verb	Duolingo
cierras	cierras	verb	Duolingo
cierras la	cierras la		Duolingo
cierren	cierren	verb	Duolingo
cierres	cierres	verb	Duolingo
cierro	cierro	verb	Duolingo
cierro la	cierro la		Duolingo
cierto	cierto	adjective	Duolingo
cifra	cifra	noun	Duolingo
cifras	cifras	noun	Duolingo
cigarrillos	cigarrillos	noun	Duolingo
cinco	cinco	numeral	Duolingo
cincuenta	cincuenta	numeral	Duolingo
cine	cine	noun	Duolingo
cintura	cintura	noun	Duolingo
cinturón	cinturon		Duolingo
cinturón	cinturon	noun	Duolingo
cinturones	cinturones	noun	Duolingo
circo	circo	noun	Duolingo
circulación	circulacion	noun	Duolingo
círculo	circulo	noun	Duolingo
círculos	circulos	noun	Duolingo
circunstancias	circunstancias	noun	Duolingo
cita	cita	noun	Duolingo
citas	citas	noun	Duolingo
ciudad	ciudad	noun	Duolingo
ciudad natal	ciudad natal		Duolingo
ciudadana	ciudadana	noun	Duolingo
ciudadano	ciudadano	noun	Duolingo
ciudadanos	ciudadanos	noun	Duolingo
ciudades	ciudades	noun	Duolingo
clara	clara	adjective	Duolingo
claramente	claramente	adverb	Duolingo
claro	claro	adjective	Duolingo
claro	claro	adverb	Duolingo
claro que sí	claro que si		Duolingo
clase	clase		Duolingo
clase	clase	noun	Duolingo
clases	clases	noun	Duolingo
clásica	clasica	adjective	Duolingo
clásica	clasica	noun	Duolingo
clásico	clasico	adjective	Duolingo
clásicos	clasicos	adjective	Duolingo
clave	clave	noun	Duolingo
clic	clic	noun	Duolingo
clima	clima	noun	Duolingo
clínica	clinica	noun	Duolingo
cobre	cobre	noun	Duolingo
coche	coche	noun	Duolingo
coches	coches	noun	Duolingo
cocina	cocina	noun	Duolingo
cocina	cocina	verb	Duolingo
cocinaba	cocinaba	verb	Duolingo
cocinada	cocinada	verb	Duolingo
cocinado	cocinado	verb	Duolingo
cocinamos	cocinamos	verb	Duolingo
cocinan	cocinan	verb	Duolingo
cocinando	cocinando	verb	Duolingo
cocinándolas	cocinandolas	pronoun	Duolingo
cocinar	cocinar	verb	Duolingo
cocinaron	cocinaron	verb	Duolingo
cocinas	cocinas	noun	Duolingo
cocinas	cocinas	verb	Duolingo
cocinaste	cocinaste	verb	Duolingo
cocinera	cocinera	adjective	Duolingo
cocinera	cocinera	noun	Duolingo
cocinero	cocinero	adjective	Duolingo
cocinero	cocinero	noun	Duolingo
cocineros	cocineros	adjective	Duolingo
cocineros	cocineros	noun	Duolingo
cocinó	cocino	verb	Duolingo
código	codigo	noun	Duolingo
codo	codo	noun	Duolingo
cogemos	cogemos	verb	Duolingo
cogen	cogen	verb	Duolingo
coger	coger	verb	Duolingo
coges	coges	verb	Duolingo
cogí	cogi	verb	Duolingo
cogimos	cogimos	verb	Duolingo
cogiste	cogiste	verb	Duolingo
cojo	cojo	verb	Duolingo
cola	cola		Duolingo
cola	cola	noun	Duolingo
colección	coleccion	noun	Duolingo
colecciona	colecciona	verb	Duolingo
colegio	colegio	noun	Duolingo
colesterol	colesterol	noun	Duolingo
colinas	colinas	noun	Duolingo
collar	collar	noun	Duolingo
colocar	colocar	verb	Duolingo
colonia	colonia	noun	Duolingo
color	color	noun	Duolingo
colores	colores	noun	Duolingo
columna	columna	noun	Duolingo
comamos	comamos	verb	Duolingo
coman	coman	verb	Duolingo
comandante	comandante	noun	Duolingo
comas	comas	verb	Duolingo
come	come	verb	Duolingo
coméis	comeis	verb	Duolingo
comemos	comemos	verb	Duolingo
comen	comen		Duolingo
comen	comen	verb	Duolingo
comencé	comence	verb	Duolingo
comentario	comentario	noun	Duolingo
comentarios	comentarios	noun	Duolingo
comenzamos	comenzamos	verb	Duolingo
comenzar	comenzar	verb	Duolingo
comenzaron	comenzaron	verb	Duolingo
comenzaste	comenzaste	verb	Duolingo
comenzó	comenzo	verb	Duolingo
comer	comer	verb	Duolingo
comer mucho	comer mucho		Duolingo
comer una	comer una		Duolingo
comerá	comera	verb	Duolingo
comerán	comeran	verb	Duolingo
comerás	comeras	verb	Duolingo
comercio	comercio	noun	Duolingo
comeré	comere	verb	Duolingo
comeremos	comeremos	verb	Duolingo
comería	comeria	verb	Duolingo
comerían	comerian	verb	Duolingo
comerías	comerias	verb	Duolingo
comerla	comerla	pronoun	Duolingo
comerlas	comerlas	pronoun	Duolingo
comerlo	comerlo		Duolingo
comes	comes	verb	Duolingo
cometa	cometa	noun	Duolingo
cometas	cometas	noun	Duolingo
comí	comi	verb	Duolingo
comía	comia	verb	Duolingo
comíamos	comiamos	verb	Duolingo
comían	comian	verb	Duolingo
comías	comias	verb	Duolingo
cómics	comics	noun	Duolingo
comida	comida	noun	Duolingo
comidas	comidas	verb	Duolingo
comidos	comidos	verb	Duolingo
comiendo	comiendo	verb	Duolingo
comienza	comienza	verb	Duolingo
comieron	comieron	verb	Duolingo
comimos	comimos	verb	Duolingo
comió	comio	verb	Duolingo
comiste	comiste	verb	Duolingo
cómo	como		Duolingo
como	como	adverb	Duolingo
como	como	conjunction	Duolingo
como	como	preposition	Duolingo
como	como	verb	Duolingo
cómo está	como esta		Duolingo
cómo está el tiempo	como esta el tiempo		Duolingo
cómo le va	como le va		Duolingo
como máximo	como maximo		Duolingo
como mínimo	como minimo		Duolingo
cómo puedo ir	como puedo ir		Duolingo
cómo quiere pagar	como quiere pagar		Duolingo
cómo quieres pagar	como quieres pagar		Duolingo
cómo se dice	como se dice		Duolingo
cómo se escribe	como se escribe		Duolingo
como siempre	como siempre		Duolingo
cómo te va	como te va		Duolingo
cómoda	comoda		Duolingo
cómoda	comoda	noun	Duolingo
cómodas	comodas	noun	Duolingo
comodidades	comodidades	noun	Duolingo
compañera	companera	noun	Duolingo
compañera de cuarto	companera de cuarto		Duolingo
compañeras de clase	companeras de clase		Duolingo
compañero	companero	noun	Duolingo
compañeros	companeros	noun	Duolingo
compañeros de clase	companeros de clase		Duolingo
compañeros de cuarto	companeros de cuarto		Duolingo
compañía	compania	noun	Duolingo
compañías	companias	noun	Duolingo
compartían	compartian	verb	Duolingo
compartías	compartias	verb	Duolingo
compartiré	compartire	verb	Duolingo
compartiremos	compartiremos	verb	Duolingo
competencia	competencia	noun	Duolingo
competencias	competencias	noun	Duolingo
competir	competir	verb	Duolingo
competiría	competiria	verb	Duolingo
competirían	competirian	verb	Duolingo
completamente	completamente	adverb	Duolingo
completando	completando	verb	Duolingo
completaste	completaste	verb	Duolingo
comportamiento	comportamiento	noun	Duolingo
compra	compra	noun	Duolingo
compra	compra	verb	Duolingo
compraba	compraba	verb	Duolingo
comprábamos	comprabamos	verb	Duolingo
compraban	compraban	verb	Duolingo
compramos	compramos	verb	Duolingo
compran	compran		Duolingo
compran	compran	verb	Duolingo
comprándoles	comprandoles	pronoun	Duolingo
comprar	comprar		Duolingo
comprar	comprar	verb	Duolingo
comprarlas	comprarlas	pronoun	Duolingo
comprarlos	comprarlos	pronoun	Duolingo
compraron	compraron	verb	Duolingo
compraste	compraste	verb	Duolingo
compré	compre	verb	Duolingo
compren	compren	verb	Duolingo
comprendemos	comprendemos	verb	Duolingo
comprender	comprender	verb	Duolingo
comprendes	comprendes	verb	Duolingo
comprendí	comprendi	verb	Duolingo
comprendieron	comprendieron	verb	Duolingo
comprendimos	comprendimos	verb	Duolingo
comprendiste	comprendiste	verb	Duolingo
comprendo	comprendo		Duolingo
compres	compres	verb	Duolingo
compró	compro	verb	Duolingo
comprobar	comprobar	verb	Duolingo
compromiso	compromiso	noun	Duolingo
computadora	computadora		Duolingo
computadora	computadora	noun	Duolingo
computadoras	computadoras	noun	Duolingo
común	comun	adjective	Duolingo
comunes	comunes	adjective	Duolingo
comunicación	comunicacion	noun	Duolingo
comunicaciones	comunicaciones	noun	Duolingo
comunidad	comunidad	noun	Duolingo
comunidades	comunidades	noun	Duolingo
con	con		Duolingo
con	con	preposition	Duolingo
con calma	con calma		Duolingo
con gas	con gas		Duolingo
con llave	con llave		Duolingo
con nadie	con nadie		Duolingo
con qué	con que		Duolingo
con tiempo	con tiempo		Duolingo
concejo municipal	concejo municipal		Duolingo
concentración	concentracion	noun	Duolingo
concepto	concepto	noun	Duolingo
conceptos	conceptos	noun	Duolingo
conciencia	conciencia	noun	Duolingo
concierto	concierto	noun	Duolingo
conciertos	conciertos	noun	Duolingo
conclusión	conclusion	noun	Duolingo
conclusiones	conclusiones	noun	Duolingo
concreto	concreto	noun	Duolingo
concurso	concurso	noun	Duolingo
condición	condicion	noun	Duolingo
condiciones	condiciones	noun	Duolingo
conducir	conducir	verb	Duolingo
conducta	conducta	noun	Duolingo
conductor	conductor	noun	Duolingo
conductora	conductora	noun	Duolingo
conduje	conduje	verb	Duolingo
conduzco	conduzco	verb	Duolingo
conectamos	conectamos	verb	Duolingo
conejo	conejo	noun	Duolingo
conejos	conejos	noun	Duolingo
conexión	conexion	noun	Duolingo
conferencia	conferencia	noun	Duolingo
conflicto	conflicto	noun	Duolingo
conflictos	conflictos	noun	Duolingo
confortable	confortable	adjective	Duolingo
confortables	confortables	adjective	Duolingo
confusión	confusion	noun	Duolingo
congreso	congreso	noun	Duolingo
conmigo	conmigo	preposition	Duolingo
conoce	conoce	verb	Duolingo
conocemos	conocemos	verb	Duolingo
conocer	conocer	verb	Duolingo
conoces	conoces	verb	Duolingo
conocí	conoci	verb	Duolingo
conocía	conocia	verb	Duolingo
conocíamos	conociamos	verb	Duolingo
conocida	conocida	verb	Duolingo
conocido	conocido	verb	Duolingo
conocidos	conocidos	verb	Duolingo
conocieron	conocieron	verb	Duolingo
conocimiento	conocimiento	noun	Duolingo
conocimientos	conocimientos	noun	Duolingo
conocimos	conocimos	verb	Duolingo
conoció	conocio	verb	Duolingo
conociste	conociste	verb	Duolingo
conozco	conozco	verb	Duolingo
consciente	consciente	adjective	Duolingo
consecuencia	consecuencia	noun	Duolingo
consecuencias	consecuencias	noun	Duolingo
conseguí	consegui	verb	Duolingo
conseguir	conseguir	verb	Duolingo
consejo	consejo	noun	Duolingo
consejos	consejos	noun	Duolingo
considera	considera	verb	Duolingo
consideran	consideran	verb	Duolingo
considerar	considerar	verb	Duolingo
consideró	considero	verb	Duolingo
consiguió	consiguio	verb	Duolingo
construcción	construccion	noun	Duolingo
construimos	construimos	verb	Duolingo
construir	construir	verb	Duolingo
construirá	construira	verb	Duolingo
construiré	construire	verb	Duolingo
construye	construye	verb	Duolingo
consulto	consulto	verb	Duolingo
contabilidad	contabilidad	noun	Duolingo
contactaron	contactaron	verb	Duolingo
contacté	contacte	verb	Duolingo
contacto	contacto	noun	Duolingo
contactos	contactos	noun	Duolingo
contamos	contamos	verb	Duolingo
contar	contar	verb	Duolingo
conté	conte	verb	Duolingo
contenido	contenido	noun	Duolingo
contenta	contenta	adjective	Duolingo
contestaste	contestaste	verb	Duolingo
contesté	conteste	verb	Duolingo
contestó	contesto	verb	Duolingo
contiene	contiene	verb	Duolingo
contigo	contigo	pronoun	Duolingo
continente	continente	noun	Duolingo
continúa	continua	verb	Duolingo
continuación	continuacion	noun	Duolingo
continúan	continuan	verb	Duolingo
continuar	continuar	verb	Duolingo
continúo	continuo	verb	Duolingo
contó	conto	verb	Duolingo
contra	contra	adverb	Duolingo
contra	contra	preposition	Duolingo
contrato	contrato	noun	Duolingo
contratos	contratos	noun	Duolingo
control	control	noun	Duolingo
controlar	controlar	verb	Duolingo
conveniente	conveniente	adjective	Duolingo
conversaban	conversaban	verb	Duolingo
conversación	conversacion	noun	Duolingo
conversaciones	conversaciones	noun	Duolingo
conversar	conversar	verb	Duolingo
conversarán	conversaran	verb	Duolingo
conversarás	conversaras	verb	Duolingo
conversaremos	conversaremos	verb	Duolingo
conversaron	conversaron	verb	Duolingo
converso	converso	verb	Duolingo
copa	copa	noun	Duolingo
copas	copas	noun	Duolingo
copias	copias	noun	Duolingo
copiaste	copiaste	verb	Duolingo
corazón	corazon	noun	Duolingo
corbata	corbata	noun	Duolingo
coronel	coronel	noun	Duolingo
corre	corre	verb	Duolingo
correctamente	correctamente	adverb	Duolingo
corredor	corredor	noun	Duolingo
corredora	corredora	noun	Duolingo
corredores	corredores	noun	Duolingo
corregirlas	corregirlas		Duolingo
corremos	corremos	verb	Duolingo
corren	corren	verb	Duolingo
correo	correo	noun	Duolingo
correo electrónico	correo electronico		Duolingo
correos electrónicos	correos electronicos		Duolingo
correr	correr	verb	Duolingo
corres	corres	verb	Duolingo
corrí	corri	verb	Duolingo
corríamos	corriamos	verb	Duolingo
corriendo	corriendo	verb	Duolingo
corriente	corriente	noun	Duolingo
corrientes	corrientes	noun	Duolingo
corrigen	corrigen	verb	Duolingo
corriges	corriges	verb	Duolingo
corrigiendo	corrigiendo	verb	Duolingo
corrijo	corrijo	verb	Duolingo
corrimos	corrimos	verb	Duolingo
corrió	corrio	verb	Duolingo
corriste	corriste	verb	Duolingo
corro	corro	verb	Duolingo
corrupción	corrupcion	noun	Duolingo
corta	corta	adjective	Duolingo
corta	corta	verb	Duolingo
cortan	cortan	verb	Duolingo
cortaré	cortare	verb	Duolingo
corte	corte	verb	Duolingo
corto	corto	adjective	Duolingo
corto	corto	verb	Duolingo
cosa	cosa	noun	Duolingo
cosas	cosas	noun	Duolingo
costa	costa	noun	Duolingo
costo	costo	noun	Duolingo
costó	costo	verb	Duolingo
costumbre	costumbre	noun	Duolingo
costumbres	costumbres	noun	Duolingo
crea	crea	verb	Duolingo
creación	creacion	noun	Duolingo
creaciones	creaciones	noun	Duolingo
creamos	creamos	verb	Duolingo
crear	crear	verb	Duolingo
creas	creas	verb	Duolingo
creativa	creativa	noun	Duolingo
creatividad	creatividad	noun	Duolingo
creativo	creativo	noun	Duolingo
crecieron	crecieron	verb	Duolingo
crecimiento	crecimiento	noun	Duolingo
crédito	credito	noun	Duolingo
créditos	creditos	noun	Duolingo
creé	cree	verb	Duolingo
creen	creen	verb	Duolingo
creer	creer	verb	Duolingo
creía	creia	verb	Duolingo
creíamos	creiamos	verb	Duolingo
creías	creias	verb	Duolingo
crema	crema	noun	Duolingo
creó	creo	verb	Duolingo
creo que	creo que		Duolingo
creo que debería	creo que deberia		Duolingo
creo que deberías	creo que deberias		Duolingo
crisis	crisis	noun	Duolingo
crucé	cruce	verb	Duolingo
cruz	cruz	noun	Duolingo
cruzaron	cruzaron	verb	Duolingo
cuaderno	cuaderno	noun	Duolingo
cuadernos	cuadernos	noun	Duolingo
cuadra	cuadra	noun	Duolingo
cuadrada	cuadrada	adjective	Duolingo
cuadradas	cuadradas	adjective	Duolingo
cuadrados	cuadrados	adjective	Duolingo
cuadras	cuadras	noun	Duolingo
cuadros	cuadros	noun	Duolingo
cuál	cual	pronoun	Duolingo
cuáles	cuales	pronoun	Duolingo
cuáles quiere	cuales quiere		Duolingo
cualquier	cualquier	adjective	Duolingo
cualquier	cualquier	determiner	Duolingo
cualquier lugar	cualquier lugar		Duolingo
cualquiera	cualquiera	pronoun	Duolingo
cuándo	cuando	adverb	Duolingo
cuando	cuando	conjunction	Duolingo
cuánta	cuanta	determiner	Duolingo
cuántas	cuantas	adjective	Duolingo
cuántas	cuantas	determiner	Duolingo
cuánto	cuanto	determiner	Duolingo
cuánto	cuanto	pronoun	Duolingo
cuanto antes	cuanto antes		Duolingo
cuánto hace que	cuanto hace que		Duolingo
cuantos	cuantos	determiner	Duolingo
cuántos	cuantos	pronoun	Duolingo
cuántos años	cuantos anos		Duolingo
cuarenta	cuarenta	numeral	Duolingo
cuarto	cuarto	noun	Duolingo
cuartos	cuartos	noun	Duolingo
cuatro	cuatro	numeral	Duolingo
cuatrocientos	cuatrocientos	numeral	Duolingo
cuba	cuba	proper noun	Duolingo
cubana	cubana	adjective	Duolingo
cubanas	cubanas	adjective	Duolingo
cubano	cubano	adjective	Duolingo
cubre	cubre	verb	Duolingo
cubrió	cubrio	verb	Duolingo
cubrir	cubrir	verb	Duolingo
cuchara	cuchara	noun	Duolingo
cucharas	cucharas	noun	Duolingo
cuchillo	cuchillo	noun	Duolingo
cuchillos	cuchillos	noun	Duolingo
cuello	cuello	noun	Duolingo
cuenta	cuenta		Duolingo
cuenta	cuenta	noun	Duolingo
cuenta	cuenta	verb	Duolingo
cuentan	cuentan	verb	Duolingo
cuentas	cuentas	noun	Duolingo
cuentas	cuentas	verb	Duolingo
cuento	cuento	verb	Duolingo
cuentos	cuentos	noun	Duolingo
cuero	cuero	noun	Duolingo
cuerpo	cuerpo	noun	Duolingo
cuerpos	cuerpos	noun	Duolingo
cuesta	cuesta	verb	Duolingo
cuestan	cuestan	verb	Duolingo
cuidaba	cuidaba	verb	Duolingo
cuidábamos	cuidabamos	verb	Duolingo
cuidaban	cuidaban	verb	Duolingo
cuidabas	cuidabas	verb	Duolingo
cuidan	cuidan	verb	Duolingo
cuidar	cuidar	verb	Duolingo
cuidas	cuidas	verb	Duolingo
culpa	culpa	verb	Duolingo
cultura	cultura	noun	Duolingo
culturas	culturas	noun	Duolingo
cumbre	cumbre	noun	Duolingo
cumbres	cumbres	noun	Duolingo
cumpleaños	cumpleanos	noun	Duolingo
cuna	cuna	noun	Duolingo
cura	cura	verb	Duolingo
curiosa	curiosa	adjective	Duolingo
curiosidad	curiosidad	noun	Duolingo
curiosos	curiosos	adjective	Duolingo
currículum	curriculum	noun	Duolingo
curso	curso	noun	Duolingo
cursos	cursos	noun	Duolingo
da	da	verb	Duolingo
daba	daba	verb	Duolingo
dame	dame		Duolingo
dámelas	damelas		Duolingo
dámelos	damelos		Duolingo
damos	damos	verb	Duolingo
dan	dan	verb	Duolingo
daña	dana	verb	Duolingo
dañar	danar	verb	Duolingo
dando	dando	verb	Duolingo
daño	dano	noun	Duolingo
dañó	dano	verb	Duolingo
daños	danos	noun	Duolingo
danza	danza	noun	Duolingo
dar	dar	verb	Duolingo
darás	daras	verb	Duolingo
darle	darle	pronoun	Duolingo
darme	darme	pronoun	Duolingo
darte	darte	pronoun	Duolingo
das	das	verb	Duolingo
dáselo	daselo		Duolingo
datos	datos	noun	Duolingo
de	de		Duolingo
de	de	preposition	Duolingo
de acuerdo	de acuerdo		Duolingo
de al lado	de al lado		Duolingo
de alto	de alto		Duolingo
de ancho	de ancho		Duolingo
de casualidad	de casualidad		Duolingo
de compras	de compras		Duolingo
de hecho	de hecho		Duolingo
de ida	de ida		Duolingo
de ida y vuelta	de ida y vuelta		Duolingo
de inmediato	de inmediato		Duolingo
de largo	de largo		Duolingo
de lo que	de lo que		Duolingo
de madera	de madera		Duolingo
de más	de mas		Duolingo
de memoria	de memoria		Duolingo
de moda	de moda		Duolingo
de nada	de nada		Duolingo
de nada	de nada	interjection	Duolingo
de niña	de nina		Duolingo
de ninguna manera	de ninguna manera		Duolingo
de niño	de nino		Duolingo
de nuevo	de nuevo		Duolingo
de otra manera	de otra manera		Duolingo
de pie	de pie		Duolingo
de regalo	de regalo		Duolingo
de repente	de repente		Duolingo
de segunda mano	de segunda mano		Duolingo
de talla única	de talla unica		Duolingo
de terror	de terror		Duolingo
de tiempo parcial	de tiempo parcial		Duolingo
de toda la vida	de toda la vida		Duolingo
de todas formas	de todas formas		Duolingo
de todas maneras	de todas maneras		Duolingo
de vacaciones	de vacaciones		Duolingo
de verdad	de verdad		Duolingo
de vez en cuando	de vez en cuando		Duolingo
debajo	debajo	adverb	Duolingo
debajo	debajo	preposition	Duolingo
debe	debe	verb	Duolingo
debe haber	debe haber		Duolingo
debe haber sido	debe haber sido		Duolingo
debemos	debemos	verb	Duolingo
deben	deben	verb	Duolingo
deberá	debera	verb	Duolingo
deberás	deberas	verb	Duolingo
deberemos	deberemos	verb	Duolingo
debería	deberia	verb	Duolingo
deberías	deberias	verb	Duolingo
debía	debia	verb	Duolingo
débil	debil	adjective	Duolingo
debió	debio	verb	Duolingo
debo	debo	verb	Duolingo
decía	decia	verb	Duolingo
decías	decias	verb	Duolingo
decidan	decidan	verb	Duolingo
deciden	deciden		Duolingo
decidí	decidi	verb	Duolingo
decidió	decidio	verb	Duolingo
decidir	decidir	verb	Duolingo
decimos	decimos	verb	Duolingo
decir	decir	verb	Duolingo
decirles	decirles	pronoun	Duolingo
decirme	decirme	pronoun	Duolingo
decirnos	decirnos	pronoun	Duolingo
decisión	decision	noun	Duolingo
decisiones	decisiones	noun	Duolingo
declaraciones	declaraciones	noun	Duolingo
decoración	decoracion	noun	Duolingo
dedicada	dedicada	verb	Duolingo
dedicado	dedicado	verb	Duolingo
dedo	dedo	noun	Duolingo
dedos	dedos	noun	Duolingo
defender	defender	verb	Duolingo
defensa	defensa	noun	Duolingo
definición	definicion	noun	Duolingo
definir	definir	verb	Duolingo
definitivamente	definitivamente	adverb	Duolingo
deja	deja	verb	Duolingo
dejaba	dejaba	verb	Duolingo
dejan	dejan	verb	Duolingo
dejando	dejando	verb	Duolingo
dejar	dejar	verb	Duolingo
dejaron	dejaron	verb	Duolingo
dejé	deje	verb	Duolingo
dejó	dejo	verb	Duolingo
del	del	preposition	Duolingo
delgados	delgados	adjective	Duolingo
deliciosa	deliciosa	adjective	Duolingo
delicioso	delicioso	adjective	Duolingo
demás	demas	noun	Duolingo
demasiado	demasiado		Duolingo
demasiado	demasiado	adjective	Duolingo
demasiado	demasiado	adverb	Duolingo
demasiados	demasiados	adjective	Duolingo
democracia	democracia	noun	Duolingo
demócrata	democrata	adjective	Duolingo
demócratas	democratas	adjective	Duolingo
democrática	democratica	adjective	Duolingo
democrático	democratico	adjective	Duolingo
demostrar	demostrar	verb	Duolingo
dentro	dentro	adverb	Duolingo
departamento	departamento	noun	Duolingo
depende	depende	verb	Duolingo
deporte	deporte	noun	Duolingo
deportes	deportes	noun	Duolingo
depresión	depresion	noun	Duolingo
depresiones	depresiones	noun	Duolingo
derecha	derecha	noun	Duolingo
derecho	derecho	adverb	Duolingo
derecho	derecho	noun	Duolingo
derechos	derechos	noun	Duolingo
derrota	derrota	verb	Duolingo
derrotan	derrotan	verb	Duolingo
des	des	verb	Duolingo
desafortunadamente	desafortunadamente	adverb	Duolingo
desarrollar	desarrollar	verb	Duolingo
desayunábamos	desayunabamos	verb	Duolingo
desayunaban	desayunaban	verb	Duolingo
desayunar	desayunar	verb	Duolingo
desayuno	desayuno	noun	Duolingo
desayunó	desayuno	verb	Duolingo
descansaba	descansaba	verb	Duolingo
descansaban	descansaban	verb	Duolingo
descansar	descansar	verb	Duolingo
descansaré	descansare	verb	Duolingo
descansaremos	descansaremos	verb	Duolingo
descansaron	descansaron	verb	Duolingo
descansas	descansas	verb	Duolingo
descanse	descanse	verb	Duolingo
descanso	descanso	verb	Duolingo
descargamos	descargamos	verb	Duolingo
descargaste	descargaste	verb	Duolingo
descargué	descargue	verb	Duolingo
descenso	descenso	noun	Duolingo
descripción	descripcion	noun	Duolingo
descripciones	descripciones	noun	Duolingo
descubrimiento	descubrimiento	noun	Duolingo
descubrimientos	descubrimientos	noun	Duolingo
descubrir	descubrir	verb	Duolingo
descuento	descuento	noun	Duolingo
desde	desde	adverb	Duolingo
desde	desde	preposition	Duolingo
desde ahora	desde ahora		Duolingo
desde cuándo	desde cuando		Duolingo
desde hace	desde hace		Duolingo
desde que	desde que		Duolingo
desea	desea	verb	Duolingo
desean	desean	verb	Duolingo
déselo	deselo		Duolingo
desempleo	desempleo	noun	Duolingo
deseo	deseo	noun	Duolingo
deseo	deseo	verb	Duolingo
deseos	deseos	noun	Duolingo
desgraciadamente	desgraciadamente	adverb	Duolingo
desocupación	desocupacion	noun	Duolingo
desorden	desorden	noun	Duolingo
despacio	despacio	adverb	Duolingo
despertador	despertador	noun	Duolingo
despertar	despertar	verb	Duolingo
despertarme	despertarme	pronoun	Duolingo
despertarnos	despertarnos	pronoun	Duolingo
despertarte	despertarte	pronoun	Duolingo
despiertas	despiertas	verb	Duolingo
después	despues	adverb	Duolingo
después	despues	preposition	Duolingo
después de que	despues de que		Duolingo
después de todo	despues de todo		Duolingo
destino	destino	noun	Duolingo
destrucción	destruccion	noun	Duolingo
destruimos	destruimos	verb	Duolingo
destruir	destruir	verb	Duolingo
destruirán	destruiran	verb	Duolingo
destruye	destruye	verb	Duolingo
destruyen	destruyen	verb	Duolingo
detalle	detalle	noun	Duolingo
detalles	detalles	noun	Duolingo
detenido	detenido	verb	Duolingo
detenidos	detenidos	verb	Duolingo
detrás	detras	preposition	Duolingo
deuda	deuda	noun	Duolingo
devolvemos	devolvemos	verb	Duolingo
devolver	devolver	verb	Duolingo
devuelven	devuelven	verb	Duolingo
devuelves	devuelves	verb	Duolingo
devuelvo	devuelvo	verb	Duolingo
di	di	verb	Duolingo
día	dia	noun	Duolingo
día de acción de gracias	dia de accion de gracias		Duolingo
día de los muertos	dia de los muertos		Duolingo
diálogo	dialogo	noun	Duolingo
diaria	diaria	adjective	Duolingo
diario	diario	adjective	Duolingo
diario	diario	noun	Duolingo
diarios	diarios	noun	Duolingo
días	dias	noun	Duolingo
dibujábamos	dibujabamos	verb	Duolingo
dibujabas	dibujabas	verb	Duolingo
dibujamos	dibujamos	verb	Duolingo
dibujando	dibujando	verb	Duolingo
dibujar	dibujar	verb	Duolingo
dibujaron	dibujaron	verb	Duolingo
dibujaste	dibujaste	verb	Duolingo
dibujé	dibuje	verb	Duolingo
dibujos	dibujos	noun	Duolingo
dibujos animados	dibujos animados		Duolingo
dice	dice	verb	Duolingo
dicen	dicen	verb	Duolingo
dices	dices	verb	Duolingo
dicho sea de paso	dicho sea de paso		Duolingo
diciembre	diciembre	noun	Duolingo
diciendo	diciendo	verb	Duolingo
dictadura	dictadura	noun	Duolingo
dictaduras	dictaduras	noun	Duolingo
diecinueve	diecinueve	numeral	Duolingo
dieciocho	dieciocho	numeral	Duolingo
dieciséis	dieciseis	numeral	Duolingo
diecisiete	diecisiete	numeral	Duolingo
dientes	dientes	noun	Duolingo
dieron	dieron	verb	Duolingo
dieta	dieta	noun	Duolingo
diez	diez	numeral	Duolingo
diferencia	diferencia	noun	Duolingo
diferencias	diferencias	noun	Duolingo
diferente	diferente		Duolingo
diferente	diferente	adjective	Duolingo
diferentes	diferentes	adjective	Duolingo
difícil	dificil		Duolingo
difícil	dificil	adjective	Duolingo
difíciles	dificiles	adjective	Duolingo
dificilísimo	dificilisimo	adjective	Duolingo
dificultades	dificultades	noun	Duolingo
diga	diga	verb	Duolingo
dígame	digame		Duolingo
dígamelo	digamelo		Duolingo
digas	digas		Duolingo
digas	digas	verb	Duolingo
dígaselo	digaselo		Duolingo
digitales	digitales	adjective	Duolingo
digo	digo	verb	Duolingo
dije	dije	verb	Duolingo
dijeron	dijeron	verb	Duolingo
dijimos	dijimos	verb	Duolingo
dijiste	dijiste	verb	Duolingo
dijo	dijo	verb	Duolingo
dime	dime	verb	Duolingo
dímelo	dimelo		Duolingo
dimensiones	dimensiones	noun	Duolingo
dimos	dimos	verb	Duolingo
dinero	dinero		Duolingo
dinero	dinero	noun	Duolingo
dinosaurio	dinosaurio	noun	Duolingo
dinosaurios	dinosaurios	noun	Duolingo
dio	dio	verb	Duolingo
dios	dios	noun	Duolingo
dioses	dioses	noun	Duolingo
dirán	diran	verb	Duolingo
dirección	direccion	noun	Duolingo
direcciones	direcciones	noun	Duolingo
diría	diria	verb	Duolingo
dirías	dirias	verb	Duolingo
disciplina	disciplina	noun	Duolingo
disco	disco	noun	Duolingo
discos	discos	noun	Duolingo
disculpa	disculpa	verb	Duolingo
disculpe	disculpe	verb	Duolingo
disculpe, señor	disculpe, senor		Duolingo
discurso	discurso	noun	Duolingo
discusión	discusion	noun	Duolingo
díselo	diselo		Duolingo
diseña	disena	verb	Duolingo
disfruta	disfruta	verb	Duolingo
disfrutaba	disfrutaba	verb	Duolingo
disfrutábamos	disfrutabamos	verb	Duolingo
disfrutamos	disfrutamos	verb	Duolingo
disfrutando	disfrutando	verb	Duolingo
disfrutar	disfrutar	verb	Duolingo
disfrutaron	disfrutaron	verb	Duolingo
disfrutas	disfrutas	verb	Duolingo
disfrutaste	disfrutaste	verb	Duolingo
disfruté	disfrute	verb	Duolingo
disfrutó	disfruto	verb	Duolingo
disminución	disminucion	noun	Duolingo
disponible	disponible	adjective	Duolingo
disponibles	disponibles	adjective	Duolingo
distancia	distancia	noun	Duolingo
diste	diste	verb	Duolingo
distintas	distintas	adjective	Duolingo
distintos	distintos	adjective	Duolingo
distribución	distribucion	noun	Duolingo
distribuciones	distribuciones	noun	Duolingo
divertida	divertida	adjective	Duolingo
divertidas	divertidas	adjective	Duolingo
divertidísima	divertidisima	adjective	Duolingo
divertidísimo	divertidisimo	adjective	Duolingo
divertido	divertido	adjective	Duolingo
divertidos	divertidos	adjective	Duolingo
división	division	noun	Duolingo
divorcio	divorcio	noun	Duolingo
doblamos	doblamos	verb	Duolingo
doblar	doblar	verb	Duolingo
doblas	doblas	verb	Duolingo
doble	doble	adjective	Duolingo
doble	doble	noun	Duolingo
doce	doce	numeral	Duolingo
docente	docente	noun	Duolingo
docentes	docentes	noun	Duolingo
doctor	doctor	noun	Duolingo
doctora	doctora	noun	Duolingo
doctores	doctores	noun	Duolingo
documento	documento	noun	Duolingo
documentos	documentos	noun	Duolingo
dólar	dolar	noun	Duolingo
dólares	dolares	noun	Duolingo
doler	doler	verb	Duolingo
dolor	dolor	noun	Duolingo
domingo	domingo	noun	Duolingo
domingos	domingos	noun	Duolingo
dónde	donde		Duolingo
dónde	donde	adverb	Duolingo
dorada	dorada	adjective	Duolingo
dorado	dorado	adjective	Duolingo
dormíamos	dormiamos	verb	Duolingo
dormías	dormias	verb	Duolingo
dormida	dormida	adjective	Duolingo
dormido	dormido	adjective	Duolingo
dormimos	dormimos	verb	Duolingo
dormir	dormir		Duolingo
dormir	dormir	verb	Duolingo
dormiste	dormiste	verb	Duolingo
dormitorio	dormitorio	noun	Duolingo
dormitorios	dormitorios	noun	Duolingo
dos	dos		Duolingo
dos	dos	numeral	Duolingo
doscientos	doscientos	numeral	Duolingo
dosis	dosis	noun	Duolingo
doy	doy	verb	Duolingo
dr.	dr.	noun	Duolingo
duda	duda	verb	Duolingo
dudas	dudas	verb	Duolingo
dudo	dudo	verb	Duolingo
duele	duele	verb	Duolingo
duelen	duelen	verb	Duolingo
dueña	duena	noun	Duolingo
dueño	dueno	noun	Duolingo
duerme	duerme	verb	Duolingo
duermen	duermen	verb	Duolingo
duermes	duermes	verb	Duolingo
duermo	duermo	verb	Duolingo
dulce	dulce	adjective	Duolingo
dulces	dulces	adjective	Duolingo
dulces	dulces	noun	Duolingo
dúplex	duplex	noun	Duolingo
dura	dura	adjective	Duolingo
durante	durante	preposition	Duolingo
durmiendo	durmiendo	verb	Duolingo
durmieron	durmieron	verb	Duolingo
durmió	durmio	verb	Duolingo
duro	duro	adjective	Duolingo
e	e	conjunction	Duolingo
ecología	ecologia	noun	Duolingo
economía	economia	noun	Duolingo
económica	economica	adjective	Duolingo
económico	economico	adjective	Duolingo
económicos	economicos	adjective	Duolingo
edad	edad	noun	Duolingo
edición	edicion	noun	Duolingo
edificio	edificio	noun	Duolingo
edificios	edificios	noun	Duolingo
editorial	editorial	noun	Duolingo
educación	educacion	noun	Duolingo
efectivo	efectivo	noun	Duolingo
efecto	efecto	noun	Duolingo
eficaz	eficaz	adjective	Duolingo
ejecutivo	ejecutivo	noun	Duolingo
ejemplo	ejemplo	noun	Duolingo
ejemplos	ejemplos	noun	Duolingo
ejercicio	ejercicio	noun	Duolingo
ejercicios	ejercicios	noun	Duolingo
ejército	ejercito	noun	Duolingo
el	el	determiner	Duolingo
él	el	pronoun	Duolingo
el ajedrez	el ajedrez		Duolingo
el azul	el azul		Duolingo
el baloncesto	el baloncesto		Duolingo
el café	el cafe		Duolingo
el ciclismo	el ciclismo		Duolingo
el español	el espanol		Duolingo
el fútbol	el futbol		Duolingo
el inglés	el ingles		Duolingo
el más	el mas		Duolingo
el mejor	el mejor		Duolingo
el mío	el mio		Duolingo
el otro día	el otro dia		Duolingo
el peor	el peor		Duolingo
el rojo	el rojo		Duolingo
él se	el se		Duolingo
el uno al otro	el uno al otro		Duolingo
elección	eleccion	noun	Duolingo
elecciones	elecciones	noun	Duolingo
electoral	electoral	adjective	Duolingo
eléctrica	electrica	adjective	Duolingo
eléctricas	electricas	adjective	Duolingo
electricidad	electricidad	noun	Duolingo
eléctrico	electrico	adjective	Duolingo
elefante	elefante	noun	Duolingo
elefantes	elefantes	noun	Duolingo
elegante	elegante		Duolingo
elegantes	elegantes	adjective	Duolingo
elegimos	elegimos	verb	Duolingo
elegir	elegir	verb	Duolingo
elemento	elemento	noun	Duolingo
elementos	elementos	noun	Duolingo
elevado	elevado	adjective	Duolingo
eligen	eligen	verb	Duolingo
eliges	eliges	verb	Duolingo
eligiendo	eligiendo	verb	Duolingo
elijo	elijo	verb	Duolingo
eliminar	eliminar	verb	Duolingo
ella	ella	pronoun	Duolingo
ella come	ella come		Duolingo
ellas	ellas	pronoun	Duolingo
ellas escriben	ellas escriben		Duolingo
ellas se	ellas se		Duolingo
ellos	ellos	pronoun	Duolingo
ellos hablan	ellos hablan		Duolingo
ellos leen	ellos leen		Duolingo
ellos se	ellos se		Duolingo
embajada	embajada	noun	Duolingo
embajador	embajador	noun	Duolingo
embajadora	embajadora	noun	Duolingo
embajadores	embajadores	noun	Duolingo
emergencia	emergencia	noun	Duolingo
emoción	emocion	noun	Duolingo
emocionada	emocionada	verb	Duolingo
emocionado	emocionado	verb	Duolingo
emocionados	emocionados	adjective	Duolingo
emocionante	emocionante	adjective	Duolingo
emociones	emociones	noun	Duolingo
empaqué	empaque	verb	Duolingo
emparedado	emparedado	noun	Duolingo
emparedados	emparedados	noun	Duolingo
empecé	empece	verb	Duolingo
empezamos	empezamos	verb	Duolingo
empezamos a	empezamos a		Duolingo
empezar	empezar	verb	Duolingo
empezaron	empezaron	verb	Duolingo
empezó	empezo	verb	Duolingo
empieza	empieza	verb	Duolingo
empiezan	empiezan	verb	Duolingo
empiezas	empiezas	verb	Duolingo
empiezo	empiezo	verb	Duolingo
empleada	empleada	noun	Duolingo
empleado	empleado	noun	Duolingo
empleados	empleados	noun	Duolingo
empresa	empresa	noun	Duolingo
empresaria	empresaria	noun	Duolingo
empresario	empresario	noun	Duolingo
empresarios	empresarios	noun	Duolingo
empuje	empuje	verb	Duolingo
en	en		Duolingo
en	en	preposition	Duolingo
en alquiler	en alquiler		Duolingo
en común	en comun		Duolingo
en concreto	en concreto		Duolingo
en contacto	en contacto		Duolingo
en contra de	en contra de		Duolingo
en cualquier caso	en cualquier caso		Duolingo
en cualquier momento	en cualquier momento		Duolingo
en cuanto	en cuanto		Duolingo
en cuanto a	en cuanto a		Duolingo
en definitiva	en definitiva		Duolingo
en efectivo	en efectivo		Duolingo
en el	en el		Duolingo
en este momento	en este momento		Duolingo
en estos tiempos	en estos tiempos		Duolingo
en familia	en familia		Duolingo
en forma	en forma		Duolingo
en general	en general		Duolingo
en general	en general	adverb	Duolingo
en línea	en linea		Duolingo
en mi vida	en mi vida		Duolingo
en ninguna parte	en ninguna parte		Duolingo
en oferta	en oferta		Duolingo
en primer lugar	en primer lugar		Duolingo
en punto	en punto		Duolingo
en realidad	en realidad		Duolingo
en regla	en regla		Duolingo
en secreto	en secreto		Duolingo
en segundo lugar	en segundo lugar		Duolingo
en serio	en serio		Duolingo
en su lugar	en su lugar		Duolingo
en todas partes	en todas partes		Duolingo
en total	en total		Duolingo
en vez de	en vez de		Duolingo
en vivo	en vivo		Duolingo
en voz baja	en voz baja		Duolingo
encantaba	encantaba	verb	Duolingo
encantaban	encantaban	verb	Duolingo
encantada	encantada	adjective	Duolingo
encantadas	encantadas	adjective	Duolingo
encantado	encantado	adjective	Duolingo
encantados	encantados	adjective	Duolingo
encantan	encantan	verb	Duolingo
encantar	encantar	verb	Duolingo
encantaría	encantaria	verb	Duolingo
encantarían	encantarian	verb	Duolingo
encantaron	encantaron	verb	Duolingo
encantó	encanto	verb	Duolingo
encendemos	encendemos	verb	Duolingo
encender	encender	verb	Duolingo
encendía	encendia	verb	Duolingo
encendían	encendian	verb	Duolingo
encendías	encendias	verb	Duolingo
encendidas	encendidas	adjective	Duolingo
encendido	encendido	adjective	Duolingo
encendidos	encendidos	adjective	Duolingo
encendieron	encendieron	verb	Duolingo
encendiste	encendiste	verb	Duolingo
encima	encima	adverb	Duolingo
encontraba	encontraba	verb	Duolingo
encontramos	encontramos	verb	Duolingo
encontrar	encontrar	verb	Duolingo
encontraron	encontraron	verb	Duolingo
encontrarse	encontrarse	pronoun	Duolingo
encontraste	encontraste	verb	Duolingo
encontré	encontre	verb	Duolingo
encontró	encontro	verb	Duolingo
encuentra	encuentra	verb	Duolingo
encuentran	encuentran	verb	Duolingo
encuentras	encuentras	verb	Duolingo
encuentro	encuentro	verb	Duolingo
enemiga	enemiga	noun	Duolingo
enemigo	enemigo	noun	Duolingo
enemigos	enemigos	noun	Duolingo
energía	energia	noun	Duolingo
enero	enero	noun	Duolingo
enferma	enferma	adjective	Duolingo
enfermedad	enfermedad	noun	Duolingo
enfermera	enfermera	noun	Duolingo
enfermeras	enfermeras	adjective	Duolingo
enfermero	enfermero	noun	Duolingo
enfermeros	enfermeros	adjective	Duolingo
enfermeros	enfermeros	noun	Duolingo
enfermo	enfermo	adjective	Duolingo
enfermos	enfermos	adjective	Duolingo
enfrente	enfrente	adverb	Duolingo
enojada	enojada	adjective	Duolingo
enojadas	enojadas	adjective	Duolingo
enojado	enojado	adjective	Duolingo
enojados	enojados	adjective	Duolingo
enorme	enorme	adjective	Duolingo
enormes	enormes	adjective	Duolingo
ensalada	ensalada		Duolingo
ensalada	ensalada	noun	Duolingo
ensaladas	ensaladas	noun	Duolingo
enseguida	enseguida	adverb	Duolingo
enseña a	ensena a		Duolingo
enséñame	ensename		Duolingo
enseñamos	ensenamos	verb	Duolingo
enseñando	ensenando	verb	Duolingo
enseñándoles	ensenandoles	pronoun	Duolingo
enseñar	ensenar	verb	Duolingo
enseñaron	ensenaron	verb	Duolingo
enseñaste	ensenaste	verb	Duolingo
entendemos	entendemos	verb	Duolingo
entender	entender	verb	Duolingo
entendimos	entendimos	verb	Duolingo
entera	entera	adjective	Duolingo
enteramos	enteramos	verb	Duolingo
enteraron	enteraron	verb	Duolingo
enteró	entero	verb	Duolingo
entiende	entiende	verb	Duolingo
entienden	entienden	verb	Duolingo
entiendes	entiendes	verb	Duolingo
entiendo	entiendo	verb	Duolingo
entonces	entonces	adverb	Duolingo
entra	entra	verb	Duolingo
entrábamos	entrabamos	verb	Duolingo
entrada	entrada	noun	Duolingo
entradas	entradas	noun	Duolingo
entrar	entrar	verb	Duolingo
entras	entras	verb	Duolingo
entre	entre	preposition	Duolingo
entre	entre	verb	Duolingo
entrega	entrega	verb	Duolingo
entregas	entregas	verb	Duolingo
entrevista	entrevista	noun	Duolingo
entró	entro	verb	Duolingo
enviándole	enviandole	pronoun	Duolingo
enviar	enviar	verb	Duolingo
envías	envias	verb	Duolingo
envíe	envie	verb	Duolingo
envío	envio	verb	Duolingo
equilibrio	equilibrio	noun	Duolingo
equipaje	equipaje	noun	Duolingo
equipo	equipo	noun	Duolingo
equipos	equipos	noun	Duolingo
era	era	verb	Duolingo
era necesario que	era necesario que		Duolingo
éramos	eramos	verb	Duolingo
eran	eran	verb	Duolingo
eras	eras	verb	Duolingo
eres	eres	verb	Duolingo
error	error	noun	Duolingo
errores	errores	noun	Duolingo
es	es	verb	Duolingo
es bueno que	es bueno que		Duolingo
es decir	es decir		Duolingo
es divertido	es divertido		Duolingo
es estresante que	es estresante que		Duolingo
es fantástico que	es fantastico que		Duolingo
es grande	es grande		Duolingo
es hora de	es hora de		Duolingo
es importante que	es importante que		Duolingo
es mejor	es mejor		Duolingo
es mejor que	es mejor que		Duolingo
es muy simpático	es muy simpatico		Duolingo
es necesario que	es necesario que		Duolingo
es posible que	es posible que		Duolingo
es preferible que	es preferible que		Duolingo
es probable que	es probable que		Duolingo
es que	es que		Duolingo
es segura	es segura		Duolingo
es seguro	es seguro		Duolingo
es tan	es tan		Duolingo
es una lástima que	es una lastima que		Duolingo
es una pena que	es una pena que		Duolingo
es urgente que	es urgente que		Duolingo
es verde	es verde		Duolingo
esa	esa	determiner	Duolingo
esa	esa	pronoun	Duolingo
esas	esas	determiner	Duolingo
esas	esas	pronoun	Duolingo
escalar	escalar	verb	Duolingo
escalaremos	escalaremos	verb	Duolingo
escalaste	escalaste	verb	Duolingo
escalera	escalera	noun	Duolingo
escaleras	escaleras	noun	Duolingo
escándalo	escandalo	noun	Duolingo
escapen	escapen	verb	Duolingo
escapó	escapo	verb	Duolingo
escasa	escasa	adjective	Duolingo
escena	escena	noun	Duolingo
escenario	escenario	noun	Duolingo
escenas	escenas	noun	Duolingo
escoger	escoger	verb	Duolingo
escogerás	escogeras	verb	Duolingo
escojo	escojo	verb	Duolingo
escriba	escriba	verb	Duolingo
escribas	escribas	verb	Duolingo
escribe	escribe	verb	Duolingo
escriben	escriben	verb	Duolingo
escribes	escribes		Duolingo
escribes	escribes	verb	Duolingo
escribí	escribi	verb	Duolingo
escribía	escribia	verb	Duolingo
escribíamos	escribiamos	verb	Duolingo
escribiendo	escribiendo	verb	Duolingo
escribieron	escribieron	verb	Duolingo
escribimos	escribimos	verb	Duolingo
escribió	escribio	verb	Duolingo
escribir	escribir		Duolingo
escribir	escribir	verb	Duolingo
escribirán	escribiran	verb	Duolingo
escribiremos	escribiremos	verb	Duolingo
escribiría	escribiria	verb	Duolingo
escribiste	escribiste	verb	Duolingo
escribo	escribo		Duolingo
escribo	escribo	verb	Duolingo
escrito	escrito	verb	Duolingo
escritorio	escritorio	noun	Duolingo
escritorios	escritorios	noun	Duolingo
escuchaba	escuchaba	verb	Duolingo
escuchábamos	escuchabamos	verb	Duolingo
escuchabas	escuchabas	verb	Duolingo
escuchamos	escuchamos	verb	Duolingo
escuchando	escuchando	verb	Duolingo
escuchar	escuchar	verb	Duolingo
escuche	escuche	verb	Duolingo
escuela	escuela		Duolingo
escuela	escuela	noun	Duolingo
escuela primaria	escuela primaria		Duolingo
escuela secundaria	escuela secundaria		Duolingo
escuelas	escuelas	noun	Duolingo
ese	ese		Duolingo
ese	ese	determiner	Duolingo
ese	ese	pronoun	Duolingo
esfuerzo	esfuerzo	noun	Duolingo
esfuerzos	esfuerzos	noun	Duolingo
eso	eso	pronoun	Duolingo
esos	esos	determiner	Duolingo
esos	esos	pronoun	Duolingo
espacio	espacio	noun	Duolingo
espacios	espacios	noun	Duolingo
espalda	espalda	noun	Duolingo
espaldas	espaldas	noun	Duolingo
españa	espana	proper noun	Duolingo
español	espanol	adjective	Duolingo
español	espanol	noun	Duolingo
española	espanola	noun	Duolingo
españolas	espanolas	adjective	Duolingo
españoles	espanoles	adjective	Duolingo
especial	especial	adjective	Duolingo
especial del día	especial del dia		Duolingo
especiales	especiales	adjective	Duolingo
especialidad	especialidad	noun	Duolingo
especialista	especialista	noun	Duolingo
especialistas	especialistas	noun	Duolingo
especialmente	especialmente	adverb	Duolingo
especie	especie	noun	Duolingo
especies	especies	noun	Duolingo
espectacular	espectacular	adjective	Duolingo
espectaculares	espectaculares	adjective	Duolingo
espectáculo	espectaculo	noun	Duolingo
espejo	espejo	noun	Duolingo
espera	espera		Duolingo
espera	espera	verb	Duolingo
esperaba	esperaba	verb	Duolingo
esperabas	esperabas	verb	Duolingo
esperamos	esperamos	verb	Duolingo
esperando	esperando	verb	Duolingo
esperanza	esperanza	noun	Duolingo
esperar	esperar	verb	Duolingo
esperaron	esperaron	verb	Duolingo
espere	espere	verb	Duolingo
espero	espero	verb	Duolingo
espíritu	espiritu	noun	Duolingo
espíritus	espiritus	noun	Duolingo
esponja	esponja	noun	Duolingo
esposa	esposa		Duolingo
esposa	esposa	noun	Duolingo
esposas	esposas	noun	Duolingo
esposo	esposo		Duolingo
esposo	esposo	noun	Duolingo
esquiábamos	esquiabamos	verb	Duolingo
esquiaban	esquiaban	verb	Duolingo
esquiamos	esquiamos	verb	Duolingo
esquiar	esquiar	verb	Duolingo
esquías	esquias	verb	Duolingo
esquina	esquina	noun	Duolingo
esquío	esquio	verb	Duolingo
está	esta		Duolingo
esta	esta	determiner	Duolingo
ésta	esta	pronoun	Duolingo
está	esta	verb	Duolingo
está bien	esta bien		Duolingo
está listo	esta listo		Duolingo
está rico	esta rico		Duolingo
estaba	estaba	verb	Duolingo
estábamos	estabamos	verb	Duolingo
estaban	estaban	verb	Duolingo
estabas	estabas	verb	Duolingo
estabilidad	estabilidad	noun	Duolingo
establecer	establecer	verb	Duolingo
estación	estacion	noun	Duolingo
estacionaste	estacionaste	verb	Duolingo
estacione	estacione	verb	Duolingo
estaciones	estaciones	noun	Duolingo
estadio	estadio	noun	Duolingo
estados unidos	estados unidos		Duolingo
Estados Unidos	estados unidos	proper noun	Duolingo
estadounidense	estadounidense	adjective	Duolingo
estáis	estais	verb	Duolingo
estamos	estamos	verb	Duolingo
estampilla	estampilla	noun	Duolingo
estampillas	estampillas	noun	Duolingo
están	estan	verb	Duolingo
están listas	estan listas		Duolingo
están ricos	estan ricos		Duolingo
están seguros	estan seguros		Duolingo
estante	estante	noun	Duolingo
estantería	estanteria	noun	Duolingo
estantes	estantes	noun	Duolingo
estar	estar	verb	Duolingo
estar de acuerdo	estar de acuerdo		Duolingo
estará	estara	verb	Duolingo
estarán	estaran	verb	Duolingo
estarás	estaras	verb	Duolingo
estaré	estare	verb	Duolingo
estaremos	estaremos	verb	Duolingo
estaría	estaria	verb	Duolingo
estaríamos	estariamos	verb	Duolingo
estarían	estarian	verb	Duolingo
estarías	estarias	verb	Duolingo
estas	estas	determiner	Duolingo
estas	estas	pronoun	Duolingo
estás	estas	verb	Duolingo
estás lista	estas lista		Duolingo
estás segura	estas segura		Duolingo
este	este		Duolingo
este	este	determiner	Duolingo
este	este	noun	Duolingo
este	este	pronoun	Duolingo
estilo	estilo	noun	Duolingo
esto	esto	pronoun	Duolingo
estómago	estomago	noun	Duolingo
estómagos	estomagos	noun	Duolingo
estos	estos	determiner	Duolingo
éstos	estos	pronoun	Duolingo
estoy	estoy	verb	Duolingo
estoy lista	estoy lista		Duolingo
estoy listo	estoy listo		Duolingo
estoy seguro	estoy seguro		Duolingo
estrella	estrella	noun	Duolingo
estrellas	estrellas	noun	Duolingo
estrés	estres	noun	Duolingo
estuche	estuche	noun	Duolingo
estudia	estudia	verb	Duolingo
estudiaba	estudiaba	verb	Duolingo
estudiaban	estudiaban	verb	Duolingo
estudiabas	estudiabas	verb	Duolingo
estudiamos	estudiamos	verb	Duolingo
estudian	estudian	verb	Duolingo
estudiando	estudiando	verb	Duolingo
estudiante	estudiante		Duolingo
estudiante	estudiante	noun	Duolingo
estudiantes	estudiantes	noun	Duolingo
estudiar	estudiar		Duolingo
estudiar	estudiar	verb	Duolingo
estudiarás	estudiaras	verb	Duolingo
estudiaré	estudiare	verb	Duolingo
estudias	estudias		Duolingo
estudias	estudias	verb	Duolingo
estudias en	estudias en		Duolingo
estudiaste	estudiaste	verb	Duolingo
estudié	estudie	verb	Duolingo
estudies	estudies	verb	Duolingo
estudio	estudio		Duolingo
estudio	estudio	noun	Duolingo
estudio	estudio	verb	Duolingo
estudios	estudios	noun	Duolingo
estudioso	estudioso	adjective	Duolingo
estudiosos	estudiosos	adjective	Duolingo
estufas	estufas	noun	Duolingo
estupenda	estupenda	adjective	Duolingo
estupendos	estupendos	adjective	Duolingo
estuve	estuve	verb	Duolingo
estuvieron	estuvieron	verb	Duolingo
estuvimos	estuvimos	verb	Duolingo
estuviste	estuviste	verb	Duolingo
estuvo	estuvo	verb	Duolingo
etcétera	etcetera	noun	Duolingo
europa	europa	proper noun	Duolingo
europea	europea	adjective	Duolingo
europeas	europeas	adjective	Duolingo
europeo	europeo	adjective	Duolingo
europeos	europeos	adjective	Duolingo
evidencia	evidencia	noun	Duolingo
evidentemente	evidentemente	adverb	Duolingo
evitar	evitar	verb	Duolingo
evolución	evolucion	noun	Duolingo
ex	ex	noun	Duolingo
exactamente	exactamente	adverb	Duolingo
examen	examen		Duolingo
excelente	excelente	adjective	Duolingo
excelentes	excelentes	adjective	Duolingo
excepción	excepcion	noun	Duolingo
excepto	excepto	preposition	Duolingo
excursión	excursion	noun	Duolingo
excusa	excusa	noun	Duolingo
excusas	excusas	noun	Duolingo
existir	existir	verb	Duolingo
éxito	exito	noun	Duolingo
experiencia	experiencia	noun	Duolingo
experiencias	experiencias	noun	Duolingo
expertas	expertas	noun	Duolingo
experto	experto	noun	Duolingo
explica	explica	verb	Duolingo
explicación	explicacion	noun	Duolingo
explícame	explicame		Duolingo
explicar	explicar	verb	Duolingo
explicaron	explicaron	verb	Duolingo
explicó	explico	verb	Duolingo
expliqué	explique	verb	Duolingo
expresa	expresa	verb	Duolingo
expresión	expresion	noun	Duolingo
expreso	expreso	verb	Duolingo
exterior	exterior	noun	Duolingo
extra	extra	adjective	Duolingo
extraña	extrana	adjective	Duolingo
extranjero	extranjero	noun	Duolingo
extranjeros	extranjeros	adjective	Duolingo
extraño	extrano	adjective	Duolingo
fábrica	fabrica	noun	Duolingo
fábricas	fabricas	noun	Duolingo
fácil	facil		Duolingo
fáciles	faciles	adjective	Duolingo
fácilmente	facilmente	adverb	Duolingo
factor	factor	noun	Duolingo
factores	factores	noun	Duolingo
facultad	facultad	noun	Duolingo
falda	falda		Duolingo
falda	falda	noun	Duolingo
faldas	faldas	noun	Duolingo
falta	falta	noun	Duolingo
fama	fama	noun	Duolingo
familia	familia		Duolingo
familia	familia	noun	Duolingo
familiar	familiar	adjective	Duolingo
familias	familias	noun	Duolingo
famosa	famosa	adjective	Duolingo
famoso	famoso	adjective	Duolingo
fantástico	fantastico	adjective	Duolingo
farmacias	farmacias	noun	Duolingo
fatal	fatal	adjective	Duolingo
favorita	favorita		Duolingo
favorita	favorita	adjective	Duolingo
favoritas	favoritas	adjective	Duolingo
favorito	favorito	adjective	Duolingo
favoritos	favoritos	adjective	Duolingo
fe	fe	noun	Duolingo
feas	feas	adjective	Duolingo
febrero	febrero	noun	Duolingo
fecha	fecha	noun	Duolingo
fechas	fechas	noun	Duolingo
federación	federacion	noun	Duolingo
felices	felices	adjective	Duolingo
felicidad	felicidad	noun	Duolingo
felicidades	felicidades	interjection	Duolingo
felicidades	felicidades	noun	Duolingo
felicitaciones	felicitaciones	interjection	Duolingo
feliz	feliz	adjective	Duolingo
felizmente	felizmente	adverb	Duolingo
femenina	femenina	adjective	Duolingo
femenino	femenino	adjective	Duolingo
fenómeno	fenomeno	noun	Duolingo
feo	feo	adjective	Duolingo
feria	feria	noun	Duolingo
ferrocarril	ferrocarril	noun	Duolingo
festival	festival	noun	Duolingo
festivales	festivales	noun	Duolingo
fibra	fibra	noun	Duolingo
fiesta	fiesta	noun	Duolingo
fiestas	fiestas	noun	Duolingo
figura	figura	noun	Duolingo
fila	fila	noun	Duolingo
filosofía	filosofia	noun	Duolingo
filosofías	filosofias	noun	Duolingo
fin	fin	noun	Duolingo
fin de semana	fin de semana		Duolingo
final	final	adjective	Duolingo
final	final	noun	Duolingo
finales	finales	adjective	Duolingo
finalmente	finalmente	adverb	Duolingo
fines de semana	fines de semana		Duolingo
firma	firma	verb	Duolingo
firmamos	firmamos	verb	Duolingo
firman	firman	verb	Duolingo
firmarán	firmaran	verb	Duolingo
firmaremos	firmaremos	verb	Duolingo
firmas	firmas	verb	Duolingo
firme	firme	verb	Duolingo
firmen	firmen	verb	Duolingo
firmo	firmo	verb	Duolingo
física	fisica	noun	Duolingo
flauta	flauta	noun	Duolingo
flor	flor	noun	Duolingo
floreros	floreros	noun	Duolingo
flores	flores	noun	Duolingo
forma	forma	noun	Duolingo
forma de ser	forma de ser		Duolingo
formal	formal	adjective	Duolingo
formar	formar	verb	Duolingo
formas	formas	noun	Duolingo
fórmula	formula	noun	Duolingo
formulario	formulario	noun	Duolingo
foro	foro	noun	Duolingo
fortuna	fortuna	noun	Duolingo
foto	foto	noun	Duolingo
fotógrafa	fotografa	noun	Duolingo
fotógrafas	fotografas	noun	Duolingo
fotografía	fotografia	noun	Duolingo
fotografías	fotografias	noun	Duolingo
fotógrafo	fotografo	noun	Duolingo
fotos	fotos	noun	Duolingo
frágiles	fragiles	adjective	Duolingo
francés	frances	adjective	Duolingo
francés	frances	noun	Duolingo
francesa	francesa	adjective	Duolingo
franceses	franceses	adjective	Duolingo
francia	francia	proper noun	Duolingo
frase	frase	noun	Duolingo
frases	frases	noun	Duolingo
frecuencia	frecuencia	noun	Duolingo
frecuentemente	frecuentemente	adverb	Duolingo
fregadero	fregadero	noun	Duolingo
freír	freir	verb	Duolingo
frente	frente	noun	Duolingo
fresa	fresa	noun	Duolingo
fresas	fresas	noun	Duolingo
fresca	fresca	adjective	Duolingo
frescos	frescos	adjective	Duolingo
frío	frio	noun	Duolingo
frita	frita	adjective	Duolingo
frontera	frontera	noun	Duolingo
fruta	fruta	noun	Duolingo
frutería	fruteria	noun	Duolingo
fue	fue	verb	Duolingo
fue desarrollado	fue desarrollado		Duolingo
fue un	fue un		Duolingo
fuego	fuego	noun	Duolingo
fuegos artificiales	fuegos artificiales		Duolingo
fuente	fuente	noun	Duolingo
fuentes	fuentes	noun	Duolingo
fuera	fuera	adverb	Duolingo
fuera	fuera	verb	Duolingo
fuéramos	fueramos	verb	Duolingo
fueras	fueras	verb	Duolingo
fueron	fueron	verb	Duolingo
fueron invitados	fueron invitados		Duolingo
fueron unos	fueron unos		Duolingo
fuerte	fuerte	adjective	Duolingo
fuerte	fuerte	adverb	Duolingo
fuertes	fuertes	adjective	Duolingo
fuerza	fuerza	noun	Duolingo
fui	fui	verb	Duolingo
fuimos	fuimos	verb	Duolingo
fuiste	fuiste	verb	Duolingo
fumaba	fumaba	verb	Duolingo
fumar	fumar	verb	Duolingo
función	funcion	noun	Duolingo
funcionan	funcionan	verb	Duolingo
funcionar	funcionar	verb	Duolingo
funciones	funciones	noun	Duolingo
fútbol	futbol	noun	Duolingo
fútbol americano	futbol americano		Duolingo
gabinetes	gabinetes	noun	Duolingo
gafas	gafas	noun	Duolingo
gafas de sol	gafas de sol		Duolingo
galería	galeria	noun	Duolingo
gana	gana	verb	Duolingo
ganaba	ganaba	verb	Duolingo
ganaban	ganaban	verb	Duolingo
ganador	ganador	noun	Duolingo
ganadora	ganadora	noun	Duolingo
ganar	ganar	verb	Duolingo
ganas	ganas	noun	Duolingo
ganas	ganas	verb	Duolingo
ganaste	ganaste	verb	Duolingo
ganó	gano	verb	Duolingo
garaje	garaje	noun	Duolingo
gas	gas	noun	Duolingo
gasolina	gasolina	noun	Duolingo
gastar	gastar	verb	Duolingo
gastaste	gastaste	verb	Duolingo
gastó	gasto	verb	Duolingo
gata	gata	noun	Duolingo
gatas	gatas	noun	Duolingo
gato	gato		Duolingo
gato	gato	noun	Duolingo
gatos	gatos	noun	Duolingo
gemelo	gemelo	adjective	Duolingo
generalmente	generalmente	adverb	Duolingo
genial	genial	interjection	Duolingo
gente	gente	noun	Duolingo
geografía	geografia	noun	Duolingo
gerentes	gerentes	noun	Duolingo
gesto	gesto	noun	Duolingo
gestos	gestos	noun	Duolingo
gimnasios	gimnasios	noun	Duolingo
gira	gira	verb	Duolingo
girar	girar	verb	Duolingo
giras	giras	verb	Duolingo
gire	gire	verb	Duolingo
globos	globos	noun	Duolingo
gobernador	gobernador	noun	Duolingo
gobierno	gobierno	noun	Duolingo
gobiernos	gobiernos	noun	Duolingo
gol	gol	noun	Duolingo
goles	goles	noun	Duolingo
golf	golf	noun	Duolingo
golpeas	golpeas	verb	Duolingo
gorra	gorra	noun	Duolingo
gps	gps	noun	Duolingo
grabando	grabando	verb	Duolingo
grabo	grabo	verb	Duolingo
gracias	gracias	interjection	Duolingo
gracias por	gracias por		Duolingo
graciosa	graciosa	adjective	Duolingo
graciosas	graciosas	adjective	Duolingo
gracioso	gracioso	adjective	Duolingo
grado	grado	noun	Duolingo
grados	grados	noun	Duolingo
graduada	graduada	adjective	Duolingo
graduado	graduado	adjective	Duolingo
graduados	graduados	adjective	Duolingo
gramática	gramatica	noun	Duolingo
gramos	gramos	noun	Duolingo
gran	gran	adjective	Duolingo
grande	grande		Duolingo
grande	grande	adjective	Duolingo
grandes	grandes	adjective	Duolingo
grandísimo	grandisimo	adjective	Duolingo
granjera	granjera	noun	Duolingo
granjero	granjero	noun	Duolingo
gratis	gratis	adjective	Duolingo
grave	grave	adjective	Duolingo
gravemente	gravemente	adverb	Duolingo
graves	graves	adjective	Duolingo
gris	gris		Duolingo
gris	gris	adjective	Duolingo
grises	grises	adjective	Duolingo
gritando	gritando	verb	Duolingo
grites	grites	verb	Duolingo
grito	grito	noun	Duolingo
gritos	gritos	noun	Duolingo
grupo	grupo	noun	Duolingo
grupos	grupos	noun	Duolingo
guarda	guarda	noun	Duolingo
guardar	guardar	verb	Duolingo
guardas	guardas	noun	Duolingo
guardaste	guardaste	verb	Duolingo
guardia	guardia	noun	Duolingo
guardias	guardias	noun	Duolingo
guardó	guardo	verb	Duolingo
guau	guau		Duolingo
guerra	guerra	noun	Duolingo
guía	guia	noun	Duolingo
gusta	gusta	verb	Duolingo
gustaba	gustaba	verb	Duolingo
gustaban	gustaban	verb	Duolingo
gustamos	gustamos	verb	Duolingo
gustan	gustan	verb	Duolingo
gustar	gustar	verb	Duolingo
gustaría	gustaria	verb	Duolingo
gustarían	gustarian		Duolingo
gustaron	gustaron	verb	Duolingo
gusto	gusto	noun	Duolingo
gustó	gusto	verb	Duolingo
habér	haber	verb	Duolingo
había	habia		Duolingo
había	habia	verb	Duolingo
había una vez	habia una vez		Duolingo
habías	habias	verb	Duolingo
habitación	habitacion	noun	Duolingo
habitaciones	habitaciones	noun	Duolingo
habla	habla	verb	Duolingo
hablaba	hablaba	verb	Duolingo
hablabas	hablabas	verb	Duolingo
hablamos	hablamos	verb	Duolingo
hablan	hablan	verb	Duolingo
hablando	hablando	verb	Duolingo
hablando de	hablando de		Duolingo
hablar	hablar	verb	Duolingo
hablar con	hablar con		Duolingo
hablar de	hablar de		Duolingo
hablar español	hablar espanol		Duolingo
hablaré	hablare	verb	Duolingo
hablaron	hablaron	verb	Duolingo
hablas	hablas	verb	Duolingo
hablas con	hablas con		Duolingo
hablaste	hablaste	verb	Duolingo
hable	hable	verb	Duolingo
hables	hables	verb	Duolingo
habló	hablo	verb	Duolingo
habrá	habra	verb	Duolingo
habrá ido	habra ido		Duolingo
habrá sido	habra sido		Duolingo
habría	habria	verb	Duolingo
hace	hace		Duolingo
hace	hace	verb	Duolingo
hace calor	hace calor		Duolingo
hace frío	hace frio		Duolingo
hace mucho tiempo	hace mucho tiempo		Duolingo
hace un rato	hace un rato		Duolingo
hacemos	hacemos	verb	Duolingo
hacen	hacen		Duolingo
hacen	hacen	verb	Duolingo
hacer	hacer	verb	Duolingo
hacer la cama	hacer la cama		Duolingo
haces	haces	verb	Duolingo
hacia	hacia	adverb	Duolingo
hacia	hacia	preposition	Duolingo
hacía	hacia	verb	Duolingo
hacia atrás	hacia atras		Duolingo
hacíamos	haciamos	verb	Duolingo
hacían	hacian	verb	Duolingo
hacías	hacias	verb	Duolingo
hacienda	hacienda	noun	Duolingo
haciendo	haciendo	verb	Duolingo
haga	haga	verb	Duolingo
hagan	hagan	verb	Duolingo
hagas	hagas	verb	Duolingo
hago	hago	verb	Duolingo
hala	hala	verb	Duolingo
halar	halar	verb	Duolingo
hambre	hambre	noun	Duolingo
hamburguesa	hamburguesa		Duolingo
hará	hara	verb	Duolingo
harán	haran	verb	Duolingo
harás	haras	verb	Duolingo
haré	hare	verb	Duolingo
haremos	haremos	verb	Duolingo
haría	haria	verb	Duolingo
haríamos	hariamos	verb	Duolingo
harían	harian	verb	Duolingo
harías	harias	verb	Duolingo
hasta	hasta	preposition	Duolingo
hasta ahora	hasta ahora		Duolingo
hasta dónde	hasta donde		Duolingo
hasta luego	hasta luego		Duolingo
hasta mañana	hasta manana		Duolingo
hasta pronto	hasta pronto		Duolingo
hasta que	hasta que		Duolingo
hay	hay	verb	Duolingo
hay algún	hay algun		Duolingo
hay alguna	hay alguna		Duolingo
hay que	hay que		Duolingo
haya	haya	verb	Duolingo
haz	haz	verb	Duolingo
hecho	hecho	verb	Duolingo
hechos	hechos	verb	Duolingo
helicóptero	helicoptero	noun	Duolingo
herido	herido	verb	Duolingo
heridos	heridos	verb	Duolingo
hermana	hermana		Duolingo
hermana	hermana	noun	Duolingo
hermanas	hermanas	noun	Duolingo
hermano	hermano		Duolingo
hermano	hermano	noun	Duolingo
hermanos	hermanos	noun	Duolingo
hermosísimas	hermosisimas	adjective	Duolingo
hermosísimo	hermosisimo	adjective	Duolingo
hice	hice	verb	Duolingo
hiciera	hiciera	verb	Duolingo
hicieras	hicieras	verb	Duolingo
hicieron	hicieron	verb	Duolingo
hicimos	hicimos	verb	Duolingo
hiciste	hiciste	verb	Duolingo
hielo	hielo	noun	Duolingo
hielos	hielos	noun	Duolingo
hija	hija		Duolingo
hija	hija	noun	Duolingo
hijas	hijas	noun	Duolingo
hijo	hijo		Duolingo
hijo	hijo	noun	Duolingo
hijos	hijos	noun	Duolingo
hip-hop	hip-hop		Duolingo
hirviendo	hirviendo	verb	Duolingo
hispanohablante	hispanohablante	adjective	Duolingo
historia	historia	noun	Duolingo
historia del arte	historia del arte		Duolingo
historias	historias	noun	Duolingo
histórica	historica	adjective	Duolingo
histórico	historico	adjective	Duolingo
hizo	hizo	verb	Duolingo
hobbies	hobbies	noun	Duolingo
hobby	hobby	noun	Duolingo
hockey	hockey	noun	Duolingo
hogar	hogar	noun	Duolingo
hoja	hoja	noun	Duolingo
hojas	hojas	noun	Duolingo
hola	hola	interjection	Duolingo
hombre	hombre	noun	Duolingo
hombres	hombres	noun	Duolingo
hombro	hombro	noun	Duolingo
hombros	hombros	noun	Duolingo
honor	honor	noun	Duolingo
hora	hora	noun	Duolingo
horario	horario	noun	Duolingo
horario de visita	horario de visita		Duolingo
horas	horas	noun	Duolingo
horno	horno	noun	Duolingo
horrible	horrible	adjective	Duolingo
hospital	hospital		Duolingo
hospital	hospital	noun	Duolingo
hotel	hotel		Duolingo
hotel	hotel	noun	Duolingo
hoy	hoy	adverb	Duolingo
hoy en día	hoy en dia		Duolingo
hubiera	hubiera	verb	Duolingo
hubieran	hubieran	verb	Duolingo
hubo	hubo	verb	Duolingo
hueso	hueso	noun	Duolingo
huesos	huesos	noun	Duolingo
huevo	huevo	noun	Duolingo
huevos revueltos	huevos revueltos		Duolingo
humanidad	humanidad	noun	Duolingo
humedad	humedad	noun	Duolingo
humo	humo	noun	Duolingo
humor	humor	noun	Duolingo
iba	iba	verb	Duolingo
íbamos	ibamos	verb	Duolingo
iban	iban	verb	Duolingo
ibas	ibas	verb	Duolingo
idea	idea	noun	Duolingo
ideal	ideal	adjective	Duolingo
identidad	identidad	noun	Duolingo
identidades	identidades	noun	Duolingo
identificación	identificacion	noun	Duolingo
iglesia	iglesia	noun	Duolingo
iglesias	iglesias	noun	Duolingo
igual	igual	adjective	Duolingo
igual de	igual de		Duolingo
igual que	igual que		Duolingo
iguales	iguales	adjective	Duolingo
igualmente	igualmente	adverb	Duolingo
ilegal	ilegal	adjective	Duolingo
ilegales	ilegales	adjective	Duolingo
imagen	imagen	noun	Duolingo
imágenes	imagenes	noun	Duolingo
imaginación	imaginacion	noun	Duolingo
imaginan	imaginan	verb	Duolingo
imaginar	imaginar	verb	Duolingo
imaginas	imaginas	verb	Duolingo
impacto	impacto	noun	Duolingo
impedir	impedir	verb	Duolingo
impermeable	impermeable	adjective	Duolingo
importa	importa	verb	Duolingo
importamos	importamos	verb	Duolingo
importan	importan	verb	Duolingo
importancia	importancia	noun	Duolingo
importante	importante		Duolingo
importante	importante	adjective	Duolingo
importantes	importantes	adjective	Duolingo
importará	importara	verb	Duolingo
importaría	importaria	verb	Duolingo
importo	importo	verb	Duolingo
imposible	imposible	adjective	Duolingo
impresora	impresora	noun	Duolingo
impuesto	impuesto	noun	Duolingo
impuestos	impuestos	noun	Duolingo
impuntualidad	impuntualidad	noun	Duolingo
incluimos	incluimos	verb	Duolingo
incluir	incluir	verb	Duolingo
incluso	incluso	adjective	Duolingo
incluye	incluye	verb	Duolingo
incluyen	incluyen	verb	Duolingo
incluyendo	incluyendo	verb	Duolingo
incluyes	incluyes	verb	Duolingo
incluyo	incluyo	verb	Duolingo
incorrecta	incorrecta	adjective	Duolingo
independiente	independiente	adjective	Duolingo
independientes	independientes	adjective	Duolingo
indicaciones	indicaciones	noun	Duolingo
individual	individual	adjective	Duolingo
individuo	individuo	noun	Duolingo
individuos	individuos	noun	Duolingo
industria	industria	noun	Duolingo
industrial	industrial	adjective	Duolingo
inesperadamente	inesperadamente	adverb	Duolingo
infancia	infancia	noun	Duolingo
inferior	inferior	adjective	Duolingo
inferiores	inferiores	adjective	Duolingo
inflación	inflacion	noun	Duolingo
influencia	influencia	noun	Duolingo
información	informacion	noun	Duolingo
informaciones	informaciones	noun	Duolingo
informática	informatica	noun	Duolingo
ingeniera	ingeniera	noun	Duolingo
ingeniero	ingeniero	noun	Duolingo
ingenieros	ingenieros	noun	Duolingo
inglaterra	inglaterra	proper noun	Duolingo
inglés	ingles	adjective	Duolingo
inglés	ingles	noun	Duolingo
inglesa	inglesa	adjective	Duolingo
inglesa	inglesa	noun	Duolingo
inglesas	inglesas	adjective	Duolingo
ingleses	ingleses	adjective	Duolingo
ingresos	ingresos	noun	Duolingo
iniciar	iniciar	verb	Duolingo
iniciaron	iniciaron	verb	Duolingo
inicié	inicie	verb	Duolingo
inició	inicio	verb	Duolingo
inmediatamente	inmediatamente	adverb	Duolingo
inmediato	inmediato	adjective	Duolingo
inmigración	inmigracion	noun	Duolingo
insistió	insistio	verb	Duolingo
instalación	instalacion	noun	Duolingo
instalaciones	instalaciones	noun	Duolingo
instalaron	instalaron	verb	Duolingo
instalé	instale	verb	Duolingo
institución	institucion	noun	Duolingo
instituciones	instituciones	noun	Duolingo
instituto	instituto	noun	Duolingo
instructoras	instructoras	noun	Duolingo
instrumento	instrumento	noun	Duolingo
instrumentos	instrumentos	noun	Duolingo
intelectual	intelectual	adjective	Duolingo
intelectuales	intelectuales	adjective	Duolingo
inteligencia	inteligencia	noun	Duolingo
inteligente	inteligente		Duolingo
inteligente	inteligente	adjective	Duolingo
inteligentes	inteligentes	adjective	Duolingo
intención	intencion	noun	Duolingo
intensidad	intensidad	noun	Duolingo
intenta	intenta	verb	Duolingo
intentábamos	intentabamos	verb	Duolingo
intentaban	intentaban	verb	Duolingo
intentar	intentar	verb	Duolingo
intentaste	intentaste	verb	Duolingo
intentó	intento	verb	Duolingo
interés	interes	noun	Duolingo
interesa	interesa	verb	Duolingo
interesa jugar	interesa jugar		Duolingo
interesaba	interesaba	verb	Duolingo
interesados	interesados	adjective	Duolingo
interesan	interesan	verb	Duolingo
interesante	interesante		Duolingo
interesante	interesante	adjective	Duolingo
interesantes	interesantes	adjective	Duolingo
intereses	intereses	noun	Duolingo
internacional	internacional	adjective	Duolingo
internacionales	internacionales	adjective	Duolingo
internacionalmente	internacionalmente	adverb	Duolingo
internet	internet	noun	Duolingo
introducción	introduccion	noun	Duolingo
inusual	inusual	adjective	Duolingo
inversión	inversion	noun	Duolingo
inversiones	inversiones	noun	Duolingo
investigación	investigacion	noun	Duolingo
investigaciones	investigaciones	noun	Duolingo
invierno	invierno	noun	Duolingo
inviernos	inviernos	noun	Duolingo
invita	invita	verb	Duolingo
invitaciones	invitaciones	noun	Duolingo
invitada	invitada	noun	Duolingo
invitados	invitados	noun	Duolingo
invitan	invitan	verb	Duolingo
invitar	invitar	verb	Duolingo
invitaste	invitaste	verb	Duolingo
invitó	invito	verb	Duolingo
ir	ir	verb	Duolingo
irán	iran	verb	Duolingo
irte	irte	pronoun	Duolingo
isla	isla	noun	Duolingo
islas	islas	noun	Duolingo
italiana	italiana	adjective	Duolingo
italianas	italianas	adjective	Duolingo
italiano	italiano	adjective	Duolingo
italiano	italiano	noun	Duolingo
italianos	italianos	adjective	Duolingo
itinerario	itinerario	noun	Duolingo
izquierda	izquierda	adjective	Duolingo
izquierda	izquierda	noun	Duolingo
jabón	jabon	noun	Duolingo
jabones	jabones	noun	Duolingo
jalea	jalea	noun	Duolingo
jamás	jamas	adverb	Duolingo
jamón	jamon	noun	Duolingo
jamones	jamones	noun	Duolingo
janucá	januca	noun	Duolingo
jardín	jardin	noun	Duolingo
jardines	jardines	noun	Duolingo
jazz	jazz	noun	Duolingo
jefa	jefa	noun	Duolingo
jefe	jefe	noun	Duolingo
jefes	jefes	noun	Duolingo
joven	joven	adjective	Duolingo
jóvenes	jovenes	adjective	Duolingo
joyas	joyas	noun	Duolingo
jueces	jueces	noun	Duolingo
juega	juega	verb	Duolingo
juegan	juegan	verb	Duolingo
juegas	juegas	verb	Duolingo
juego	juego	noun	Duolingo
juego	juego	verb	Duolingo
juegos	juegos	noun	Duolingo
juegos de mesa	juegos de mesa		Duolingo
jueves	jueves	noun	Duolingo
juez	juez	noun	Duolingo
jugaba	jugaba	verb	Duolingo
jugábamos	jugabamos	verb	Duolingo
jugaban	jugaban	verb	Duolingo
jugabas	jugabas	verb	Duolingo
jugador	jugador	noun	Duolingo
jugadora	jugadora	noun	Duolingo
jugadoras	jugadoras	noun	Duolingo
jugadores	jugadores	noun	Duolingo
jugamos	jugamos	verb	Duolingo
jugar	jugar	verb	Duolingo
jugo	jugo		Duolingo
jugo	jugo	noun	Duolingo
jugos	jugos	noun	Duolingo
jugué	jugue	verb	Duolingo
juicio	juicio	noun	Duolingo
julio	julio	noun	Duolingo
junio	junio	noun	Duolingo
junta	junta	noun	Duolingo
junto	junto	adjective	Duolingo
juntos	juntos	adjective	Duolingo
justicia	justicia	noun	Duolingo
justo	justo	adjective	Duolingo
kilómetro	kilometro	noun	Duolingo
kilómetros	kilometros	noun	Duolingo
la	la	determiner	Duolingo
la	la	pronoun	Duolingo
la amarilla	la amarilla		Duolingo
la mano	la mano		Duolingo
la más	la mas		Duolingo
la mayoría de	la mayoria de		Duolingo
la mitad de	la mitad de		Duolingo
la parte de abajo	la parte de abajo		Duolingo
la quiero	la quiero		Duolingo
la tuya	la tuya		Duolingo
la verdad	la verdad		Duolingo
labios	labios	noun	Duolingo
laboratorio	laboratorio	noun	Duolingo
laboratorios	laboratorios	noun	Duolingo
lado	lado	noun	Duolingo
lados	lados	noun	Duolingo
lagos	lagos	noun	Duolingo
lágrimas	lagrimas	noun	Duolingo
lamento que	lamento que		Duolingo
lámpara	lampara	noun	Duolingo
lana	lana	noun	Duolingo
lancé	lance	verb	Duolingo
lanzas	lanzas	verb	Duolingo
larga	larga	adjective	Duolingo
largas	largas	adjective	Duolingo
largo	largo	adjective	Duolingo
largos	largos	adjective	Duolingo
las	las	determiner	Duolingo
las	las	pronoun	Duolingo
las afueras	las afueras		Duolingo
las afueras de la ciudad	las afueras de la ciudad		Duolingo
las comen	las comen		Duolingo
las frutas	las frutas		Duolingo
las necesita	las necesita		Duolingo
las nuestras	las nuestras		Duolingo
lástima	lastima	noun	Duolingo
latina	latina	adjective	Duolingo
latinos	latinos	adjective	Duolingo
lavaba	lavaba	verb	Duolingo
lavábamos	lavabamos	verb	Duolingo
lavadora	lavadora	noun	Duolingo
lavamanos	lavamanos	noun	Duolingo
lavan	lavan	verb	Duolingo
lavaplatos	lavaplatos	noun	Duolingo
lavar	lavar	verb	Duolingo
lavarla	lavarla	pronoun	Duolingo
lavarlas	lavarlas	pronoun	Duolingo
lavarlo	lavarlo		Duolingo
lavarme	lavarme	pronoun	Duolingo
lavarnos	lavarnos	pronoun	Duolingo
lavaron	lavaron	verb	Duolingo
lavarse	lavarse	pronoun	Duolingo
lavarte	lavarte	pronoun	Duolingo
lavaste	lavaste	verb	Duolingo
lávate	lavate	pronoun	Duolingo
lavavajillas	lavavajillas	noun	Duolingo
lávese	lavese	pronoun	Duolingo
lavó	lavo	verb	Duolingo
le	le	pronoun	Duolingo
le das	le das		Duolingo
le doy	le doy		Duolingo
le encanta	le encanta		Duolingo
le gusta	le gusta		Duolingo
le gustan	le gustan		Duolingo
le hago	le hago		Duolingo
le interesa	le interesa		Duolingo
lea	lea	verb	Duolingo
leas	leas	verb	Duolingo
lecciones	lecciones	noun	Duolingo
leche	leche	noun	Duolingo
lechuga	lechuga	noun	Duolingo
lectura	lectura	noun	Duolingo
lee	lee	verb	Duolingo
leéis	leeis	verb	Duolingo
leemos	leemos	verb	Duolingo
leen	leen	verb	Duolingo
leer	leer		Duolingo
leer	leer	verb	Duolingo
leer este	leer este		Duolingo
leerá	leera		Duolingo
leerán	leeran	verb	Duolingo
leerlo	leerlo		Duolingo
lees	lees		Duolingo
lees	lees	verb	Duolingo
legal	legal	adjective	Duolingo
legales	legales	adjective	Duolingo
legislación	legislacion	noun	Duolingo
leí	lei	verb	Duolingo
leía	leia	verb	Duolingo
leías	leias	verb	Duolingo
leímos	leimos	verb	Duolingo
leíste	leiste	verb	Duolingo
lejos	lejos	adverb	Duolingo
lengua	lengua	noun	Duolingo
lenguaje	lenguaje	noun	Duolingo
lenguas	lenguas	noun	Duolingo
lentamente	lentamente	adverb	Duolingo
lentejas	lentejas	noun	Duolingo
lentes	lentes	noun	Duolingo
lento	lento	adverb	Duolingo
leo	leo		Duolingo
leo	leo	verb	Duolingo
león	leon	noun	Duolingo
les	les	pronoun	Duolingo
les encanta	les encanta		Duolingo
les gusta	les gusta		Duolingo
les interesa	les interesa		Duolingo
letra	letra	noun	Duolingo
levanta	levanta	verb	Duolingo
levantan	levantan	verb	Duolingo
levantarme	levantarme	pronoun	Duolingo
levantarse	levantarse	pronoun	Duolingo
levantarte	levantarte	pronoun	Duolingo
levántate	levantate	pronoun	Duolingo
levántese	levantese	pronoun	Duolingo
ley	ley	noun	Duolingo
leyendo	leyendo	verb	Duolingo
leyeron	leyeron	verb	Duolingo
leyes	leyes	noun	Duolingo
leyó	leyo	verb	Duolingo
libertad	libertad	noun	Duolingo
libre	libre	adjective	Duolingo
libres	libres	adjective	Duolingo
libro	libro		Duolingo
libro	libro	noun	Duolingo
libro de texto	libro de texto		Duolingo
libros	libros	noun	Duolingo
libros de ejercicios	libros de ejercicios		Duolingo
licencia de conducir	licencia de conducir		Duolingo
liga	liga	noun	Duolingo
ligeras	ligeras	adjective	Duolingo
Lima	lima	proper noun	Duolingo
límite	limite	noun	Duolingo
límites	limites	noun	Duolingo
limón	limon	noun	Duolingo
limpia	limpia	adjective	Duolingo
limpia	limpia	verb	Duolingo
limpiaban	limpiaban	verb	Duolingo
limpiabas	limpiabas	verb	Duolingo
limpiador	limpiador	noun	Duolingo
limpiadora	limpiadora	noun	Duolingo
limpiadores	limpiadores	noun	Duolingo
límpialas	limpialas		Duolingo
limpiamos	limpiamos	verb	Duolingo
limpian	limpian	verb	Duolingo
limpiando	limpiando	verb	Duolingo
limpiar	limpiar	verb	Duolingo
limpiaron	limpiaron	verb	Duolingo
limpias	limpias	adjective	Duolingo
limpias	limpias	verb	Duolingo
limpiaste	limpiaste	verb	Duolingo
limpieza	limpieza	noun	Duolingo
limpio	limpio	adjective	Duolingo
limpió	limpio	verb	Duolingo
línea	linea	noun	Duolingo
líneas	lineas	noun	Duolingo
liso	liso	adjective	Duolingo
lista	lista	adjective	Duolingo
lista	lista	noun	Duolingo
literatura	literatura	noun	Duolingo
llama	llama	verb	Duolingo
llamaba	llamaba	verb	Duolingo
llamada	llamada	noun	Duolingo
llamadas	llamadas	noun	Duolingo
llamamos	llamamos	verb	Duolingo
llaman	llaman	verb	Duolingo
llamando	llamando	verb	Duolingo
llamándola	llamandola	pronoun	Duolingo
llamándolo	llamandolo	pronoun	Duolingo
llamar	llamar	verb	Duolingo
llamará	llamara	verb	Duolingo
llamaré	llamare	verb	Duolingo
llamaron	llamaron	verb	Duolingo
llamas	llamas	verb	Duolingo
llamaste	llamaste	verb	Duolingo
llame	llame	verb	Duolingo
llamen	llamen	verb	Duolingo
llamó	llamo	verb	Duolingo
llave	llave	noun	Duolingo
llaves	llaves	noun	Duolingo
llega	llega	verb	Duolingo
llegaba	llegaba	verb	Duolingo
llegada	llegada	noun	Duolingo
llegamos	llegamos	verb	Duolingo
llegar	llegar	verb	Duolingo
llegará	llegara	verb	Duolingo
llegaré	llegare	verb	Duolingo
llegaremos	llegaremos	verb	Duolingo
llegaron	llegaron	verb	Duolingo
llegas	llegas	verb	Duolingo
llegaste	llegaste	verb	Duolingo
llegó	llego	verb	Duolingo
llegue	llegue	verb	Duolingo
llena	llena	verb	Duolingo
llenas	llenas	adjective	Duolingo
llene	llene	verb	Duolingo
lleno	lleno	verb	Duolingo
lleva	lleva	verb	Duolingo
lleva puesto	lleva puesto		Duolingo
llevaba	llevaba	verb	Duolingo
llévame	llevame	pronoun	Duolingo
llevamos	llevamos	verb	Duolingo
llevan	llevan	verb	Duolingo
llevar	llevar	verb	Duolingo
llevarnos bien	llevarnos bien		Duolingo
llevas	llevas	verb	Duolingo
llevaste	llevaste	verb	Duolingo
llévate	llevate	pronoun	Duolingo
lléveme	lleveme	pronoun	Duolingo
lleves	lleves	verb	Duolingo
llevo	llevo	verb	Duolingo
lloraban	lloraban	verb	Duolingo
llorabas	llorabas	verb	Duolingo
llorar	llorar	verb	Duolingo
llover	llover	verb	Duolingo
lloverá	llovera	verb	Duolingo
llovía	llovia	verb	Duolingo
lloviendo	lloviendo	verb	Duolingo
llovió	llovio	verb	Duolingo
llueve	llueve	verb	Duolingo
lluvia	lluvia	noun	Duolingo
lluvias	lluvias	noun	Duolingo
lo	lo	pronoun	Duolingo
lo compro	lo compro		Duolingo
lo contrario	lo contrario		Duolingo
lo curioso	lo curioso		Duolingo
lo es	lo es		Duolingo
lo está	lo esta		Duolingo
lo interesante	lo interesante		Duolingo
lo lamento	lo lamento		Duolingo
lo más divertido	lo mas divertido		Duolingo
lo más importante	lo mas importante		Duolingo
lo mismo	lo mismo		Duolingo
lo mismo que	lo mismo que		Duolingo
lo que	lo que		Duolingo
lo quiero	lo quiero		Duolingo
lo raro	lo raro		Duolingo
lo siento	lo siento		Duolingo
lo siento	lo siento	interjection	Duolingo
local	local	adjective	Duolingo
loco	loco	adjective	Duolingo
locos	locos	adjective	Duolingo
locos	locos	noun	Duolingo
lógica	logica	adjective	Duolingo
lógico	logico	adjective	Duolingo
lograr	lograr	verb	Duolingo
logró	logro	verb	Duolingo
los	los	determiner	Duolingo
los	los	pronoun	Duolingo
los años	los anos		Duolingo
los comen	los comen		Duolingo
los deportes	los deportes		Duolingo
los gatos	los gatos		Duolingo
los lunes	los lunes		Duolingo
los maestros	los maestros		Duolingo
los médicos	los medicos		Duolingo
los necesita	los necesita		Duolingo
los padres	los padres		Duolingo
los perros	los perros		Duolingo
luces	luces	noun	Duolingo
luego	luego		Duolingo
luego	luego	adverb	Duolingo
lugar	lugar	noun	Duolingo
lugares	lugares	noun	Duolingo
luna	luna	noun	Duolingo
lunes	lunes	noun	Duolingo
luz	luz	noun	Duolingo
madera	madera	noun	Duolingo
madre	madre		Duolingo
madre	madre	noun	Duolingo
madrugada	madrugada	noun	Duolingo
maestra	maestra	noun	Duolingo
maestras	maestras	noun	Duolingo
maestro	maestro		Duolingo
maestro	maestro	noun	Duolingo
maestros	maestros	noun	Duolingo
magia	magia	noun	Duolingo
maíz	maiz	noun	Duolingo
mal	mal	adjective	Duolingo
mal	mal	adverb	Duolingo
mal	mal	noun	Duolingo
mal tiempo	mal tiempo		Duolingo
mala	mala	adjective	Duolingo
maleta	maleta		Duolingo
maleta	maleta	noun	Duolingo
maletas	maletas	noun	Duolingo
malísima	malisima	adjective	Duolingo
malísimos	malisimos	adjective	Duolingo
malo	malo	adjective	Duolingo
malos	malos	adjective	Duolingo
mamá	mama	noun	Duolingo
mañana	manana	adverb	Duolingo
mañana	manana	noun	Duolingo
manda	manda	verb	Duolingo
mandamos	mandamos	verb	Duolingo
mandan	mandan	verb	Duolingo
mandar	mandar	verb	Duolingo
mandaste	mandaste	verb	Duolingo
mandé	mande	verb	Duolingo
maneja	maneja	verb	Duolingo
manejaba	manejaba	verb	Duolingo
manejan	manejan	verb	Duolingo
manejar	manejar	verb	Duolingo
manejo	manejo	verb	Duolingo
manera	manera	noun	Duolingo
mangos	mangos	noun	Duolingo
manifestación	manifestacion	noun	Duolingo
manifestaciones	manifestaciones	noun	Duolingo
mano	mano	noun	Duolingo
mano de obra	mano de obra		Duolingo
manos	manos	noun	Duolingo
mantenemos	mantenemos	verb	Duolingo
mantener	mantener	verb	Duolingo
mantengo	mantengo	verb	Duolingo
mantequilla	mantequilla	noun	Duolingo
mantequilla de maní	mantequilla de mani		Duolingo
mantiene	mantiene	verb	Duolingo
manuela	manuela	proper noun	Duolingo
manzana	manzana	noun	Duolingo
manzanas	manzanas	noun	Duolingo
mapa	mapa	noun	Duolingo
maquillaje	maquillaje	noun	Duolingo
máquina	maquina	noun	Duolingo
máquinas	maquinas	noun	Duolingo
mar	mar	noun	Duolingo
maravillosas	maravillosas	adjective	Duolingo
maravilloso	maravilloso	adjective	Duolingo
mareada	mareada	adjective	Duolingo
margen	margen	noun	Duolingo
marido	marido	noun	Duolingo
mariscos	mariscos	noun	Duolingo
marrón	marron		Duolingo
marrones	marrones	noun	Duolingo
martes	martes	noun	Duolingo
marzo	marzo	noun	Duolingo
más	mas		Duolingo
más	mas	adjective	Duolingo
más	mas	adverb	Duolingo
más o menos	mas o menos		Duolingo
más que	mas que		Duolingo
masa	masa	noun	Duolingo
mascota	mascota	noun	Duolingo
mascotas	mascotas	noun	Duolingo
matar	matar	verb	Duolingo
matarán	mataran	verb	Duolingo
matemáticas	matematicas	noun	Duolingo
materia	materia	noun	Duolingo
material	material	noun	Duolingo
materias	materias	noun	Duolingo
matrimonio	matrimonio	noun	Duolingo
máxima	maxima	adjective	Duolingo
máximo	maximo	adjective	Duolingo
mayo	mayo	noun	Duolingo
mayonesa	mayonesa	noun	Duolingo
mayor	mayor	adjective	Duolingo
mayores	mayores	adjective	Duolingo
mayoría	mayoria	noun	Duolingo
me	me	pronoun	Duolingo
me acostaré	me acostare		Duolingo
me acuerdo	me acuerdo		Duolingo
me ama	me ama		Duolingo
me ayudas	me ayudas		Duolingo
me bajo	me bajo		Duolingo
me cae bien	me cae bien		Duolingo
me cae mal	me cae mal		Duolingo
me caigo	me caigo		Duolingo
me caso	me caso		Duolingo
me cepillé	me cepille		Duolingo
me compra	me compra		Duolingo
me conoce	me conoce		Duolingo
me despierto	me despierto		Duolingo
me dice	me dice		Duolingo
me dices	me dices		Duolingo
me duché	me duche		Duolingo
me ducho	me ducho		Duolingo
me encanta	me encanta		Duolingo
me encuentro	me encuentro		Duolingo
me enseña	me ensena		Duolingo
me escondí	me escondi		Duolingo
me escucha	me escucha		Duolingo
me fui	me fui		Duolingo
me gusta	me gusta		Duolingo
me iba	me iba		Duolingo
me interesa	me interesa		Duolingo
me iré	me ire		Duolingo
me la	me la		Duolingo
me lavo	me lavo		Duolingo
me levantaba	me levantaba		Duolingo
me levanté	me levante		Duolingo
me levanto	me levanto		Duolingo
me llaman	me llaman		Duolingo
me llamo	me llamo		Duolingo
me llevaba bien	me llevaba bien		Duolingo
me lo	me lo		Duolingo
me lo llevo	me lo llevo		Duolingo
me lo quedo	me lo quedo		Duolingo
me los llevo	me los llevo		Duolingo
me necesita	me necesita		Duolingo
me olvido	me olvido		Duolingo
me pierdo	me pierdo		Duolingo
me pongo	me pongo		Duolingo
me preocupo	me preocupo		Duolingo
me probé	me probe		Duolingo
me puede cambiar	me puede cambiar		Duolingo
me puede decir	me puede decir		Duolingo
me puede traer	me puede traer		Duolingo
me puedes decir	me puedes decir		Duolingo
me puedo probar	me puedo probar		Duolingo
me puse	me puse		Duolingo
me quedaré con	me quedare con		Duolingo
me quedé	me quede		Duolingo
me quedo	me quedo		Duolingo
me quedo con	me quedo con		Duolingo
me reuní	me reuni		Duolingo
me río	me rio		Duolingo
me siento	me siento		Duolingo
me subo	me subo		Duolingo
me veo	me veo		Duolingo
me voy	me voy		Duolingo
mecánica	mecanica	noun	Duolingo
mecánico	mecanico	noun	Duolingo
mecánicos	mecanicos	noun	Duolingo
media	media	noun	Duolingo
medianoche	medianoche	noun	Duolingo
medias	medias	noun	Duolingo
médica	medica	noun	Duolingo
médicas	medicas	noun	Duolingo
medicina	medicina		Duolingo
medicina	medicina	noun	Duolingo
médico	medico	noun	Duolingo
médicos	medicos	noun	Duolingo
medida	medida	noun	Duolingo
medidas	medidas	noun	Duolingo
medio	medio	noun	Duolingo
medio ambiente	medio ambiente		Duolingo
mediodía	mediodia	noun	Duolingo
mejor	mejor	adjective	Duolingo
mejor	mejor	adverb	Duolingo
mejora	mejora	verb	Duolingo
mejorar	mejorar	verb	Duolingo
mejorarán	mejoraran	verb	Duolingo
mejores	mejores	adjective	Duolingo
mejoro	mejoro	verb	Duolingo
melón	melon	noun	Duolingo
memoria	memoria	noun	Duolingo
memorizan	memorizan	verb	Duolingo
menciona	menciona	verb	Duolingo
mencionó	menciono	verb	Duolingo
menor	menor	adjective	Duolingo
menores	menores	adjective	Duolingo
menos	menos	adjective	Duolingo
menos	menos	adverb	Duolingo
menos	menos	noun	Duolingo
menos mal	menos mal		Duolingo
menos que	menos que		Duolingo
mensaje	mensaje	noun	Duolingo
mensajes	mensajes	noun	Duolingo
mente	mente		Duolingo
mente	mente	noun	Duolingo
menú	menu	noun	Duolingo
mercado	mercado	noun	Duolingo
mercados	mercados	noun	Duolingo
mes	mes	noun	Duolingo
mesa	mesa		Duolingo
mesa	mesa	noun	Duolingo
mesas de noche	mesas de noche		Duolingo
mesera	mesera	noun	Duolingo
mesero	mesero	noun	Duolingo
meseros	meseros	noun	Duolingo
meses	meses	noun	Duolingo
mesita	mesita	noun	Duolingo
metal	metal	noun	Duolingo
metas	metas	noun	Duolingo
método	metodo	noun	Duolingo
métodos	metodos	noun	Duolingo
metro	metro	noun	Duolingo
metros	metros	noun	Duolingo
mexicana	mexicana	adjective	Duolingo
mexicanas	mexicanas	noun	Duolingo
mexicano	mexicano	adjective	Duolingo
mexicanos	mexicanos	adjective	Duolingo
mexicanos	mexicanos	noun	Duolingo
méxico	mexico	proper noun	Duolingo
mezcla	mezcla	verb	Duolingo
mezclan	mezclan	verb	Duolingo
mezclar	mezclar	verb	Duolingo
mi	mi		Duolingo
mi	mi	determiner	Duolingo
mí	mi	pronoun	Duolingo
mi nuevo	mi nuevo		Duolingo
mía	mia	adjective	Duolingo
mía	mia	pronoun	Duolingo
mías	mias	adjective	Duolingo
microondas	microondas	noun	Duolingo
miedo	miedo	noun	Duolingo
mientras	mientras	conjunction	Duolingo
mientras tanto	mientras tanto		Duolingo
miércoles	miercoles	noun	Duolingo
mil	mil	numeral	Duolingo
mil disculpas	mil disculpas		Duolingo
mil gracias	mil gracias		Duolingo
mil millones	mil millones		Duolingo
miles	miles	noun	Duolingo
miles	miles	numeral	Duolingo
millas	millas	noun	Duolingo
millón	millon	noun	Duolingo
millones	millones	noun	Duolingo
mínima	minima	adjective	Duolingo
mínimo	minimo	adjective	Duolingo
ministerio	ministerio	noun	Duolingo
ministra	ministra	noun	Duolingo
ministras	ministras	noun	Duolingo
ministro	ministro	noun	Duolingo
minuto	minuto	noun	Duolingo
minutos	minutos	noun	Duolingo
mío	mio	adjective	Duolingo
mío	mio	pronoun	Duolingo
míos	mios	adjective	Duolingo
mira	mira		Duolingo
mira	mira	verb	Duolingo
miraba	miraba	verb	Duolingo
miraban	miraban	verb	Duolingo
mirada	mirada	noun	Duolingo
miramos	miramos	verb	Duolingo
mirando	mirando	verb	Duolingo
mirar	mirar	verb	Duolingo
miraron	miraron	verb	Duolingo
miras	miras	verb	Duolingo
miraste	miraste	verb	Duolingo
miré	mire	verb	Duolingo
miren	miren	verb	Duolingo
miro	miro	verb	Duolingo
mis	mis	determiner	Duolingo
misión	mision	noun	Duolingo
misma	misma	adjective	Duolingo
mismas	mismas	adjective	Duolingo
mismo	mismo	adjective	Duolingo
mismos	mismos	adjective	Duolingo
mitad	mitad	noun	Duolingo
mochila	mochila	noun	Duolingo
moda	moda	noun	Duolingo
modas	modas	noun	Duolingo
modelo	modelo	noun	Duolingo
modelos	modelos	noun	Duolingo
moderna	moderna	adjective	Duolingo
modernas	modernas	adjective	Duolingo
moderno	moderno	adjective	Duolingo
modernos	modernos	adjective	Duolingo
mojadas	mojadas	adjective	Duolingo
mojado	mojado	adjective	Duolingo
mojados	mojados	adjective	Duolingo
molesta	molesta	verb	Duolingo
molestos	molestos	adjective	Duolingo
momento	momento	noun	Duolingo
momentos	momentos	noun	Duolingo
monas	monas	noun	Duolingo
moneda	moneda	noun	Duolingo
mono	mono	noun	Duolingo
monos	monos	noun	Duolingo
montaba	montaba	verb	Duolingo
montabas	montabas	verb	Duolingo
montamos	montamos	verb	Duolingo
montan	montan	verb	Duolingo
montaña	montana	noun	Duolingo
montañas	montanas	noun	Duolingo
montar	montar	verb	Duolingo
montaron	montaron	verb	Duolingo
montaste	montaste	verb	Duolingo
monté	monte	verb	Duolingo
monumento	monumento	noun	Duolingo
monumentos	monumentos	noun	Duolingo
morada	morada	adjective	Duolingo
morenos	morenos	adjective	Duolingo
morir	morir	verb	Duolingo
mostaza	mostaza	noun	Duolingo
mostramos	mostramos	verb	Duolingo
mostrar	mostrar	verb	Duolingo
mostró	mostro	verb	Duolingo
motivo	motivo	noun	Duolingo
motivos	motivos	noun	Duolingo
moto	moto	noun	Duolingo
motor	motor	noun	Duolingo
motores	motores	noun	Duolingo
mover	mover	verb	Duolingo
movimiento	movimiento	noun	Duolingo
movimientos	movimientos	noun	Duolingo
mucha	mucha	determiner	Duolingo
muchacha	muchacha	noun	Duolingo
muchacho	muchacho	noun	Duolingo
muchas	muchas	adjective	Duolingo
muchas	muchas	determiner	Duolingo
muchas gracias	muchas gracias		Duolingo
muchísimas gracias	muchisimas gracias		Duolingo
mucho	mucho		Duolingo
mucho	mucho	adjective	Duolingo
mucho	mucho	adverb	Duolingo
mucho gusto	mucho gusto		Duolingo
mucho gusto	mucho gusto	interjection	Duolingo
muchos	muchos	adjective	Duolingo
muchos	muchos	determiner	Duolingo
muebles	muebles	noun	Duolingo
muertas	muertas	adjective	Duolingo
muerto	muerto	adjective	Duolingo
muertos	muertos	adjective	Duolingo
muestra	muestra	verb	Duolingo
muestran	muestran	verb	Duolingo
muestras	muestras	verb	Duolingo
mujer	mujer	noun	Duolingo
mujeres	mujeres	noun	Duolingo
múltiples	multiples	adjective	Duolingo
mundial	mundial	adjective	Duolingo
mundiales	mundiales	adjective	Duolingo
mundo	mundo	noun	Duolingo
muñeca	muneca	noun	Duolingo
muñecas	munecas	noun	Duolingo
muriendo	muriendo	verb	Duolingo
murió	murio	verb	Duolingo
museo	museo		Duolingo
museo	museo	noun	Duolingo
música	musica	noun	Duolingo
musical	musical	adjective	Duolingo
musicales	musicales	adjective	Duolingo
muy	muy		Duolingo
muy	muy	adverb	Duolingo
muy amable	muy amable		Duolingo
nacer	nacer	verb	Duolingo
nación	nacion	noun	Duolingo
nacional	nacional	adjective	Duolingo
nacionales	nacionales	adjective	Duolingo
nacionalidad	nacionalidad	noun	Duolingo
nada	nada	pronoun	Duolingo
nada	nada	verb	Duolingo
nada es	nada es		Duolingo
nada más	nada mas		Duolingo
nadaba	nadaba	verb	Duolingo
nadábamos	nadabamos	verb	Duolingo
nadabas	nadabas	verb	Duolingo
nadamos	nadamos	verb	Duolingo
nadan	nadan	verb	Duolingo
nadando	nadando	verb	Duolingo
nadar	nadar	verb	Duolingo
nadas	nadas	verb	Duolingo
nadaste	nadaste	verb	Duolingo
nadé	nade	verb	Duolingo
nadie	nadie	pronoun	Duolingo
nadie más	nadie mas		Duolingo
nadó	nado	verb	Duolingo
naranja	naranja		Duolingo
naranja	naranja	adjective	Duolingo
naranja	naranja	noun	Duolingo
naranjas	naranjas	adjective	Duolingo
narices	narices	noun	Duolingo
nariz	nariz	noun	Duolingo
natación	natacion	noun	Duolingo
natural	natural	adjective	Duolingo
naturales	naturales	adjective	Duolingo
naturaleza	naturaleza	noun	Duolingo
naturalmente	naturalmente	adverb	Duolingo
navegamos	navegamos	verb	Duolingo
navegará	navegara	verb	Duolingo
navegaré	navegare	verb	Duolingo
navegaremos	navegaremos	verb	Duolingo
navegué	navegue	verb	Duolingo
navidad	navidad	noun	Duolingo
necesaria	necesaria	adjective	Duolingo
necesariamente	necesariamente	adverb	Duolingo
necesarias	necesarias	adjective	Duolingo
necesario	necesario	adjective	Duolingo
necesarios	necesarios	adjective	Duolingo
necesidad	necesidad	noun	Duolingo
necesidades	necesidades	noun	Duolingo
necesita	necesita	verb	Duolingo
necesita escribir	necesita escribir		Duolingo
necesitaba	necesitaba	verb	Duolingo
necesitaban	necesitaban	verb	Duolingo
necesitamos	necesitamos	verb	Duolingo
necesitamos abrir	necesitamos abrir		Duolingo
necesitan	necesitan	verb	Duolingo
necesitar	necesitar	verb	Duolingo
necesitaría	necesitaria	verb	Duolingo
necesitarla	necesitarla	pronoun	Duolingo
necesitarlas	necesitarlas	pronoun	Duolingo
necesitas	necesitas	verb	Duolingo
necesito	necesito		Duolingo
necesito	necesito	verb	Duolingo
necesito comprar	necesito comprar		Duolingo
negativa	negativa	adjective	Duolingo
negativo	negativo	adjective	Duolingo
negativos	negativos	adjective	Duolingo
negó	nego	verb	Duolingo
negociación	negociacion	noun	Duolingo
negocio	negocio	noun	Duolingo
negocios	negocios	noun	Duolingo
negra	negra	adjective	Duolingo
negras	negras	adjective	Duolingo
negro	negro	adjective	Duolingo
negros	negros	adjective	Duolingo
negué	negue	verb	Duolingo
nerviosa	nerviosa	adjective	Duolingo
nerviosas	nerviosas	adjective	Duolingo
nervioso	nervioso	adjective	Duolingo
nevaba	nevaba	verb	Duolingo
nevando	nevando	verb	Duolingo
nevar	nevar	verb	Duolingo
nevará	nevara	verb	Duolingo
nevera	nevera	noun	Duolingo
neveras	neveras	noun	Duolingo
nevó	nevo	verb	Duolingo
ni	ni	conjunction	Duolingo
ni idea	ni idea		Duolingo
ni siquiera	ni siquiera		Duolingo
niebla	niebla	noun	Duolingo
nietas	nietas	noun	Duolingo
nieva	nieva	verb	Duolingo
niña	nina	noun	Duolingo
niñas	ninas	noun	Duolingo
niñez	ninez	noun	Duolingo
ningún	ningun	determiner	Duolingo
ninguna	ninguna	determiner	Duolingo
ninguna	ninguna	pronoun	Duolingo
ninguno	ninguno	pronoun	Duolingo
ninguno de	ninguno de		Duolingo
ningunos	ningunos	pronoun	Duolingo
niño	nino	noun	Duolingo
niños	ninos	noun	Duolingo
nivel	nivel	noun	Duolingo
niveles	niveles	noun	Duolingo
no	no		Duolingo
no	no	adverb	Duolingo
no crees	no crees		Duolingo
no creo que	no creo que		Duolingo
no es cierto que	no es cierto que		Duolingo
no es seguro que	no es seguro que		Duolingo
no está nada mal	no esta nada mal		Duolingo
no hay de qué	no hay de que		Duolingo
no hay por qué	no hay por que		Duolingo
no hay problema	no hay problema		Duolingo
no lo sé	no lo se		Duolingo
no me digas	no me digas		Duolingo
no me parece que	no me parece que		Duolingo
no pasa nada	no pasa nada		Duolingo
no puede ser	no puede ser		Duolingo
no puede ser que	no puede ser que		Duolingo
no te creo	no te creo		Duolingo
no vayamos	no vayamos		Duolingo
noche	noche	noun	Duolingo
nochebuena	nochebuena	noun	Duolingo
noches	noches	noun	Duolingo
nochevieja	nochevieja	noun	Duolingo
nombre	nombre	noun	Duolingo
nombre de usuario	nombre de usuario		Duolingo
nombres	nombres	noun	Duolingo
normal	normal	adjective	Duolingo
normalmente	normalmente	adverb	Duolingo
noroeste	noroeste	adjective	Duolingo
norte	norte	noun	Duolingo
norteamericana	norteamericana	adjective	Duolingo
norteamericano	norteamericano	adjective	Duolingo
nos	nos	pronoun	Duolingo
nos acordamos	nos acordamos		Duolingo
nos acostamos	nos acostamos		Duolingo
nos acostaremos	nos acostaremos		Duolingo
nos apuramos	nos apuramos		Duolingo
nos ayudan	nos ayudan		Duolingo
nos ayudas	nos ayudas		Duolingo
nos bajamos	nos bajamos		Duolingo
nos besamos	nos besamos		Duolingo
nos besaremos	nos besaremos		Duolingo
nos caemos	nos caemos		Duolingo
nos casamos	nos casamos		Duolingo
nos cepillamos	nos cepillamos		Duolingo
nos compra	nos compra		Duolingo
nos comunicamos	nos comunicamos		Duolingo
nos conocemos	nos conocemos		Duolingo
nos conocen	nos conocen		Duolingo
nos despertamos	nos despertamos		Duolingo
nos duchamos	nos duchamos		Duolingo
nos encanta	nos encanta		Duolingo
nos encontramos	nos encontramos		Duolingo
nos escondimos	nos escondimos		Duolingo
nos escribimos	nos escribimos		Duolingo
nos escuchan	nos escuchan		Duolingo
nos gusta	nos gusta		Duolingo
nos interesa	nos interesa		Duolingo
nos iremos	nos iremos		Duolingo
nos lavamos	nos lavamos		Duolingo
nos levantamos	nos levantamos		Duolingo
nos llamamos	nos llamamos		Duolingo
nos llamas	nos llamas		Duolingo
nos llevamos bien	nos llevamos bien		Duolingo
nos odiamos	nos odiamos		Duolingo
nos ponemos	nos ponemos		Duolingo
nos probamos	nos probamos		Duolingo
nos quedamos	nos quedamos		Duolingo
nos quedamos con	nos quedamos con		Duolingo
nos quedaremos con	nos quedaremos con		Duolingo
nos reímos	nos reimos		Duolingo
nos relajamos	nos relajamos		Duolingo
nos reunimos	nos reunimos		Duolingo
nos sentamos	nos sentamos		Duolingo
nos sentimos	nos sentimos		Duolingo
nos subimos	nos subimos		Duolingo
nos tumbamos	nos tumbamos		Duolingo
nos vamos	nos vamos		Duolingo
nos vemos	nos vemos		Duolingo
nos visita	nos visita		Duolingo
nosotras	nosotras	pronoun	Duolingo
nosotras vivimos	nosotras vivimos		Duolingo
nosotros	nosotros	pronoun	Duolingo
nosotros comemos	nosotros comemos		Duolingo
nosotros fuimos	nosotros fuimos		Duolingo
nosotros leemos	nosotros leemos		Duolingo
nota	nota	noun	Duolingo
notas	notas	noun	Duolingo
noticia	noticia	noun	Duolingo
noticias	noticias	noun	Duolingo
novecientos	novecientos	numeral	Duolingo
novela	novela	noun	Duolingo
novelas	novelas	noun	Duolingo
noventa	noventa	numeral	Duolingo
novia	novia	noun	Duolingo
noviembre	noviembre	noun	Duolingo
novio	novio	noun	Duolingo
novios	novios	noun	Duolingo
nublado	nublado	adjective	Duolingo
núcleo	nucleo	noun	Duolingo
nuestra	nuestra	determiner	Duolingo
nuestra	nuestra	pronoun	Duolingo
nuestras	nuestras	determiner	Duolingo
nuestro	nuestro	determiner	Duolingo
nuestro	nuestro	pronoun	Duolingo
nuestros	nuestros	determiner	Duolingo
nueva	nueva	adjective	Duolingo
nuevamente	nuevamente	adverb	Duolingo
nuevas	nuevas	adjective	Duolingo
nueve	nueve	numeral	Duolingo
nuevo	nuevo	adjective	Duolingo
nuevos	nuevos	adjective	Duolingo
número	numero	noun	Duolingo
números	numeros	noun	Duolingo
numerosos	numerosos	adjective	Duolingo
nunca	nunca	adverb	Duolingo
nunca más	nunca mas		Duolingo
o	o		Duolingo
o	o	conjunction	Duolingo
objetivo	objetivo	noun	Duolingo
objetivos	objetivos	noun	Duolingo
objeto	objeto	noun	Duolingo
objetos	objetos	noun	Duolingo
obligación	obligacion	noun	Duolingo
obra	obra	noun	Duolingo
obra de teatro	obra de teatro		Duolingo
obras	obras	noun	Duolingo
obrera	obrera	adjective	Duolingo
obrero	obrero	adjective	Duolingo
observa	observa	verb	Duolingo
observación	observacion	noun	Duolingo
observaciones	observaciones	noun	Duolingo
observar	observar	verb	Duolingo
obtener	obtener	verb	Duolingo
obtuvo	obtuvo	verb	Duolingo
obvia	obvia	adjective	Duolingo
obviamente	obviamente	adverb	Duolingo
obvio	obvio	adjective	Duolingo
ocasión	ocasion	noun	Duolingo
ochenta	ochenta	numeral	Duolingo
ocho	ocho	numeral	Duolingo
ochocientos	ochocientos	numeral	Duolingo
octubre	octubre	noun	Duolingo
ocupa	ocupa	verb	Duolingo
ocupación	ocupacion	noun	Duolingo
ocupada	ocupada	adjective	Duolingo
ocupadas	ocupadas	adjective	Duolingo
ocupado	ocupado	adjective	Duolingo
ocupados	ocupados	adjective	Duolingo
ocupamos	ocupamos	verb	Duolingo
ocupan	ocupan	verb	Duolingo
ocurrieron	ocurrieron	verb	Duolingo
ocurrió	ocurrio	verb	Duolingo
ocurrir	ocurrir	verb	Duolingo
odia	odia	verb	Duolingo
odiaba	odiaba	verb	Duolingo
odiaban	odiaban	verb	Duolingo
odiar	odiar	verb	Duolingo
odiaste	odiaste	verb	Duolingo
odio	odio	verb	Duolingo
oeste	oeste	noun	Duolingo
oferta	oferta	noun	Duolingo
oficial	oficial	noun	Duolingo
oficiales	oficiales	noun	Duolingo
oficina	oficina	noun	Duolingo
oficina de correos	oficina de correos		Duolingo
oficinas	oficinas	noun	Duolingo
ofrecer	ofrecer	verb	Duolingo
ofrecieron	ofrecieron	verb	Duolingo
ofreció	ofrecio	verb	Duolingo
ofrezco	ofrezco	verb	Duolingo
oí	oi	verb	Duolingo
oído	oido	noun	Duolingo
oídos	oidos	noun	Duolingo
oigan	oigan	verb	Duolingo
oigo	oigo	verb	Duolingo
oímos	oimos	verb	Duolingo
oír	oir	verb	Duolingo
oíste	oiste	verb	Duolingo
oíste que	oiste que		Duolingo
ojalá	ojala	interjection	Duolingo
ojo	ojo	noun	Duolingo
ojos	ojos	noun	Duolingo
olor	olor	noun	Duolingo
olvidar	olvidar	verb	Duolingo
olvidaron	olvidaron	verb	Duolingo
olvido	olvido	verb	Duolingo
once	once	numeral	Duolingo
opción	opcion	noun	Duolingo
opciones	opciones	noun	Duolingo
ópera	opera	noun	Duolingo
operación	operacion	noun	Duolingo
opinión	opinion	noun	Duolingo
opiniones	opiniones	noun	Duolingo
oportunidad	oportunidad	noun	Duolingo
oportunidades	oportunidades	noun	Duolingo
oposición	oposicion	noun	Duolingo
oraciones	oraciones	noun	Duolingo
orden	orden	noun	Duolingo
organicé	organice	verb	Duolingo
organismo	organismo	noun	Duolingo
organiza	organiza	verb	Duolingo
organización	organizacion	noun	Duolingo
organizaste	organizaste	verb	Duolingo
órgano	organo	noun	Duolingo
orientación	orientacion	noun	Duolingo
orientaciones	orientaciones	noun	Duolingo
origen	origen	noun	Duolingo
original	original	adjective	Duolingo
originales	originales	adjective	Duolingo
oro	oro	noun	Duolingo
orquesta	orquesta	noun	Duolingo
ortografía	ortografia	noun	Duolingo
oscuridad	oscuridad	noun	Duolingo
oscuro	oscuro	adjective	Duolingo
oscuros	oscuros	adjective	Duolingo
oso	oso	noun	Duolingo
otoños	otonos	noun	Duolingo
otra	otra	determiner	Duolingo
otra	otra	pronoun	Duolingo
otra vez	otra vez		Duolingo
otras	otras	determiner	Duolingo
otras	otras	pronoun	Duolingo
otro	otro	determiner	Duolingo
otro	otro	pronoun	Duolingo
otros	otros	determiner	Duolingo
otros	otros	pronoun	Duolingo
ovejas	ovejas	noun	Duolingo
oye	oye		Duolingo
oye	oye	interjection	Duolingo
oye	oye	verb	Duolingo
oyen	oyen	verb	Duolingo
oyendo	oyendo	verb	Duolingo
oyes	oyes	verb	Duolingo
oyó	oyo	verb	Duolingo
paciencia	paciencia	noun	Duolingo
paciente	paciente	noun	Duolingo
pacientes	pacientes	noun	Duolingo
padre	padre		Duolingo
padre	padre	noun	Duolingo
padres	padres	noun	Duolingo
paga	paga	verb	Duolingo
pagada	pagada	verb	Duolingo
pagado	pagado	verb	Duolingo
pagamos	pagamos	verb	Duolingo
pagan	pagan	verb	Duolingo
pagando	pagando	verb	Duolingo
pagar	pagar		Duolingo
pagar	pagar	verb	Duolingo
pagas	pagas	verb	Duolingo
pagaste	pagaste	verb	Duolingo
página	pagina	noun	Duolingo
página web	pagina web		Duolingo
páginas	paginas	noun	Duolingo
páginas web	paginas web		Duolingo
pagó	pago	verb	Duolingo
pagué	pague	verb	Duolingo
paguen	paguen	verb	Duolingo
pagues	pagues	verb	Duolingo
país	pais	noun	Duolingo
paisaje	paisaje	noun	Duolingo
países	paises	noun	Duolingo
pájaro	pajaro	noun	Duolingo
pájaros	pajaros	noun	Duolingo
palabra	palabra	noun	Duolingo
palabras	palabras	noun	Duolingo
palacio	palacio	noun	Duolingo
pálido	palido	adjective	Duolingo
palomitas de maíz	palomitas de maiz		Duolingo
pan	pan	noun	Duolingo
panadera	panadera	noun	Duolingo
panadero	panadero	noun	Duolingo
panes	panes	noun	Duolingo
panorama	panorama	noun	Duolingo
pantalla	pantalla	noun	Duolingo
pantalón	pantalon	noun	Duolingo
pantalones	pantalones	noun	Duolingo
pantalones cortos	pantalones cortos	noun	Duolingo
papá	papa	noun	Duolingo
papel	papel	noun	Duolingo
papeles	papeles	noun	Duolingo
paquete	paquete	noun	Duolingo
paquetes	paquetes	noun	Duolingo
par	par	noun	Duolingo
para	para		Duolingo
para	para	preposition	Duolingo
para	para	verb	Duolingo
para él	para el		Duolingo
para ella	para ella		Duolingo
para nada	para nada		Duolingo
para nosotros	para nosotros		Duolingo
para que	para que		Duolingo
para siempre	para siempre		Duolingo
parabrisas	parabrisas	noun	Duolingo
parachoques	parachoques	noun	Duolingo
paraguas	paraguas	noun	Duolingo
paramos	paramos	verb	Duolingo
parar	parar	verb	Duolingo
pararme	pararme	pronoun	Duolingo
pararse	pararse	pronoun	Duolingo
pararte	pararte	pronoun	Duolingo
paras	paras	verb	Duolingo
parece	parece		Duolingo
parece	parece	verb	Duolingo
parecen	parecen	verb	Duolingo
parecía	parecia	verb	Duolingo
parecían	parecian	verb	Duolingo
pared	pared	noun	Duolingo
paredes	paredes	noun	Duolingo
pareja	pareja	noun	Duolingo
parejas	parejas	noun	Duolingo
pares	pares	noun	Duolingo
parís	paris	proper noun	Duolingo
parlantes	parlantes	noun	Duolingo
paro	paro	verb	Duolingo
parque	parque	noun	Duolingo
parque de atracciones	parque de atracciones		Duolingo
parques	parques	noun	Duolingo
párrafos	parrafos	noun	Duolingo
parrilla	parrilla	noun	Duolingo
parte	parte	noun	Duolingo
parte de atrás	parte de atras		Duolingo
partes	partes	noun	Duolingo
participar	participar	verb	Duolingo
particular	particular	adjective	Duolingo
partido	partido	noun	Duolingo
partidos	partidos	noun	Duolingo
partir	partir	verb	Duolingo
pasa	pasa	verb	Duolingo
pasaba	pasaba	verb	Duolingo
pasábamos	pasabamos	verb	Duolingo
pasaban	pasaban	verb	Duolingo
pasada	pasada	adjective	Duolingo
pasado	pasado	adjective	Duolingo
pasado mañana	pasado manana		Duolingo
pasados	pasados	adjective	Duolingo
pásamela	pasamela		Duolingo
pásamelas	pasamelas		Duolingo
pásamelos	pasamelos		Duolingo
pasamos	pasamos	verb	Duolingo
pasan	pasan	verb	Duolingo
pasando	pasando	verb	Duolingo
pasaporte	pasaporte		Duolingo
pasaporte	pasaporte	noun	Duolingo
pasaportes	pasaportes	noun	Duolingo
pasar	pasar	verb	Duolingo
pasas	pasas	verb	Duolingo
pase	pase	verb	Duolingo
pasión	pasion	noun	Duolingo
paso	paso	noun	Duolingo
pasó	paso	verb	Duolingo
pasos	pasos	noun	Duolingo
pasta	pasta	noun	Duolingo
pasto	pasto	noun	Duolingo
patada	patada	noun	Duolingo
patinábamos	patinabamos	verb	Duolingo
patinaban	patinaban	verb	Duolingo
patinabas	patinabas	verb	Duolingo
patinar	patinar	verb	Duolingo
patines	patines	noun	Duolingo
patio	patio	noun	Duolingo
patio de juego	patio de juego		Duolingo
patios de juego	patios de juego		Duolingo
pato	pato	noun	Duolingo
patos	patos	noun	Duolingo
patria	patria	noun	Duolingo
pausa	pausa	noun	Duolingo
pavo	pavo	noun	Duolingo
payaso	payaso	noun	Duolingo
payasos	payasos	noun	Duolingo
paz	paz	noun	Duolingo
pc	pc	noun	Duolingo
pecho	pecho	noun	Duolingo
pedí	pedi	verb	Duolingo
pedido	pedido	noun	Duolingo
pedimos	pedimos	verb	Duolingo
pedir	pedir		Duolingo
pedir	pedir	verb	Duolingo
pedir prestado	pedir prestado		Duolingo
pedirlo	pedirlo		Duolingo
pediste	pediste	verb	Duolingo
película	pelicula	noun	Duolingo
películas	peliculas	noun	Duolingo
peligro	peligro	noun	Duolingo
pelo	pelo	noun	Duolingo
pena	pena	noun	Duolingo
pendiente	pendiente	adjective	Duolingo
pensaba	pensaba	verb	Duolingo
pensamiento	pensamiento	noun	Duolingo
pensamos	pensamos	verb	Duolingo
pensando	pensando	verb	Duolingo
pensar	pensar	verb	Duolingo
pensaron	pensaron	verb	Duolingo
pensaste	pensaste	verb	Duolingo
pensé	pense	verb	Duolingo
pensó	penso	verb	Duolingo
peor	peor	adjective	Duolingo
peores	peores	adjective	Duolingo
pequeña	pequena	adjective	Duolingo
pequeñas	pequenas	adjective	Duolingo
pequeñito	pequenito	adjective	Duolingo
pequeñitos	pequenitos	adjective	Duolingo
pequeño	pequeno	adjective	Duolingo
pequeños	pequenos	adjective	Duolingo
pera	pera	noun	Duolingo
perdemos	perdemos	verb	Duolingo
perder	perder		Duolingo
perder	perder	verb	Duolingo
perderte	perderte	pronoun	Duolingo
perdí	perdi	verb	Duolingo
perdida	perdida	adjective	Duolingo
pérdida	perdida	noun	Duolingo
perdidas	perdidas	adjective	Duolingo
perdido	perdido	adjective	Duolingo
perdidos	perdidos	adjective	Duolingo
perdieron	perdieron	verb	Duolingo
perdió	perdio	verb	Duolingo
perdón	perdon	noun	Duolingo
perdona	perdona	verb	Duolingo
perdone	perdone	verb	Duolingo
perezosa	perezosa	adjective	Duolingo
perezosas	perezosas	adjective	Duolingo
perezosos	perezosos	adjective	Duolingo
perfecta	perfecta	adjective	Duolingo
perfectamente	perfectamente	adverb	Duolingo
perfecto	perfecto		Duolingo
perfecto	perfecto	adjective	Duolingo
perfil	perfil	noun	Duolingo
perfumes	perfumes	noun	Duolingo
periódico	periodico	noun	Duolingo
periódicos	periodicos	noun	Duolingo
periodismo	periodismo	noun	Duolingo
periodista	periodista	noun	Duolingo
periodistas	periodistas	noun	Duolingo
permanente	permanente	adverb	Duolingo
permiso	permiso	noun	Duolingo
permite	permite	verb	Duolingo
permiten	permiten	verb	Duolingo
permití	permiti	verb	Duolingo
permitió	permitio	verb	Duolingo
permitir	permitir	verb	Duolingo
permito	permito	verb	Duolingo
pero	pero		Duolingo
pero	pero	conjunction	Duolingo
perrito	perrito	noun	Duolingo
perro	perro		Duolingo
perro	perro	noun	Duolingo
perros	perros	noun	Duolingo
persona	persona	noun	Duolingo
personajes	personajes	noun	Duolingo
personal	personal	adjective	Duolingo
personal	personal	noun	Duolingo
personales	personales	adjective	Duolingo
personalidad	personalidad	noun	Duolingo
personalmente	personalmente	adverb	Duolingo
personas	personas		Duolingo
personas	personas	noun	Duolingo
perspectiva	perspectiva	noun	Duolingo
pertenece	pertenece	verb	Duolingo
pertenecer	pertenecer	verb	Duolingo
pertenezco	pertenezco	verb	Duolingo
pesa	pesa	verb	Duolingo
pesadas	pesadas	adjective	Duolingo
pesados	pesados	adjective	Duolingo
pesar	pesar	verb	Duolingo
pesca	pesca	noun	Duolingo
pescaba	pescaba	verb	Duolingo
pescaban	pescaban	verb	Duolingo
pescado	pescado		Duolingo
pescado	pescado	noun	Duolingo
pescados	pescados	noun	Duolingo
pescar	pescar	verb	Duolingo
pescaron	pescaron	verb	Duolingo
pescó	pesco	verb	Duolingo
peso	peso	verb	Duolingo
pesos	pesos	noun	Duolingo
pesqué	pesque	verb	Duolingo
petición	peticion	noun	Duolingo
picando	picando	verb	Duolingo
picante	picante	noun	Duolingo
picantes	picantes	noun	Duolingo
picar	picar	verb	Duolingo
pide	pide	verb	Duolingo
pidiendo	pidiendo	adverb	Duolingo
pidieron	pidieron	verb	Duolingo
pidió	pidio	verb	Duolingo
pido	pido	verb	Duolingo
pie	pie	noun	Duolingo
piedra	piedra	noun	Duolingo
piedras	piedras	noun	Duolingo
piel	piel	noun	Duolingo
piensa	piensa	verb	Duolingo
piensas	piensas	verb	Duolingo
pienso	pienso	verb	Duolingo
pienso que deberías	pienso que deberias		Duolingo
pierden	pierden	verb	Duolingo
pierdes	pierdes	verb	Duolingo
pierna	pierna	noun	Duolingo
piernas	piernas	noun	Duolingo
pies	pies	noun	Duolingo
pieza	pieza	noun	Duolingo
piezas	piezas	noun	Duolingo
pijama	pijama	noun	Duolingo
pijamas	pijamas	noun	Duolingo
pimienta	pimienta	noun	Duolingo
pingüino	pinguino	noun	Duolingo
pingüinos	pinguinos	noun	Duolingo
pintada	pintada	adjective	Duolingo
pintadas	pintadas	adjective	Duolingo
pintados	pintados	adjective	Duolingo
pintan	pintan	verb	Duolingo
pintar	pintar		Duolingo
pintar	pintar	verb	Duolingo
pintaste	pintaste	verb	Duolingo
pinté	pinte	verb	Duolingo
pinto	pinto	verb	Duolingo
pintor	pintor	noun	Duolingo
pintora	pintora	noun	Duolingo
pintoras	pintoras	noun	Duolingo
pintura	pintura	noun	Duolingo
pinturas	pinturas	noun	Duolingo
piscina	piscina	noun	Duolingo
piscinas	piscinas	noun	Duolingo
piso	piso	noun	Duolingo
pisos	pisos	noun	Duolingo
pista	pista	noun	Duolingo
pizarra	pizarra	noun	Duolingo
pizarras	pizarras	noun	Duolingo
pizza	pizza	noun	Duolingo
placer	placer	noun	Duolingo
plan	plan	noun	Duolingo
planea	planea	verb	Duolingo
planeamos	planeamos	verb	Duolingo
planean	planean	verb	Duolingo
planeas	planeas	verb	Duolingo
planeo	planeo	verb	Duolingo
planes	planes	noun	Duolingo
planeta	planeta	noun	Duolingo
plano	plano	adjective	Duolingo
planta	planta	noun	Duolingo
plantas	plantas	noun	Duolingo
plástico	plastico	noun	Duolingo
plata	plata	noun	Duolingo
plátanos	platanos	noun	Duolingo
plato	plato	noun	Duolingo
platos	platos	noun	Duolingo
playa	playa	noun	Duolingo
plaza	plaza	noun	Duolingo
plomero	plomero	noun	Duolingo
plomeros	plomeros	noun	Duolingo
pluma	pluma	noun	Duolingo
población	poblacion	noun	Duolingo
pobre	pobre	adjective	Duolingo
pobres	pobres	adjective	Duolingo
pobreza	pobreza	noun	Duolingo
poca	poca	determiner	Duolingo
pocas	pocas	determiner	Duolingo
poco	poco	adverb	Duolingo
poco	poco	determiner	Duolingo
poco a poco	poco a poco		Duolingo
poco después	poco despues		Duolingo
pocos	pocos	determiner	Duolingo
podemos	podemos	verb	Duolingo
poder	poder	verb	Duolingo
podía	podia	verb	Duolingo
podían	podian	verb	Duolingo
podrá	podra	verb	Duolingo
podrán	podran	verb	Duolingo
podrás	podras	verb	Duolingo
podré	podre	verb	Duolingo
podremos	podremos	verb	Duolingo
podría	podria	verb	Duolingo
podría ser	podria ser		Duolingo
podríamos	podriamos	verb	Duolingo
podrían	podrian	verb	Duolingo
poema	poema	noun	Duolingo
poesía	poesia	noun	Duolingo
poeta	poeta	noun	Duolingo
policía	policia	noun	Duolingo
policías	policias	noun	Duolingo
política	politica	noun	Duolingo
político	politico	noun	Duolingo
políticos	politicos	noun	Duolingo
pollo	pollo	noun	Duolingo
polvo	polvo	noun	Duolingo
pon	pon	verb	Duolingo
pondrás	pondras	verb	Duolingo
pondré	pondre	verb	Duolingo
pone	pone	verb	Duolingo
ponen	ponen	verb	Duolingo
poner	poner	verb	Duolingo
ponerme	ponerme	pronoun	Duolingo
ponerse	ponerse	pronoun	Duolingo
ponerte	ponerte	pronoun	Duolingo
ponga	ponga	verb	Duolingo
pongan	pongan	verb	Duolingo
pongas	pongas	verb	Duolingo
pongo	pongo	verb	Duolingo
poniendo	poniendo	verb	Duolingo
poniéndola	poniendola	pronoun	Duolingo
pop	pop	noun	Duolingo
popular	popular	adjective	Duolingo
populares	populares	adjective	Duolingo
poquito	poquito	adjective	Duolingo
por	por	preposition	Duolingo
por adelantado	por adelantado		Duolingo
por ahora	por ahora		Duolingo
por amor	por amor		Duolingo
por anticipado	por anticipado		Duolingo
por ciento	por ciento		Duolingo
por cierto	por cierto		Duolingo
por completo	por completo	adverb	Duolingo
por dentro	por dentro		Duolingo
por dónde	por donde		Duolingo
por el momento	por el momento		Duolingo
por eso	por eso		Duolingo
por favor	por favor		Duolingo
por favor	por favor	interjection	Duolingo
por fin	por fin		Duolingo
por fuera	por fuera		Duolingo
por lo general	por lo general		Duolingo
por lo menos	por lo menos		Duolingo
por lo que veo	por lo que veo		Duolingo
por lo tanto	por lo tanto		Duolingo
por lo visto	por lo visto		Duolingo
por nada	por nada		Duolingo
por otro lado	por otro lado		Duolingo
por qué	por que		Duolingo
por si acaso	por si acaso		Duolingo
por suerte	por suerte		Duolingo
por supuesto	por supuesto		Duolingo
por todas partes	por todas partes		Duolingo
por último	por ultimo		Duolingo
por un lado	por un lado		Duolingo
porcentaje	porcentaje	noun	Duolingo
porque	porque	conjunction	Duolingo
portátil	portatil	adjective	Duolingo
portugués	portugues	noun	Duolingo
portugueses	portugueses	adjective	Duolingo
posee	posee	verb	Duolingo
posibilidad	posibilidad	noun	Duolingo
posibilidades	posibilidades	noun	Duolingo
posible	posible	adjective	Duolingo
posiblemente	posiblemente	adverb	Duolingo
posición	posicion	noun	Duolingo
positiva	positiva	adjective	Duolingo
positivo	positivo	adjective	Duolingo
postal	postal	adjective	Duolingo
postal	postal	noun	Duolingo
postales	postales	noun	Duolingo
póster	poster	noun	Duolingo
pósteres	posteres	noun	Duolingo
postre	postre	noun	Duolingo
postres	postres	noun	Duolingo
práctica	practica	noun	Duolingo
prácticamente	practicamente	adverb	Duolingo
practicamos	practicamos	verb	Duolingo
practicar	practicar	verb	Duolingo
practicaste	practicaste	verb	Duolingo
practicó	practico	verb	Duolingo
practiqué	practique	verb	Duolingo
precio	precio	noun	Duolingo
precios	precios	noun	Duolingo
prefería	preferia	verb	Duolingo
preferían	preferian	verb	Duolingo
preferida	preferida	verb	Duolingo
preferido	preferido	verb	Duolingo
preferimos	preferimos	verb	Duolingo
preferir	preferir	verb	Duolingo
prefieren	prefieren	verb	Duolingo
pregunta	pregunta		Duolingo
pregunta	pregunta	noun	Duolingo
pregunta	pregunta	verb	Duolingo
preguntamos	preguntamos	verb	Duolingo
preguntar	preguntar	verb	Duolingo
preguntaron	preguntaron	verb	Duolingo
preguntas	preguntas	noun	Duolingo
preguntas	preguntas	verb	Duolingo
pregunté	pregunte	verb	Duolingo
preguntó	pregunto	verb	Duolingo
premio	premio	noun	Duolingo
premios	premios	noun	Duolingo
prensa	prensa	noun	Duolingo
preocupación	preocupacion	noun	Duolingo
preocupaciones	preocupaciones	noun	Duolingo
preocupadas	preocupadas	adjective	Duolingo
preocupados	preocupados	adjective	Duolingo
preocuparme	preocuparme	pronoun	Duolingo
preocuparnos	preocuparnos	pronoun	Duolingo
preocuparse	preocuparse	pronoun	Duolingo
preocuparte	preocuparte	pronoun	Duolingo
prepara	prepara	verb	Duolingo
preparar	preparar	verb	Duolingo
prepararlo	prepararlo	pronoun	Duolingo
prepararlos	prepararlos	pronoun	Duolingo
prepare	prepare	verb	Duolingo
preparó	preparo	verb	Duolingo
presencia	presencia	noun	Duolingo
presenta	presenta	verb	Duolingo
presentación	presentacion	noun	Duolingo
presentamos	presentamos	verb	Duolingo
presentan	presentan	verb	Duolingo
presentar	presentar	verb	Duolingo
presente	presente	adjective	Duolingo
presente	presente	noun	Duolingo
presentes	presentes	adjective	Duolingo
presento	presento	verb	Duolingo
presidenta	presidenta	noun	Duolingo
presidente	presidente	noun	Duolingo
presidentes	presidentes	noun	Duolingo
préstame	prestame		Duolingo
prestar	prestar	verb	Duolingo
prestaste	prestaste	verb	Duolingo
presto	presto	verb	Duolingo
presupuesto	presupuesto	noun	Duolingo
presupuestos	presupuestos	noun	Duolingo
previa	previa	adjective	Duolingo
previamente	previamente	adverb	Duolingo
prima	prima	noun	Duolingo
primas	primas	noun	Duolingo
primavera	primavera	noun	Duolingo
primer	primer	adjective	Duolingo
primer	primer	determiner	Duolingo
primera	primera	adjective	Duolingo
primeras	primeras	adjective	Duolingo
primero	primero	adjective	Duolingo
primero	primero	adverb	Duolingo
primeros	primeros	adjective	Duolingo
primeros auxilios	primeros auxilios		Duolingo
primo	primo	noun	Duolingo
primos	primos	noun	Duolingo
principal	principal	adjective	Duolingo
principales	principales	adjective	Duolingo
principalmente	principalmente	adverb	Duolingo
príncipe	principe	noun	Duolingo
principio	principio	noun	Duolingo
principios	principios	noun	Duolingo
privada	privada	adjective	Duolingo
privadas	privadas	adjective	Duolingo
privado	privado	adjective	Duolingo
probable	probable	adjective	Duolingo
probablemente	probablemente	adverb	Duolingo
probador	probador	noun	Duolingo
probadores	probadores	noun	Duolingo
probamos	probamos	verb	Duolingo
probar	probar	verb	Duolingo
probaron	probaron	verb	Duolingo
probarse	probarse	pronoun	Duolingo
probarte	probarte	pronoun	Duolingo
probaste	probaste	verb	Duolingo
probé	probe	verb	Duolingo
problema	problema		Duolingo
problema	problema	noun	Duolingo
problemas	problemas	noun	Duolingo
procedimiento	procedimiento	noun	Duolingo
procedimientos	procedimientos	noun	Duolingo
proceso	proceso	noun	Duolingo
producción	produccion	noun	Duolingo
producir	producir	verb	Duolingo
producto	producto	noun	Duolingo
productos	productos	noun	Duolingo
profesión	profesion	noun	Duolingo
profesional	profesional	adjective	Duolingo
profesionales	profesionales	adjective	Duolingo
profesor	profesor		Duolingo
profesor	profesor	noun	Duolingo
profesora	profesora	noun	Duolingo
profesoras	profesoras	noun	Duolingo
profesores	profesores	noun	Duolingo
profunda	profunda	adjective	Duolingo
profundidad	profundidad	noun	Duolingo
profundo	profundo	adjective	Duolingo
programa	programa	noun	Duolingo
progreso	progreso	noun	Duolingo
progresos	progresos	noun	Duolingo
promedio	promedio	noun	Duolingo
promoción	promocion	noun	Duolingo
promociones	promociones	noun	Duolingo
pronto	pronto	adverb	Duolingo
propias	propias	adjective	Duolingo
propiedad	propiedad	noun	Duolingo
propiedades	propiedades	noun	Duolingo
propina	propina	noun	Duolingo
propio	propio	adjective	Duolingo
propios	propios	adjective	Duolingo
proporción	proporcion	noun	Duolingo
propósito	proposito	noun	Duolingo
propuesta	propuesta	noun	Duolingo
propuestas	propuestas	noun	Duolingo
protagonistas	protagonistas	adjective	Duolingo
protección	proteccion	noun	Duolingo
proteínas	proteinas	noun	Duolingo
próxima	proxima	adjective	Duolingo
próximamente	proximamente	adverb	Duolingo
próximas	proximas	adjective	Duolingo
próximo	proximo	adjective	Duolingo
proyecto	proyecto	noun	Duolingo
prueba	prueba	verb	Duolingo
prueban	prueban	verb	Duolingo
pruebas	pruebas	verb	Duolingo
pruebe	pruebe	verb	Duolingo
pruebo	pruebo	verb	Duolingo
pública	publica	adjective	Duolingo
publicación	publicacion	noun	Duolingo
publicaciones	publicaciones	noun	Duolingo
publicadas	publicadas	verb	Duolingo
publicado	publicado	verb	Duolingo
publicidad	publicidad	noun	Duolingo
publicidades	publicidades	noun	Duolingo
público	publico	adjective	Duolingo
público	publico	noun	Duolingo
públicos	publicos	adjective	Duolingo
pude	pude	verb	Duolingo
pudiera	pudiera	verb	Duolingo
pudiéramos	pudieramos	verb	Duolingo
pudieron	pudieron	verb	Duolingo
pudimos	pudimos	verb	Duolingo
pudiste	pudiste	verb	Duolingo
pudo	pudo	verb	Duolingo
pueblo	pueblo	noun	Duolingo
pueblos	pueblos	noun	Duolingo
puede	puede	verb	Duolingo
puede que	puede que		Duolingo
puede ser	puede ser		Duolingo
puede traer	puede traer		Duolingo
pueden	pueden	verb	Duolingo
puedes	puedes	verb	Duolingo
puedo	puedo	verb	Duolingo
puente	puente	noun	Duolingo
puerta	puerta	noun	Duolingo
puertas	puertas	noun	Duolingo
puerto	puerto	noun	Duolingo
puesta	puesta	verb	Duolingo
puestas	puestas	adjective	Duolingo
puesto	puesto	adjective	Duolingo
puesto	puesto	noun	Duolingo
puestos	puestos	noun	Duolingo
punto	punto	noun	Duolingo
puntos	puntos	noun	Duolingo
puntualmente	puntualmente	adverb	Duolingo
pura	pura	adjective	Duolingo
puro	puro	adjective	Duolingo
puros	puros	adjective	Duolingo
puse	puse	verb	Duolingo
pusieron	pusieron	verb	Duolingo
pusimos	pusimos	verb	Duolingo
pusiste	pusiste	verb	Duolingo
puso	puso	verb	Duolingo
qué	que		Duolingo
que	que	adverb	Duolingo
que	que	conjunction	Duolingo
qué	que	determiner	Duolingo
que	que	pronoun	Duolingo
qué alivio	que alivio		Duolingo
qué bien	que bien		Duolingo
qué bien que	que bien que		Duolingo
qué divertido	que divertido		Duolingo
qué elegante	que elegante		Duolingo
que escribir	que escribir		Duolingo
que estudiar	que estudiar		Duolingo
qué hacemos	que hacemos		Duolingo
que hacer	que hacer		Duolingo
qué horror	que horror		Duolingo
qué interesante	que interesante		Duolingo
qué interesante que	que interesante que		Duolingo
qué le gustaría para empezar	que le gustaria para empezar		Duolingo
qué le parece	que le parece		Duolingo
qué le traigo	que le traigo		Duolingo
que leer	que leer		Duolingo
qué mal	que mal		Duolingo
qué mala suerte	que mala suerte		Duolingo
qué raro	que raro		Duolingo
qué raro que	que raro que		Duolingo
qué tal	que tal		Duolingo
qué tal si	que tal si		Duolingo
qué tan	que tan		Duolingo
qué te parece	que te parece		Duolingo
qué te traigo	que te traigo		Duolingo
qué tiempo hace	que tiempo hace		Duolingo
que viene	que viene		Duolingo
que yo sepa	que yo sepa		Duolingo
queda	queda	verb	Duolingo
quedaba	quedaba	verb	Duolingo
quedan	quedan	verb	Duolingo
quedar	quedar	verb	Duolingo
quedará	quedara	verb	Duolingo
quedarás	quedaras	verb	Duolingo
quedaré	quedare	verb	Duolingo
quedaremos	quedaremos	verb	Duolingo
quedarme	quedarme	pronoun	Duolingo
quedarme con	quedarme con		Duolingo
quedarnos	quedarnos	pronoun	Duolingo
quedaron	quedaron	verb	Duolingo
quedarse	quedarse	pronoun	Duolingo
quedarse con	quedarse con		Duolingo
quedarte con	quedarte con		Duolingo
quedaste	quedaste	verb	Duolingo
quedé	quede	verb	Duolingo
quedó	quedo	verb	Duolingo
queremos	queremos	verb	Duolingo
queremos abrir	queremos abrir		Duolingo
querer	querer	verb	Duolingo
quería	queria	verb	Duolingo
quería decir	queria decir		Duolingo
querrá	querra	verb	Duolingo
querrán	querran	verb	Duolingo
querrás	querras	verb	Duolingo
querré	querre	verb	Duolingo
querremos	querremos	verb	Duolingo
querría	querria	verb	Duolingo
queso	queso		Duolingo
queso	queso	noun	Duolingo
quesos	quesos	noun	Duolingo
quién	quien	pronoun	Duolingo
quiénes	quienes	pronoun	Duolingo
quiera	quiera	verb	Duolingo
quieras	quieras	verb	Duolingo
quiere	quiere	verb	Duolingo
quiere aprender	quiere aprender		Duolingo
quiere decir	quiere decir		Duolingo
quiere dibujar	quiere dibujar		Duolingo
quieren	quieren	verb	Duolingo
quieren beber	quieren beber		Duolingo
quieres	quieres	verb	Duolingo
quieres decir	quieres decir		Duolingo
quiero	quiero		Duolingo
quiero	quiero	verb	Duolingo
quiero aprender	quiero aprender		Duolingo
quiero beber	quiero beber		Duolingo
química	quimica	adjective	Duolingo
química	quimica	noun	Duolingo
quince	quince	numeral	Duolingo
quinientos	quinientos	numeral	Duolingo
quiosco	quiosco	noun	Duolingo
quise	quise	verb	Duolingo
quisiera	quisiera	verb	Duolingo
quisiéramos	quisieramos	verb	Duolingo
quisieras	quisieras	verb	Duolingo
quisieron	quisieron	verb	Duolingo
quisimos	quisimos	verb	Duolingo
quisiste	quisiste	verb	Duolingo
quiso	quiso	verb	Duolingo
quitarnos	quitarnos	pronoun	Duolingo
quitarte	quitarte	pronoun	Duolingo
quizá	quiza	adverb	Duolingo
quizás	quizas	adverb	Duolingo
radio	radio	noun	Duolingo
raíces	raices	noun	Duolingo
raíz	raiz	noun	Duolingo
ramadán	ramadan	noun	Duolingo
rap	rap	noun	Duolingo
rápidamente	rapidamente	adverb	Duolingo
rápido	rapido	adjective	Duolingo
rápido	rapido	adverb	Duolingo
rápidos	rapidos	adjective	Duolingo
rasuradora	rasuradora	noun	Duolingo
rata	rata	noun	Duolingo
ratas	ratas	noun	Duolingo
rato	rato	noun	Duolingo
ratón	raton	noun	Duolingo
ratones	ratones	noun	Duolingo
razón	razon	noun	Duolingo
razones	razones	noun	Duolingo
reacciones	reacciones	noun	Duolingo
real	real	adjective	Duolingo
reales	reales	adjective	Duolingo
realidad	realidad	noun	Duolingo
realizar	realizar	verb	Duolingo
realmente	realmente	adverb	Duolingo
rebanada	rebanada	noun	Duolingo
rebanadas	rebanadas	noun	Duolingo
recepcionista	recepcionista	noun	Duolingo
receta	receta	noun	Duolingo
rechazan	rechazan	verb	Duolingo
rechazo	rechazo	verb	Duolingo
recibe	recibe	verb	Duolingo
recibían	recibian	verb	Duolingo
recibías	recibias	verb	Duolingo
recibido	recibido	verb	Duolingo
recibimos	recibimos	verb	Duolingo
recibió	recibio	verb	Duolingo
recibir	recibir	verb	Duolingo
recibirán	recibiran	verb	Duolingo
recibirás	recibiras	verb	Duolingo
recibiremos	recibiremos	verb	Duolingo
recibo	recibo	noun	Duolingo
recibos	recibos	noun	Duolingo
reciclaje	reciclaje	noun	Duolingo
recién	recien	adverb	Duolingo
reciente	reciente	adjective	Duolingo
recientemente	recientemente	adverb	Duolingo
recientes	recientes	adjective	Duolingo
recomendable	recomendable	adjective	Duolingo
reconoce	reconoce	verb	Duolingo
reconocer	reconocer	verb	Duolingo
reconoces	reconoces	verb	Duolingo
recordamos	recordamos	verb	Duolingo
recordar	recordar	verb	Duolingo
recordaron	recordaron	verb	Duolingo
recordé	recorde	verb	Duolingo
recordó	recordo	verb	Duolingo
rectas	rectas	adjective	Duolingo
recuerda	recuerda	verb	Duolingo
recuerdan	recuerdan	verb	Duolingo
recuerdas	recuerdas	verb	Duolingo
recuerdo	recuerdo	verb	Duolingo
recuperar	recuperar	verb	Duolingo
recurso	recurso	noun	Duolingo
recursos	recursos	noun	Duolingo
recursos humanos	recursos humanos		Duolingo
red	red	noun	Duolingo
redonda	redonda	adjective	Duolingo
redondo	redondo	adjective	Duolingo
reducir	reducir	verb	Duolingo
reencarnación	reencarnacion	noun	Duolingo
reflexión	reflexion	noun	Duolingo
reflexiones	reflexiones	noun	Duolingo
refrescos	refrescos	noun	Duolingo
refrigerador	refrigerador	noun	Duolingo
refrigeradores	refrigeradores	noun	Duolingo
regalo	regalo		Duolingo
regaló	regalo	verb	Duolingo
región	region	noun	Duolingo
regiones	regiones	noun	Duolingo
regla	regla	noun	Duolingo
reglas	reglas	noun	Duolingo
regresamos	regresamos	verb	Duolingo
regresar	regresar	verb	Duolingo
regresas	regresas	verb	Duolingo
regrese	regrese	verb	Duolingo
regreso	regreso	verb	Duolingo
regular	regular	adjective	Duolingo
reina	reina	noun	Duolingo
reinas	reinas	noun	Duolingo
reino unido	reino unido		Duolingo
reírnos	reirnos	pronoun	Duolingo
relación	relacion	noun	Duolingo
relajación	relajacion	noun	Duolingo
relativamente	relativamente	adverb	Duolingo
religión	religion	noun	Duolingo
religiosa	religiosa	adjective	Duolingo
religioso	religioso	adjective	Duolingo
religiosos	religiosos	adjective	Duolingo
reloj	reloj		Duolingo
reloj	reloj	noun	Duolingo
relojes	relojes	noun	Duolingo
remedio	remedio	noun	Duolingo
reparaba	reparaba	verb	Duolingo
reparar	reparar	verb	Duolingo
repare	repare	verb	Duolingo
reparó	reparo	verb	Duolingo
repetimos	repetimos	verb	Duolingo
repetir	repetir	verb	Duolingo
repite	repite	verb	Duolingo
repiten	repiten	verb	Duolingo
repitiendo	repitiendo	verb	Duolingo
reportajes	reportajes	noun	Duolingo
reprobó	reprobo	verb	Duolingo
repruebas	repruebas	verb	Duolingo
repruebo	repruebo	verb	Duolingo
república	republica	noun	Duolingo
republicano	republicano	adjective	Duolingo
republicanos	republicanos	adjective	Duolingo
requiere	requiere	verb	Duolingo
reserva	reserva		Duolingo
reserva	reserva	verb	Duolingo
reservan	reservan	verb	Duolingo
reservará	reservara	verb	Duolingo
reservarán	reservaran	verb	Duolingo
reservaron	reservaron	verb	Duolingo
reservas	reservas	verb	Duolingo
reservaste	reservaste	verb	Duolingo
reserve	reserve	verb	Duolingo
reservo	reservo	verb	Duolingo
resolver	resolver	verb	Duolingo
respeta	respeta	verb	Duolingo
respetan	respetan	verb	Duolingo
respeto	respeto	verb	Duolingo
responde	responde	verb	Duolingo
responden	responden	verb	Duolingo
responder	responder	verb	Duolingo
respondes	respondes	verb	Duolingo
respondimos	respondimos	verb	Duolingo
respondió	respondio	verb	Duolingo
respondo	respondo	verb	Duolingo
responsabilidad	responsabilidad	noun	Duolingo
responsabilidades	responsabilidades	noun	Duolingo
responsable	responsable	adjective	Duolingo
responsables	responsables	adjective	Duolingo
respuesta	respuesta	noun	Duolingo
respuestas	respuestas	noun	Duolingo
restaurante	restaurante		Duolingo
restaurante	restaurante	noun	Duolingo
restaurantes	restaurantes	noun	Duolingo
resto	resto	noun	Duolingo
resultado	resultado	noun	Duolingo
resultados	resultados	noun	Duolingo
retrasamos	retrasamos	verb	Duolingo
retrasaste	retrasaste	verb	Duolingo
retrasó	retraso	verb	Duolingo
reunión	reunion	noun	Duolingo
reuniones	reuniones	noun	Duolingo
revisión	revision	noun	Duolingo
revista	revista	noun	Duolingo
revistas	revistas	noun	Duolingo
revolución	revolucion	noun	Duolingo
revolucionario	revolucionario	adjective	Duolingo
rey	rey	noun	Duolingo
reyes	reyes	noun	Duolingo
rezábamos	rezabamos	verb	Duolingo
rezaban	rezaban	verb	Duolingo
rezar	rezar	verb	Duolingo
rica	rica	adjective	Duolingo
ricas	ricas	adjective	Duolingo
rico	rico	adjective	Duolingo
ricos	ricos	adjective	Duolingo
río	rio	noun	Duolingo
ríos	rios	noun	Duolingo
ritmo	ritmo	noun	Duolingo
rival	rival	noun	Duolingo
rock	rock	noun	Duolingo
rodilla	rodilla	noun	Duolingo
rodillas	rodillas	noun	Duolingo
roja	roja	adjective	Duolingo
rojas	rojas	adjective	Duolingo
rojo	rojo		Duolingo
rojo	rojo	adjective	Duolingo
rojos	rojos	adjective	Duolingo
roma	roma	proper noun	Duolingo
romance	romance	noun	Duolingo
romántica	romantica	adjective	Duolingo
romántico	romantico	adjective	Duolingo
románticos	romanticos	adjective	Duolingo
rompecabezas	rompecabezas	noun	Duolingo
romper	romper	verb	Duolingo
rompí	rompi	verb	Duolingo
rompiste	rompiste	verb	Duolingo
ropa	ropa		Duolingo
ropa	ropa	noun	Duolingo
ropa interior	ropa interior		Duolingo
rosa	rosa	adjective	Duolingo
rosa	rosa	noun	Duolingo
rosadas	rosadas	adjective	Duolingo
rosas	rosas	noun	Duolingo
rota	rota	verb	Duolingo
rotas	rotas	verb	Duolingo
rubias	rubias	adjective	Duolingo
rubios	rubios	adjective	Duolingo
rueda	rueda	noun	Duolingo
ruedas	ruedas	noun	Duolingo
rugby	rugby	noun	Duolingo
ruido	ruido	noun	Duolingo
ruidosa	ruidosa	adjective	Duolingo
rumbo	rumbo	noun	Duolingo
rumbos	rumbos	noun	Duolingo
ruta	ruta	noun	Duolingo
rutas	rutas	noun	Duolingo
rutina	rutina	noun	Duolingo
sábado	sabado	noun	Duolingo
sábados	sabados	noun	Duolingo
sábana	sabana	noun	Duolingo
sábanas	sabanas	noun	Duolingo
sabe	sabe	verb	Duolingo
sabe usted	sabe usted		Duolingo
sabemos	sabemos	verb	Duolingo
sabemos dónde	sabemos donde		Duolingo
saben	saben	verb	Duolingo
saber	saber	verb	Duolingo
sabes	sabes	verb	Duolingo
sabes cuándo	sabes cuando		Duolingo
sabes nadar	sabes nadar		Duolingo
sabes quién	sabes quien		Duolingo
sabía	sabia	verb	Duolingo
sabían	sabian	verb	Duolingo
sabías	sabias	verb	Duolingo
sabor	sabor	noun	Duolingo
sabrán	sabran	verb	Duolingo
sabré	sabre	verb	Duolingo
sabrías	sabrias	verb	Duolingo
sacacorchos	sacacorchos	noun	Duolingo
sacerdote	sacerdote	noun	Duolingo
sacerdotes	sacerdotes	noun	Duolingo
sacó	saco	verb	Duolingo
sal	sal		Duolingo
sal	sal	noun	Duolingo
sal	sal	verb	Duolingo
sala	sala	noun	Duolingo
salas	salas	noun	Duolingo
salchicha	salchicha	noun	Duolingo
salchichas	salchichas	noun	Duolingo
saldrá	saldra	verb	Duolingo
saldremos	saldremos	verb	Duolingo
sale	sale	verb	Duolingo
salen	salen	verb	Duolingo
sales	sales	verb	Duolingo
salga	salga	verb	Duolingo
salgan	salgan	verb	Duolingo
salgas	salgas	verb	Duolingo
salgo	salgo	verb	Duolingo
salí	sali	verb	Duolingo
salida	salida	noun	Duolingo
salida de emergencia	salida de emergencia		Duolingo
saliendo	saliendo	verb	Duolingo
salieron	salieron	verb	Duolingo
salimos	salimos	verb	Duolingo
salió	salio	verb	Duolingo
salir	salir	verb	Duolingo
salir a	salir a		Duolingo
saliste	saliste	verb	Duolingo
salón	salon	noun	Duolingo
salsa	salsa	noun	Duolingo
salta	salta	verb	Duolingo
saltamos	saltamos	verb	Duolingo
salto	salto	verb	Duolingo
salud	salud	noun	Duolingo
saludable	saludable	adjective	Duolingo
saludos	saludos		Duolingo
saludos	saludos	noun	Duolingo
salva	salva	verb	Duolingo
salvajes	salvajes	adjective	Duolingo
salvamos	salvamos	verb	Duolingo
salvo	salvo	verb	Duolingo
salvo que	salvo que		Duolingo
sándwich	sandwich		Duolingo
sándwich	sandwich	noun	Duolingo
sándwiches	sandwiches	noun	Duolingo
sangre	sangre	noun	Duolingo
santa	santa	adjective	Duolingo
santo	santo	adjective	Duolingo
sartén	sarten	noun	Duolingo
sartenes	sartenes	noun	Duolingo
satisfacción	satisfaccion	noun	Duolingo
satisfecho	satisfecho	adjective	Duolingo
satisfechos	satisfechos	adjective	Duolingo
se	se		Duolingo
se	se	pronoun	Duolingo
sé	se	verb	Duolingo
se abrazan	se abrazan		Duolingo
se abrazaron	se abrazaron		Duolingo
se acordó	se acordo		Duolingo
se acostaban	se acostaban		Duolingo
se acuerda	se acuerda		Duolingo
se acuerdan	se acuerdan		Duolingo
se acuestan	se acuestan		Duolingo
se almuerza	se almuerza		Duolingo
se amaban	se amaban		Duolingo
se amaron	se amaron		Duolingo
se ayudan	se ayudan		Duolingo
se ayudaron	se ayudaron		Duolingo
se cae	se cae		Duolingo
se caen	se caen		Duolingo
se casan	se casan		Duolingo
se casó	se caso		Duolingo
se celebra	se celebra		Duolingo
se celebran	se celebran		Duolingo
se cepilla	se cepilla		Duolingo
se cepillan	se cepillan		Duolingo
se cepillaron	se cepillaron		Duolingo
se cepilló	se cepillo		Duolingo
se come	se come		Duolingo
se comunica	se comunica		Duolingo
se comunicaron	se comunicaron		Duolingo
se comunicó	se comunico		Duolingo
se conocen	se conocen		Duolingo
se cree	se cree		Duolingo
sé cuándo	se cuando		Duolingo
se desayuna	se desayuna		Duolingo
se despierta	se despierta		Duolingo
se dice	se dice		Duolingo
se divierte	se divierte		Duolingo
se ducha	se ducha		Duolingo
se duchan	se duchan		Duolingo
se ducharon	se ducharon		Duolingo
se encuentra	se encuentra		Duolingo
se escondieron	se escondieron		Duolingo
se escriben	se escriben		Duolingo
se está realizando	se esta realizando		Duolingo
se habla	se habla		Duolingo
se hacen	se hacen		Duolingo
se han vendido	se han vendido		Duolingo
se la	se la		Duolingo
se las	se las		Duolingo
se lavan	se lavan		Duolingo
se lavaron	se lavaron		Duolingo
se levanta	se levanta		Duolingo
se levantan	se levantan		Duolingo
se llama	se llama		Duolingo
se llamaba	se llamaba		Duolingo
se llamaban	se llamaban		Duolingo
se llaman	se llaman		Duolingo
se llamará	se llamara		Duolingo
se llamarán	se llamaran		Duolingo
se lleva bien	se lleva bien		Duolingo
se llevan bien	se llevan bien		Duolingo
se llevó bien	se llevo bien		Duolingo
se los	se los		Duolingo
se necesitan	se necesitan		Duolingo
se nota	se nota		Duolingo
se odiaron	se odiaron		Duolingo
se ofrecen	se ofrecen		Duolingo
se paga	se paga		Duolingo
se pone	se pone		Duolingo
se ponen	se ponen		Duolingo
se preocupaban	se preocupaban		Duolingo
se preocupan	se preocupan		Duolingo
se preocupe	se preocupe		Duolingo
se preocupó	se preocupo		Duolingo
se probaron	se probaron		Duolingo
se probó	se probo		Duolingo
se puede	se puede		Duolingo
se puede cenar	se puede cenar		Duolingo
se puede ir	se puede ir		Duolingo
se puso	se puso		Duolingo
se queda	se queda		Duolingo
se queda con	se queda con		Duolingo
se quedaron	se quedaron		Duolingo
se quedaron con	se quedaron con		Duolingo
se quedó con	se quedo con		Duolingo
se quitan	se quitan		Duolingo
se regala	se regala		Duolingo
se regalan	se regalan		Duolingo
se reunieron	se reunieron		Duolingo
se reunió	se reunio		Duolingo
se ríe	se rie		Duolingo
se ríen	se rien		Duolingo
se siente	se siente		Duolingo
se sienten	se sienten		Duolingo
se supone que	se supone que		Duolingo
se trabaja	se trabaja		Duolingo
se usa	se usa		Duolingo
se va	se va		Duolingo
se van	se van		Duolingo
se ve	se ve		Duolingo
se vende	se vende		Duolingo
se venden	se venden		Duolingo
se verá	se vera		Duolingo
se vive	se vive		Duolingo
se volverán	se volveran		Duolingo
sea	sea	verb	Duolingo
sean	sean	verb	Duolingo
seca	seca	verb	Duolingo
secadora	secadora	noun	Duolingo
secar	secar	verb	Duolingo
secas	secas	adjective	Duolingo
sección	seccion	noun	Duolingo
seco	seco	verb	Duolingo
secos	secos	adjective	Duolingo
secretaria	secretaria	noun	Duolingo
secretarias	secretarias	noun	Duolingo
secretario	secretario	noun	Duolingo
secretarios	secretarios	noun	Duolingo
secreto	secreto	noun	Duolingo
sector	sector	noun	Duolingo
sed	sed	noun	Duolingo
seguía	seguia	verb	Duolingo
seguíamos	seguiamos	verb	Duolingo
seguían	seguian	verb	Duolingo
seguida	seguida	verb	Duolingo
seguidas	seguidas	verb	Duolingo
seguido	seguido	adverb	Duolingo
seguido	seguido	verb	Duolingo
seguimos	seguimos	verb	Duolingo
seguir	seguir	verb	Duolingo
seguiste	seguiste	verb	Duolingo
según	segun		Duolingo
según	segun	preposition	Duolingo
segunda	segunda	noun	Duolingo
segundo	segundo	adjective	Duolingo
segundo	segundo	noun	Duolingo
segundos	segundos	noun	Duolingo
segura	segura	adjective	Duolingo
seguramente	seguramente	adverb	Duolingo
seguras	seguras	adjective	Duolingo
seguridad	seguridad	noun	Duolingo
seguro	seguro	adjective	Duolingo
seguro que	seguro que		Duolingo
seguro social	seguro social		Duolingo
seis	seis	numeral	Duolingo
seiscientos	seiscientos	numeral	Duolingo
selección	seleccion	noun	Duolingo
selecciones	selecciones	noun	Duolingo
semana	semana	noun	Duolingo
semana santa	semana santa		Duolingo
semanas	semanas	noun	Duolingo
senador	senador	noun	Duolingo
senadores	senadores	noun	Duolingo
señal	senal	noun	Duolingo
señala	senala	verb	Duolingo
señales	senales	noun	Duolingo
sencillo	sencillo	adjective	Duolingo
senderismo	senderismo	noun	Duolingo
señor	senor	noun	Duolingo
señora	senora	noun	Duolingo
señoras	senoras	noun	Duolingo
señores	senores	noun	Duolingo
señorita	senorita	noun	Duolingo
señoritas	senoritas	noun	Duolingo
sentada	sentada	verb	Duolingo
sentado	sentado	verb	Duolingo
sentarnos	sentarnos	pronoun	Duolingo
sentarse	sentarse	pronoun	Duolingo
sentía	sentia	verb	Duolingo
sentido común	sentido comun		Duolingo
sentido del humor	sentido del humor		Duolingo
sentimiento	sentimiento	noun	Duolingo
sentimientos	sentimientos	noun	Duolingo
sentir	sentir	verb	Duolingo
sentirnos	sentirnos	pronoun	Duolingo
sentiste	sentiste	verb	Duolingo
septiembre	septiembre	noun	Duolingo
sequé	seque	verb	Duolingo
ser	ser	verb	Duolingo
será	sera	verb	Duolingo
serán	seran	verb	Duolingo
serás	seras	verb	Duolingo
seré	sere	verb	Duolingo
seremos	seremos	verb	Duolingo
sería	seria	verb	Duolingo
sería posible	seria posible		Duolingo
sería una buena idea	seria una buena idea		Duolingo
serías	serias	verb	Duolingo
serpientes	serpientes	noun	Duolingo
servicio	servicio	noun	Duolingo
servicios	servicios	noun	Duolingo
servimos	servimos	verb	Duolingo
servir	servir	verb	Duolingo
sesenta	sesenta	numeral	Duolingo
sesión	sesion	noun	Duolingo
sesiones	sesiones	noun	Duolingo
setecientos	setecientos	numeral	Duolingo
setenta	setenta	numeral	Duolingo
sí	si		Duolingo
sí	si	adverb	Duolingo
si	si	conjunction	Duolingo
si mal no recuerdo	si mal no recuerdo		Duolingo
si no	si no		Duolingo
sí o sí	si o si		Duolingo
siempre	siempre	adverb	Duolingo
siempre que	siempre que		Duolingo
siéntate	sientate	pronoun	Duolingo
siéntese	sientese	pronoun	Duolingo
siento mucho que	siento mucho que		Duolingo
siete	siete	numeral	Duolingo
siga	siga	verb	Duolingo
significado	significado	noun	Duolingo
signo	signo	noun	Duolingo
sigo	sigo	verb	Duolingo
sigue	sigue	verb	Duolingo
siguen	siguen	verb	Duolingo
sigues	sigues	verb	Duolingo
siguiendo	siguiendo	verb	Duolingo
siguiente	siguiente	adjective	Duolingo
siguientes	siguientes	adjective	Duolingo
siguieron	siguieron	verb	Duolingo
siguió	siguio	verb	Duolingo
silencio	silencio	noun	Duolingo
silenciosa	silenciosa	adjective	Duolingo
silenciosamente	silenciosamente	adverb	Duolingo
silencioso	silencioso	adjective	Duolingo
silenciosos	silenciosos	adjective	Duolingo
silla	silla	noun	Duolingo
sillas	sillas	noun	Duolingo
sillones	sillones	noun	Duolingo
silvestres	silvestres	adjective	Duolingo
símbolo	simbolo	noun	Duolingo
símbolos	simbolos	noun	Duolingo
similar	similar	adjective	Duolingo
similares	similares	adjective	Duolingo
simpática	simpatica	adjective	Duolingo
simpáticas	simpaticas	adjective	Duolingo
simpático	simpatico	adjective	Duolingo
simpáticos	simpaticos	adjective	Duolingo
simple	simple	adjective	Duolingo
simplemente	simplemente	adverb	Duolingo
sin	sin		Duolingo
sin	sin	preposition	Duolingo
sin descanso	sin descanso		Duolingo
sin duda	sin duda		Duolingo
sin embargo	sin embargo		Duolingo
sin parar	sin parar		Duolingo
sin querer	sin querer		Duolingo
sin receta	sin receta		Duolingo
sinceramente	sinceramente	adverb	Duolingo
sino	sino	conjunction	Duolingo
sintió	sintio	verb	Duolingo
síntomas	sintomas	noun	Duolingo
siquiera	siquiera	adverb	Duolingo
sirve	sirve	verb	Duolingo
sirvo	sirvo	verb	Duolingo
sitio	sitio	noun	Duolingo
sitios	sitios	noun	Duolingo
situación	situacion	noun	Duolingo
situaciones	situaciones	noun	Duolingo
snowboard	snowboard	noun	Duolingo
sobre	sobre	adverb	Duolingo
sobre	sobre	preposition	Duolingo
sobre todo	sobre todo		Duolingo
sociales	sociales	adjective	Duolingo
socialista	socialista	adjective	Duolingo
sociedad	sociedad	noun	Duolingo
sociedades	sociedades	noun	Duolingo
sociología	sociologia	noun	Duolingo
sofá	sofa	noun	Duolingo
software	software	noun	Duolingo
sois	sois	verb	Duolingo
sol	sol	noun	Duolingo
sola	sola	adjective	Duolingo
solamente	solamente	adverb	Duolingo
solas	solas	adjective	Duolingo
soldado	soldado	noun	Duolingo
soldados	soldados	noun	Duolingo
soleada	soleada	adjective	Duolingo
soleadas	soleadas	adjective	Duolingo
soleados	soleados	adjective	Duolingo
soledad	soledad	noun	Duolingo
solo	solo	adjective	Duolingo
solo	solo	adverb	Duolingo
solos	solos	adjective	Duolingo
solteras	solteras	adjective	Duolingo
solteros	solteros	adjective	Duolingo
solución	solucion	noun	Duolingo
soluciones	soluciones	noun	Duolingo
sombra	sombra	noun	Duolingo
sombras	sombras	noun	Duolingo
sombrero	sombrero		Duolingo
sombrero	sombrero	noun	Duolingo
sombreros	sombreros	noun	Duolingo
somos	somos	verb	Duolingo
son	son	verb	Duolingo
son verdes	son verdes		Duolingo
soñamos	sonamos	verb	Duolingo
sonar	sonar	verb	Duolingo
soñaron	sonaron	verb	Duolingo
soñaste	sonaste	verb	Duolingo
sonido	sonido	noun	Duolingo
sonrisa	sonrisa	noun	Duolingo
sopa	sopa	noun	Duolingo
sopas	sopas	noun	Duolingo
sorprendidas	sorprendidas	adjective	Duolingo
sorpresa	sorpresa	noun	Duolingo
sortija	sortija	noun	Duolingo
sortijas	sortijas	noun	Duolingo
sótano	sotano	noun	Duolingo
soul	soul	noun	Duolingo
soy	soy	verb	Duolingo
su	su	determiner	Duolingo
suavemente	suavemente	adverb	Duolingo
suaves	suaves	adjective	Duolingo
subas	subas	verb	Duolingo
sube	sube	verb	Duolingo
subieron	subieron	verb	Duolingo
subimos	subimos	verb	Duolingo
subir	subir	verb	Duolingo
subirnos	subirnos	pronoun	Duolingo
subirte	subirte	pronoun	Duolingo
subiste	subiste	verb	Duolingo
sucederá	sucedera	verb	Duolingo
sucederán	sucederan	verb	Duolingo
sucia	sucia	adjective	Duolingo
sucio	sucio	adjective	Duolingo
sucios	sucios	adjective	Duolingo
sudamérica	sudamerica	proper noun	Duolingo
sudeste	sudeste	noun	Duolingo
suegros	suegros	noun	Duolingo
suena	suena	verb	Duolingo
sueño	sueno	noun	Duolingo
sueño	sueno	verb	Duolingo
sueños	suenos	noun	Duolingo
suerte	suerte	noun	Duolingo
suéter	sueter	noun	Duolingo
suéters	sueters	noun	Duolingo
suficiente	suficiente	adjective	Duolingo
suficiente	suficiente	adverb	Duolingo
suficientes	suficientes	adjective	Duolingo
sufrir	sufrir	verb	Duolingo
suma	suma	verb	Duolingo
suman	suman	verb	Duolingo
sumo	sumo	verb	Duolingo
supe	supe	verb	Duolingo
superar	superar	verb	Duolingo
superficie	superficie	noun	Duolingo
superior	superior	adjective	Duolingo
superiores	superiores	adjective	Duolingo
supermercado	supermercado		Duolingo
supermercados	supermercados	noun	Duolingo
supieron	supieron	verb	Duolingo
supimos	supimos	verb	Duolingo
supiste	supiste	verb	Duolingo
supo	supo	verb	Duolingo
suponemos	suponemos	verb	Duolingo
supongo	supongo	verb	Duolingo
sur	sur	noun	Duolingo
surfea	surfea	verb	Duolingo
surfear	surfear	verb	Duolingo
surfeo	surfeo	verb	Duolingo
sus	sus	determiner	Duolingo
suspenso	suspenso	noun	Duolingo
sustancia	sustancia	noun	Duolingo
sustancias	sustancias	noun	Duolingo
suya	suya	adjective	Duolingo
suya	suya	pronoun	Duolingo
suyas	suyas	adjective	Duolingo
suyo	suyo	adjective	Duolingo
suyos	suyos	adjective	Duolingo
suyos	suyos	pronoun	Duolingo
tableta	tableta	noun	Duolingo
tal	tal	adjective	Duolingo
tal como	tal como		Duolingo
tal vez	tal vez		Duolingo
tales	tales	adjective	Duolingo
tallas	tallas	noun	Duolingo
tamaño	tamano	noun	Duolingo
también	tambien	adverb	Duolingo
tambores	tambores	noun	Duolingo
tampoco	tampoco		Duolingo
tampoco	tampoco	adverb	Duolingo
tan	tan	adverb	Duolingo
tan bonita	tan bonita		Duolingo
tan bonito	tan bonito		Duolingo
tanta	tanta	determiner	Duolingo
tantas	tantas	determiner	Duolingo
tanto	tanto	adverb	Duolingo
tanto como	tanto como		Duolingo
tantos	tantos	determiner	Duolingo
tarde	tarde	adverb	Duolingo
tarea	tarea	noun	Duolingo
tareas domésticas	tareas domesticas		Duolingo
tarjeta	tarjeta	noun	Duolingo
tarjeta de crédito	tarjeta de credito		Duolingo
tasa	tasa	noun	Duolingo
tasas	tasas	noun	Duolingo
taxi	taxi		Duolingo
taxi	taxi	noun	Duolingo
taxis	taxis	noun	Duolingo
taza	taza		Duolingo
taza	taza	noun	Duolingo
tazas	tazas	noun	Duolingo
té	te	noun	Duolingo
te	te	pronoun	Duolingo
te acostabas	te acostabas		Duolingo
te acostaste	te acostaste		Duolingo
te acuestas	te acuestas		Duolingo
te amo	te amo		Duolingo
te apuras	te apuras		Duolingo
te ayudo	te ayudo		Duolingo
te caes	te caes		Duolingo
te cepillas	te cepillas		Duolingo
te compra	te compra		Duolingo
te comunicas	te comunicas		Duolingo
te conozco	te conozco		Duolingo
te dicen	te dicen		Duolingo
te duchas	te duchas		Duolingo
te duchaste	te duchaste		Duolingo
te encanta	te encanta		Duolingo
te escondías	te escondias		Duolingo
te fuiste	te fuiste		Duolingo
te gusta	te gusta		Duolingo
te gustan	te gustan		Duolingo
te ibas	te ibas		Duolingo
te interesa	te interesa		Duolingo
te levantas	te levantas		Duolingo
te llamamos	te llamamos		Duolingo
te llamas	te llamas		Duolingo
te llevabas bien	te llevabas bien		Duolingo
te lo	te lo		Duolingo
te necesito	te necesito		Duolingo
te olvidas	te olvidas		Duolingo
te perdiste	te perdiste		Duolingo
te pones	te pones		Duolingo
te preocupabas	te preocupabas		Duolingo
te preocupas	te preocupas		Duolingo
te quedarás con	te quedaras con		Duolingo
te quedas con	te quedas con		Duolingo
te reuniste	te reuniste		Duolingo
te ríes	te ries		Duolingo
te sientas	te sientas		Duolingo
te sientes	te sientes		Duolingo
te vas	te vas		Duolingo
te verás	te veras		Duolingo
te visitan	te visitan		Duolingo
teatro	teatro	noun	Duolingo
techo	techo	noun	Duolingo
técnica	tecnica	noun	Duolingo
técnicas	tecnicas	noun	Duolingo
técnicos	tecnicos	noun	Duolingo
tecnología	tecnologia	noun	Duolingo
tecnologías	tecnologias	noun	Duolingo
tele	tele	noun	Duolingo
teléfono	telefono		Duolingo
teléfono	telefono	noun	Duolingo
teléfonos	telefonos	noun	Duolingo
televisión	television	noun	Duolingo
televisores	televisores	noun	Duolingo
tema	tema	noun	Duolingo
temas	temas	noun	Duolingo
temor	temor	noun	Duolingo
temperatura	temperatura	noun	Duolingo
temporada	temporada	noun	Duolingo
temprano	temprano	adverb	Duolingo
ten	ten	verb	Duolingo
ten cuidado	ten cuidado		Duolingo
tendencia	tendencia	noun	Duolingo
tendrá	tendra	verb	Duolingo
tendrán	tendran	verb	Duolingo
tendrás	tendras	verb	Duolingo
tendré	tendre	verb	Duolingo
tendremos	tendremos	verb	Duolingo
tendría	tendria	verb	Duolingo
tendríamos	tendriamos	verb	Duolingo
tendrían	tendrian	verb	Duolingo
tendrías	tendrias	verb	Duolingo
tenéis	teneis	verb	Duolingo
tenemos	tenemos	verb	Duolingo
tenemos que	tenemos que		Duolingo
tener	tener	verb	Duolingo
tenga	tenga	verb	Duolingo
tengan	tengan	verb	Duolingo
tengas	tengas	verb	Duolingo
tengo	tengo		Duolingo
tengo	tengo	verb	Duolingo
tengo que	tengo que		Duolingo
tenía	tenia	verb	Duolingo
tenía prisa	tenia prisa		Duolingo
teníamos	teniamos	verb	Duolingo
tenían	tenian	verb	Duolingo
tenías	tenias	verb	Duolingo
tenías prisa	tenias prisa		Duolingo
tenido	tenido	verb	Duolingo
teniendo	teniendo	verb	Duolingo
tenis	tenis	noun	Duolingo
tensión	tension	noun	Duolingo
teoría	teoria	noun	Duolingo
tercer	tercer	determiner	Duolingo
tercera	tercera	determiner	Duolingo
tercero	tercero	noun	Duolingo
termina	termina	verb	Duolingo
terminar	terminar	verb	Duolingo
terminaré	terminare	verb	Duolingo
terminaron	terminaron	verb	Duolingo
terminaste	terminaste	verb	Duolingo
término	termino	noun	Duolingo
termino	termino	verb	Duolingo
terraza	terraza	noun	Duolingo
terremotos	terremotos	noun	Duolingo
terreno	terreno	noun	Duolingo
terrible	terrible	adjective	Duolingo
territorio	territorio	noun	Duolingo
terrorismo	terrorismo	noun	Duolingo
tés	tes	noun	Duolingo
tesis	tesis	noun	Duolingo
testigo	testigo	noun	Duolingo
testigos	testigos	noun	Duolingo
textos	textos	noun	Duolingo
ti	ti	pronoun	Duolingo
tía	tia	noun	Duolingo
tías	tias	noun	Duolingo
tiempo	tiempo	noun	Duolingo
tiempo completo	tiempo completo		Duolingo
tiempo libre	tiempo libre		Duolingo
tiempos	tiempos	noun	Duolingo
tienda	tienda		Duolingo
tiendas	tiendas	noun	Duolingo
tiene	tiene		Duolingo
tiene	tiene	verb	Duolingo
tiene prisa	tiene prisa		Duolingo
tiene que	tiene que		Duolingo
tienen	tienen	verb	Duolingo
tienen prisa	tienen prisa		Duolingo
tienen que	tienen que		Duolingo
tienes	tienes		Duolingo
tienes	tienes	verb	Duolingo
tienes que	tienes que		Duolingo
tierra	tierra	noun	Duolingo
tijeras	tijeras	noun	Duolingo
tío	tio	noun	Duolingo
tíos	tios	noun	Duolingo
típica	tipica	adjective	Duolingo
típico	tipico	adjective	Duolingo
tipo	tipo	noun	Duolingo
tira	tira	verb	Duolingo
tírasela	tirasela		Duolingo
tires	tires	verb	Duolingo
título	titulo	noun	Duolingo
títulos	titulos	noun	Duolingo
toallas	toallas	noun	Duolingo
toca	toca	verb	Duolingo
tocaba	tocaba	verb	Duolingo
tocábamos	tocabamos	verb	Duolingo
tocaban	tocaban	verb	Duolingo
tocamos	tocamos	verb	Duolingo
tocan	tocan	verb	Duolingo
tocando	tocando	verb	Duolingo
tocar	tocar	verb	Duolingo
tocaron	tocaron	verb	Duolingo
tocas	tocas	verb	Duolingo
tocaste	tocaste	verb	Duolingo
tocó	toco	verb	Duolingo
toda	toda	determiner	Duolingo
toda la mañana	toda la manana		Duolingo
todas	todas	determiner	Duolingo
todas	todas	pronoun	Duolingo
todavía	todavia	adverb	Duolingo
todo	todo	determiner	Duolingo
todo	todo	pronoun	Duolingo
todo el día	todo el dia	adverb	Duolingo
todo el mundo	todo el mundo		Duolingo
todo el tiempo	todo el tiempo		Duolingo
todo lo contrario	todo lo contrario		Duolingo
todo recto	todo recto		Duolingo
todos	todos	determiner	Duolingo
todos	todos	pronoun	Duolingo
tolerante	tolerante	adjective	Duolingo
tolerantes	tolerantes	adjective	Duolingo
toma	toma	verb	Duolingo
tomábamos	tomabamos	verb	Duolingo
tomaban	tomaban	verb	Duolingo
tomabas	tomabas	verb	Duolingo
tomamos	tomamos		Duolingo
tomamos	tomamos	verb	Duolingo
toman	toman	verb	Duolingo
tomando	tomando	verb	Duolingo
tomar	tomar		Duolingo
tomar	tomar	verb	Duolingo
tomar el	tomar el		Duolingo
tomaron	tomaron	verb	Duolingo
tomaste	tomaste	verb	Duolingo
tomate	tomate		Duolingo
tomate	tomate	noun	Duolingo
tomé	tome		Duolingo
tome	tome	verb	Duolingo
tomó	tomo		Duolingo
tomó	tomo	verb	Duolingo
toneladas	toneladas	noun	Duolingo
toqué	toque	verb	Duolingo
torneo	torneo	noun	Duolingo
toro	toro	noun	Duolingo
torre	torre	noun	Duolingo
torres	torres	noun	Duolingo
tortillas	tortillas	noun	Duolingo
tortuga	tortuga	noun	Duolingo
tortugas	tortugas	noun	Duolingo
tos	tos	noun	Duolingo
tostada	tostada	noun	Duolingo
tostadas	tostadas	noun	Duolingo
totalmente	totalmente	adverb	Duolingo
tour	tour	noun	Duolingo
trabaja	trabaja	verb	Duolingo
trabajabas	trabajabas	verb	Duolingo
trabajador	trabajador	noun	Duolingo
trabajadora	trabajadora	adjective	Duolingo
trabajadora	trabajadora	noun	Duolingo
trabajadores	trabajadores	adjective	Duolingo
trabajadores	trabajadores	noun	Duolingo
trabajamos	trabajamos	verb	Duolingo
trabajan	trabajan		Duolingo
trabajan	trabajan	verb	Duolingo
trabajando	trabajando	verb	Duolingo
trabajar	trabajar	verb	Duolingo
trabajar en	trabajar en		Duolingo
trabajar mucho	trabajar mucho		Duolingo
trabajarías	trabajarias	verb	Duolingo
trabajas	trabajas	verb	Duolingo
trabajé	trabaje	verb	Duolingo
trabajen	trabajen	verb	Duolingo
trabajo	trabajo	noun	Duolingo
trabajo	trabajo	verb	Duolingo
trabajos	trabajos	noun	Duolingo
tradición	tradicion	noun	Duolingo
tradicional	tradicional	adjective	Duolingo
tradicionales	tradicionales	adjective	Duolingo
tradiciones	tradiciones	noun	Duolingo
traducen	traducen	verb	Duolingo
traduzco	traduzco	verb	Duolingo
tráemela	traemela		Duolingo
tráemelo	traemelo		Duolingo
traemos	traemos	verb	Duolingo
traes	traes	verb	Duolingo
tráfico	trafico	noun	Duolingo
traigan	traigan	verb	Duolingo
traigo	traigo	verb	Duolingo
traje	traje	noun	Duolingo
traje	traje	verb	Duolingo
traje de baño	traje de bano		Duolingo
trajeron	trajeron	verb	Duolingo
trajes	trajes	noun	Duolingo
trajimos	trajimos	verb	Duolingo
trajiste	trajiste	verb	Duolingo
trajo	trajo	verb	Duolingo
tranquila	tranquila	adjective	Duolingo
tranquilo	tranquilo	adjective	Duolingo
tranquilos	tranquilos	adjective	Duolingo
transformación	transformacion	noun	Duolingo
transformaciones	transformaciones	noun	Duolingo
tránsito	transito	noun	Duolingo
transporte	transporte		Duolingo
transporte	transporte	noun	Duolingo
tranvía	tranvia	noun	Duolingo
trasera	trasera	adjective	Duolingo
trasero	trasero	adjective	Duolingo
trata	trata	verb	Duolingo
trataba	trataba	verb	Duolingo
tratamiento	tratamiento	noun	Duolingo
tratando	tratando	verb	Duolingo
tratar	tratar	verb	Duolingo
tratarán	trataran	verb	Duolingo
trato	trato	verb	Duolingo
trayendo	trayendo	verb	Duolingo
trece	trece	numeral	Duolingo
treinta	treinta	numeral	Duolingo
tren	tren		Duolingo
tren	tren	noun	Duolingo
trenes	trenes	noun	Duolingo
tres	tres		Duolingo
tres	tres	numeral	Duolingo
trescientos	trescientos	adjective	Duolingo
triste	triste	adjective	Duolingo
tristes	tristes	adjective	Duolingo
trozo	trozo	noun	Duolingo
trozos	trozos	noun	Duolingo
tu	tu		Duolingo
tu	tu	determiner	Duolingo
tú	tu	pronoun	Duolingo
tú bebes	tu bebes		Duolingo
tú escribes	tu escribes		Duolingo
tú fuiste	tu fuiste		Duolingo
tú hablas	tu hablas		Duolingo
tú haces	tu haces		Duolingo
tú lees	tu lees		Duolingo
tú pones	tu pones		Duolingo
tú se	tu se		Duolingo
tú vas	tu vas		Duolingo
tú vuelves	tu vuelves		Duolingo
turismo	turismo	noun	Duolingo
tus	tus	determiner	Duolingo
tuve	tuve	verb	Duolingo
tuviera	tuviera	verb	Duolingo
tuvieras	tuvieras	verb	Duolingo
tuvieron	tuvieron	verb	Duolingo
tuvimos	tuvimos	verb	Duolingo
tuviste	tuviste	verb	Duolingo
tuvo	tuvo	verb	Duolingo
tuya	tuya	adjective	Duolingo
tuyas	tuyas	adjective	Duolingo
tuyas	tuyas	pronoun	Duolingo
tuyo	tuyo	adjective	Duolingo
tuyos	tuyos	pronoun	Duolingo
u	u	conjunction	Duolingo
ubicación	ubicacion	noun	Duolingo
última	ultima	determiner	Duolingo
últimamente	ultimamente	adverb	Duolingo
últimas	ultimas	determiner	Duolingo
último	ultimo	determiner	Duolingo
últimos	ultimos	determiner	Duolingo
un	un	determiner	Duolingo
un grupo de	un grupo de		Duolingo
un plato	un plato		Duolingo
un poco	un poco		Duolingo
una	una	determiner	Duolingo
una	una	pronoun	Duolingo
una vez	una vez		Duolingo
una vez más	una vez mas	adverb	Duolingo
una vez que	una vez que		Duolingo
unas	unas	determiner	Duolingo
única	unica	adjective	Duolingo
únicamente	unicamente	adverb	Duolingo
único	unico	adjective	Duolingo
unidad	unidad	noun	Duolingo
unidades	unidades	noun	Duolingo
uniforme	uniforme	noun	Duolingo
uniformes	uniformes	noun	Duolingo
unión	union	noun	Duolingo
universal	universal	adjective	Duolingo
universidad	universidad		Duolingo
universidad	universidad	noun	Duolingo
universidades	universidades	noun	Duolingo
universo	universo	noun	Duolingo
uno	uno		Duolingo
uno	uno	noun	Duolingo
uno	uno	pronoun	Duolingo
unos	unos	determiner	Duolingo
urgencia	urgencia	noun	Duolingo
urgentemente	urgentemente	adverb	Duolingo
usa	usa	verb	Duolingo
usaba	usaba	verb	Duolingo
usamos	usamos	verb	Duolingo
usan	usan	verb	Duolingo
usando	usando	verb	Duolingo
usar	usar	verb	Duolingo
usas	usas	verb	Duolingo
usaste	usaste	verb	Duolingo
use	use	verb	Duolingo
usó	uso	verb	Duolingo
usted	usted	pronoun	Duolingo
usted bebe	usted bebe		Duolingo
usted escribe	usted escribe		Duolingo
usted habla	usted habla		Duolingo
usted hace	usted hace		Duolingo
usted pone	usted pone		Duolingo
usted prueba	usted prueba		Duolingo
usted trabaja	usted trabaja		Duolingo
usted va	usted va		Duolingo
usted vive	usted vive		Duolingo
usted vuelve	usted vuelve		Duolingo
ustedes	ustedes	pronoun	Duolingo
usual	usual	adjective	Duolingo
usualmente	usualmente	adverb	Duolingo
útil	util	adjective	Duolingo
útiles	utiles	adjective	Duolingo
utiliza	utiliza	verb	Duolingo
utilizamos	utilizamos	verb	Duolingo
utilizan	utilizan	verb	Duolingo
utilizando	utilizando	verb	Duolingo
utilizar	utilizar	verb	Duolingo
utilizo	utilizo	verb	Duolingo
uvas	uvas	noun	Duolingo
uy	uy		Duolingo
va	va	verb	Duolingo
va a	va a		Duolingo
vacaciones	vacaciones	noun	Duolingo
vacas	vacas	noun	Duolingo
vacíos	vacios	noun	Duolingo
vainilla	vainilla	noun	Duolingo
vale	vale	verb	Duolingo
valor	valor	noun	Duolingo
valores	valores	noun	Duolingo
vámonos	vamonos	pronoun	Duolingo
vamos	vamos	verb	Duolingo
vamos a	vamos a		Duolingo
van	van		Duolingo
van	van	verb	Duolingo
van a	van a		Duolingo
vaqueros	vaqueros	noun	Duolingo
varias	varias	determiner	Duolingo
variedad	variedad	noun	Duolingo
varios	varios	determiner	Duolingo
vas	vas	verb	Duolingo
vas a	vas a		Duolingo
vaso	vaso		Duolingo
vaso	vaso	noun	Duolingo
vasos	vasos	noun	Duolingo
vaya	vaya		Duolingo
vaya	vaya	interjection	Duolingo
vaya	vaya	verb	Duolingo
vayan	vayan	verb	Duolingo
vayas	vayas	verb	Duolingo
ve	ve	verb	Duolingo
veamos	veamos	verb	Duolingo
veces	veces	noun	Duolingo
vecina	vecina	adjective	Duolingo
vecina	vecina	noun	Duolingo
vecino	vecino	noun	Duolingo
vecinos	vecinos	adjective	Duolingo
vecinos	vecinos	noun	Duolingo
vegetales	vegetales	noun	Duolingo
vegetariana	vegetariana	adjective	Duolingo
vegetarianas	vegetarianas	adjective	Duolingo
vegetariano	vegetariano	adjective	Duolingo
vegetarianos	vegetarianos	adjective	Duolingo
vehículo	vehiculo	noun	Duolingo
vehículos	vehiculos	noun	Duolingo
veía	veia	verb	Duolingo
veíamos	veiamos	verb	Duolingo
veían	veian	verb	Duolingo
veías	veias	verb	Duolingo
veinte	veinte	numeral	Duolingo
veinticinco	veinticinco	numeral	Duolingo
veinticuatro	veinticuatro	numeral	Duolingo
veintidós	veintidos	numeral	Duolingo
veintinueve	veintinueve	numeral	Duolingo
veintiocho	veintiocho	numeral	Duolingo
veintiséis	veintiseis	numeral	Duolingo
veintisiete	veintisiete	numeral	Duolingo
veintitrés	veintitres	numeral	Duolingo
veintiún	veintiun	noun	Duolingo
veintiuno	veintiuno	numeral	Duolingo
velero	velero	noun	Duolingo
velocidad	velocidad	noun	Duolingo
vemos	vemos	verb	Duolingo
ven	ven	verb	Duolingo
ven acá	ven aca		Duolingo
vendedoras	vendedoras	noun	Duolingo
vender	vender	verb	Duolingo
vendrá	vendra	verb	Duolingo
vendrás	vendras	verb	Duolingo
vendremos	vendremos	verb	Duolingo
venga	venga	verb	Duolingo
vengamos	vengamos	verb	Duolingo
vengan	vengan	verb	Duolingo
vengas	vengas	verb	Duolingo
vengo	vengo	verb	Duolingo
venía	venia	verb	Duolingo
veníamos	veniamos	verb	Duolingo
venimos	venimos	verb	Duolingo
venir	venir	verb	Duolingo
venta	venta	noun	Duolingo
ventaja	ventaja	noun	Duolingo
ventajas	ventajas	noun	Duolingo
ventana	ventana	noun	Duolingo
ventanas	ventanas	noun	Duolingo
ventas	ventas	noun	Duolingo
veo	veo	verb	Duolingo
veo que	veo que		Duolingo
ver	ver	verb	Duolingo
verá	vera	verb	Duolingo
verán	veran	verb	Duolingo
verano	verano	noun	Duolingo
veranos	veranos	noun	Duolingo
verás	veras	verb	Duolingo
verdad	verdad	noun	Duolingo
verdadera	verdadera	adjective	Duolingo
verdaderas	verdaderas	adjective	Duolingo
verdadero	verdadero	adjective	Duolingo
verdaderos	verdaderos	adjective	Duolingo
verde	verde		Duolingo
verde	verde	adjective	Duolingo
verdes	verdes	adjective	Duolingo
veré	vere	verb	Duolingo
veremos	veremos	verb	Duolingo
vernos	vernos	pronoun	Duolingo
versión	version	noun	Duolingo
ves	ves	verb	Duolingo
vestido	vestido		Duolingo
vestido	vestido	noun	Duolingo
vestido	vestido	verb	Duolingo
vestidos	vestidos	noun	Duolingo
vestir	vestir	verb	Duolingo
vestirme	vestirme	pronoun	Duolingo
vestirse	vestirse	pronoun	Duolingo
vestirte	vestirte	pronoun	Duolingo
vete	vete	pronoun	Duolingo
vez	vez	noun	Duolingo
vi	vi	verb	Duolingo
viajamos	viajamos	verb	Duolingo
viajar	viajar	verb	Duolingo
viajaron	viajaron	verb	Duolingo
viajaste	viajaste	verb	Duolingo
viaje	viaje	noun	Duolingo
viajé	viaje	verb	Duolingo
viajes	viajes	noun	Duolingo
viajes	viajes	verb	Duolingo
viajó	viajo	verb	Duolingo
víctima	victima	noun	Duolingo
víctimas	victimas	noun	Duolingo
vida	vida	noun	Duolingo
vida nocturna	vida nocturna		Duolingo
vidas	vidas	noun	Duolingo
video	video	noun	Duolingo
videojuego	videojuego	noun	Duolingo
videojuegos	videojuegos	noun	Duolingo
videos	videos	noun	Duolingo
vieja	vieja	adjective	Duolingo
viejas	viejas	adjective	Duolingo
viejo	viejo	adjective	Duolingo
viejos	viejos	adjective	Duolingo
viendo	viendo	verb	Duolingo
viene	viene	verb	Duolingo
vienen	vienen	verb	Duolingo
vienes	vienes	verb	Duolingo
viento	viento	noun	Duolingo
vientos	vientos	noun	Duolingo
viernes	viernes	noun	Duolingo
vieron	vieron	verb	Duolingo
vimos	vimos	verb	Duolingo
vinagre	vinagre	noun	Duolingo
vine	vine	verb	Duolingo
vinieron	vinieron	verb	Duolingo
vinimos	vinimos	verb	Duolingo
viniste	viniste	verb	Duolingo
vino	vino	noun	Duolingo
vino	vino	verb	Duolingo
vinos	vinos	noun	Duolingo
vio	vio	verb	Duolingo
violencia	violencia	noun	Duolingo
violín	violin	noun	Duolingo
violines	violines	noun	Duolingo
virus	virus	noun	Duolingo
visión	vision	noun	Duolingo
visita	visita	verb	Duolingo
visitaba	visitaba	verb	Duolingo
visitaban	visitaban	verb	Duolingo
visitamos	visitamos	verb	Duolingo
visitan	visitan	verb	Duolingo
visitando	visitando	verb	Duolingo
visitándolos	visitandolos	pronoun	Duolingo
visitantes	visitantes	noun	Duolingo
visitar	visitar	verb	Duolingo
visitaron	visitaron	verb	Duolingo
visitas	visitas	verb	Duolingo
visitaste	visitaste	verb	Duolingo
visité	visite	verb	Duolingo
visites	visites	verb	Duolingo
visitó	visito	verb	Duolingo
viste	viste	verb	Duolingo
viva	viva	adjective	Duolingo
viva	viva	verb	Duolingo
vivan	vivan	verb	Duolingo
vivas	vivas	verb	Duolingo
vive	vive	verb	Duolingo
viven	viven	verb	Duolingo
vives	vives	verb	Duolingo
viví	vivi	verb	Duolingo
vivía	vivia	verb	Duolingo
vivíamos	viviamos	verb	Duolingo
vivían	vivian	verb	Duolingo
vivías	vivias	verb	Duolingo
vivieron	vivieron	verb	Duolingo
vivimos	vivimos	verb	Duolingo
vivir	vivir	verb	Duolingo
vivir en	vivir en		Duolingo
vivirás	viviras	verb	Duolingo
viviré	vivire	verb	Duolingo
viviste	viviste	verb	Duolingo
vivo	vivo		Duolingo
vivo	vivo	adjective	Duolingo
vivo	vivo	verb	Duolingo
vivos	vivos	adjective	Duolingo
vocabulario	vocabulario	noun	Duolingo
volamos	volamos	verb	Duolingo
volar	volar	verb	Duolingo
volcán	volcan	noun	Duolingo
volumen	volumen	noun	Duolingo
voluntario	voluntario	adjective	Duolingo
volvemos	volvemos	verb	Duolingo
volver	volver	verb	Duolingo
volverse	volverse	pronoun	Duolingo
volverte	volverte	pronoun	Duolingo
volví	volvi	verb	Duolingo
volviendo al tema	volviendo al tema		Duolingo
volvieron	volvieron	verb	Duolingo
volvió	volvio	verb	Duolingo
vosotras	vosotras	pronoun	Duolingo
vosotros	vosotros	pronoun	Duolingo
votaré	votare	verb	Duolingo
voy	voy	verb	Duolingo
voy a	voy a		Duolingo
voz	voz	noun	Duolingo
vuela	vuela	verb	Duolingo
vuelan	vuelan	verb	Duolingo
vuelo	vuelo	verb	Duolingo
vuelos	vuelos	noun	Duolingo
vuelva	vuelva	verb	Duolingo
vuelve	vuelve	verb	Duolingo
vuelven	vuelven	verb	Duolingo
vuelves	vuelves	verb	Duolingo
vuelvo	vuelvo	verb	Duolingo
web	web	noun	Duolingo
y	y		Duolingo
y	y	conjunction	Duolingo
y después	y despues		Duolingo
y medio	y medio		Duolingo
y si	y si		Duolingo
ya	ya	adverb	Duolingo
ya me lo imagino	ya me lo imagino		Duolingo
ya mismo	ya mismo		Duolingo
ya que	ya que		Duolingo
ya veremos	ya veremos		Duolingo
yendo	yendo	verb	Duolingo
yo	yo	pronoun	Duolingo
yo fui	yo fui		Duolingo
yo no	yo no		Duolingo
yo sí	yo si		Duolingo
yoga	yoga	noun	Duolingo
yogur	yogur	noun	Duolingo
yogures	yogures	noun	Duolingo
zanahorias	zanahorias	noun	Duolingo
zapato	zapato	noun	Duolingo
zapatos	zapatos	noun	Duolingo
zapatos deportivos	zapatos deportivos		Duolingo
zona	zona	noun	Duolingo
zonas	zonas	noun	Duolingo
