learnable	normalized	partOfSpeech	source
?	?		Duolingo
a	a	preposition	Duolingo
a casa	a casa		Duolingo
a causa	a causa		Duolingo
a cena	a cena		Duolingo
a che ora	a che ora		Duolingo
a chi	a chi		Duolingo
a chiave	a chiave		Duolingo
a colazione	a colazione		Duolingo
a cui	a cui		Duolingo
a luca	a luca		Duolingo
a lungo	a lungo	adverb	Duolingo
a piedi	a piedi		Duolingo
a proposito	a proposito	adverb	Duolingo
a quale	a quale	adjective	Duolingo
a scuola	a scuola		Duolingo
abbassa	abbassa	verb	Duolingo
abbassano	abbassano	verb	Duolingo
abbassare	abbassare	verb	Duolingo
abbassiamo	abbassiamo	verb	Duolingo
abbastanza	abbastanza	adverb	Duolingo
abbia	abbia	verb	Duolingo
abbiamo	abbiamo	verb	Duolingo
abbiano	abbiano	verb	Duolingo
abbigliamento	abbigliamento	noun	Duolingo
abitanti	abitanti	noun	Duolingo
abitare	abitare	verb	Duolingo
abitate	abitate	verb	Duolingo
abiti	abiti	noun	Duolingo
abito	abito	noun	Duolingo
abituale	abituale	adjective	Duolingo
abituali	abituali	adjective	Duolingo
abitudine	abitudine	noun	Duolingo
accanto	accanto	adverb	Duolingo
accende	accende	verb	Duolingo
accendere	accendere	verb	Duolingo
accendiamo	accendiamo	verb	Duolingo
accendo	accendo	verb	Duolingo
accettano	accettano	verb	Duolingo
accettate	accettate	verb	Duolingo
accetti	accetti	verb	Duolingo
accidenti	accidenti	noun	Duolingo
accordo	accordo	noun	Duolingo
acerbe	acerbe	adjective	Duolingo
acerbi	acerbi	adjective	Duolingo
acerbo	acerbo	adjective	Duolingo
acido	acido	adjective	Duolingo
acqua	acqua	noun	Duolingo
acque	acque	noun	Duolingo
ad	ad	preposition	Duolingo
addirittura	addirittura	adverb	Duolingo
adesso	adesso	adverb	Duolingo
adolescente	adolescente	noun	Duolingo
adolescenti	adolescenti	noun	Duolingo
adriatica	adriatica	adjective	Duolingo
adriatico	adriatico	adjective	Duolingo
adulta	adulta	adjective	Duolingo
adulte	adulte	adjective	Duolingo
adulti	adulti	noun	Duolingo
adulto	adulto	adjective	Duolingo
adulto	adulto	noun	Duolingo
aerei	aerei	noun	Duolingo
aereo	aereo	noun	Duolingo
aeroplani	aeroplani	noun	Duolingo
aeroplano	aeroplano	noun	Duolingo
aeroporto	aeroporto	noun	Duolingo
affare	affare	noun	Duolingo
affari	affari	noun	Duolingo
affatto	affatto	adverb	Duolingo
affitta	affitta	verb	Duolingo
affittare	affittare	verb	Duolingo
africa	africa	proper noun	Duolingo
aggiunge	aggiunge	verb	Duolingo
aggiungere	aggiungere	verb	Duolingo
aggiungete	aggiungete	verb	Duolingo
aggiungi	aggiungi	verb	Duolingo
aggiungo	aggiungo	verb	Duolingo
aggiungono	aggiungono	verb	Duolingo
agli	agli	preposition	Duolingo
aglio	aglio	noun	Duolingo
agosto	agosto	noun	Duolingo
agricoltura	agricoltura	noun	Duolingo
ah	ah	interjection	Duolingo
ai	ai	preposition	Duolingo
aiuta	aiuta	verb	Duolingo
aiutando	aiutando	verb	Duolingo
aiutano	aiutano	verb	Duolingo
aiutare	aiutare	verb	Duolingo
aiutate	aiutate	verb	Duolingo
aiuti	aiuti	verb	Duolingo
aiuto	aiuto	noun	Duolingo
al	al	preposition	Duolingo
al lavoro	al lavoro		Duolingo
alba	alba	noun	Duolingo
albergo	albergo	noun	Duolingo
alberi	alberi	noun	Duolingo
albero	albero	noun	Duolingo
alcol	alcol	noun	Duolingo
alcuna	alcuna	determiner	Duolingo
alcuna	alcuna	pronoun	Duolingo
alcune	alcune	determiner	Duolingo
alcune	alcune	pronoun	Duolingo
alcuni	alcuni	determiner	Duolingo
alcuni	alcuni	pronoun	Duolingo
alcuno	alcuno	pronoun	Duolingo
all'	all'	preposition	Duolingo
alla	alla	preposition	Duolingo
alle	alle	preposition	Duolingo
alle ragazze	alle ragazze		Duolingo
alle sette	alle sette		Duolingo
allegra	allegra	adjective	Duolingo
allegre	allegre	adjective	Duolingo
allegri	allegri	adjective	Duolingo
allegria	allegria	noun	Duolingo
allegro	allegro	adjective	Duolingo
allena	allena	verb	Duolingo
allenatore	allenatore	noun	Duolingo
allo	allo	preposition	Duolingo
allora	allora	adverb	Duolingo
almeno	almeno	adverb	Duolingo
alpi	alpi	proper noun	Duolingo
alta	alta	adjective	Duolingo
alte	alte	adjective	Duolingo
altezza	altezza	noun	Duolingo
alti	alti	adjective	Duolingo
alto	alto	adjective	Duolingo
altra	altra	determiner	Duolingo
altra	altra	pronoun	Duolingo
altre	altre	pronoun	Duolingo
altri	altri	pronoun	Duolingo
altrimenti	altrimenti	adverb	Duolingo
altro	altro	determiner	Duolingo
altro	altro	pronoun	Duolingo
altrove	altrove	adverb	Duolingo
alunni	alunni	noun	Duolingo
alzi	alzi	verb	Duolingo
ama	ama	verb	Duolingo
amano	amano	verb	Duolingo
amare	amare	verb	Duolingo
ambasciatore	ambasciatore	noun	Duolingo
ambiente	ambiente	noun	Duolingo
ambulanza	ambulanza	noun	Duolingo
america	america	proper noun	Duolingo
americana	americana	adjective	Duolingo
americana	americana	noun	Duolingo
americane	americane	adjective	Duolingo
americani	americani	adjective	Duolingo
americano	americano	adjective	Duolingo
ami	ami	verb	Duolingo
amica	amica	noun	Duolingo
amiche	amiche	noun	Duolingo
amichevole	amichevole	adjective	Duolingo
amichevoli	amichevoli	adjective	Duolingo
amici	amici	noun	Duolingo
amicizia	amicizia	noun	Duolingo
amico	amico	noun	Duolingo
amministrazione	amministrazione	noun	Duolingo
amo	amo	verb	Duolingo
amore	amore	noun	Duolingo
anatra	anatra	noun	Duolingo
anch'io	anch'io		Duolingo
anche	anche	adverb	Duolingo
ancora	ancora	adverb	Duolingo
andai	andai	verb	Duolingo
andammo	andammo	verb	Duolingo
andando	andando	verb	Duolingo
andarci	andarci	pronoun	Duolingo
andare	andare	verb	Duolingo
andarono	andarono	verb	Duolingo
andarsene	andarsene	pronoun	Duolingo
andasse	andasse	verb	Duolingo
andassi	andassi	verb	Duolingo
andate	andate	verb	Duolingo
andava	andava	verb	Duolingo
andavamo	andavamo	verb	Duolingo
andiamo	andiamo		Duolingo
andiamo	andiamo	verb	Duolingo
andrai	andrai	verb	Duolingo
andrebbe	andrebbe	verb	Duolingo
andrebbero	andrebbero	verb	Duolingo
andremo	andremo	verb	Duolingo
andresti	andresti	verb	Duolingo
andrò	andro	verb	Duolingo
angeli	angeli	noun	Duolingo
angelo	angelo	noun	Duolingo
angoli	angoli	noun	Duolingo
angolo	angolo	noun	Duolingo
anima	anima	noun	Duolingo
animale	animale	noun	Duolingo
animali	animali	noun	Duolingo
anni	anni	noun	Duolingo
anno	anno	noun	Duolingo
annoiata	annoiata	adjective	Duolingo
annoiato	annoiato	adjective	Duolingo
antica	antica	adjective	Duolingo
antichi	antichi	adjective	Duolingo
antico	antico	adjective	Duolingo
antipasti	antipasti	noun	Duolingo
anzi	anzi	adverb	Duolingo
ape	ape	noun	Duolingo
aperitivi	aperitivi	noun	Duolingo
aperitivo	aperitivo	noun	Duolingo
aperta	aperta	adjective	Duolingo
aperti	aperti	adjective	Duolingo
api	api	noun	Duolingo
appartamenti	appartamenti	noun	Duolingo
appartamento	appartamento	noun	Duolingo
appartenere	appartenere	verb	Duolingo
appena	appena	adverb	Duolingo
appena	appena	conjunction	Duolingo
appetito	appetito	noun	Duolingo
appuntamenti	appuntamenti	noun	Duolingo
appuntamento	appuntamento	noun	Duolingo
appunto	appunto	adverb	Duolingo
apra	apra	verb	Duolingo
aprendo	aprendo	verb	Duolingo
apri	apri	verb	Duolingo
aprii	aprii	verb	Duolingo
aprile	aprile	noun	Duolingo
aprirà	aprira	verb	Duolingo
aprirai	aprirai	verb	Duolingo
aprire	aprire	verb	Duolingo
aprirebbe	aprirebbe	verb	Duolingo
aprirei	aprirei	verb	Duolingo
apriremo	apriremo	verb	Duolingo
aprireste	aprireste	verb	Duolingo
aprirono	aprirono	verb	Duolingo
aprisse	aprisse	verb	Duolingo
aprissi	aprissi	verb	Duolingo
aprite	aprite	verb	Duolingo
apriva	apriva	verb	Duolingo
aprivano	aprivano	verb	Duolingo
aprivo	aprivo	verb	Duolingo
apro	apro	verb	Duolingo
aprono	aprono	verb	Duolingo
arance	arance	noun	Duolingo
arancia	arancia	noun	Duolingo
aranciata	aranciata	noun	Duolingo
arancione	arancione	adjective	Duolingo
arancioni	arancioni	adjective	Duolingo
arbitri	arbitri	noun	Duolingo
arbitro	arbitro	noun	Duolingo
architetto	architetto	noun	Duolingo
architettura	architettura	noun	Duolingo
argentina	argentina	adjective	Duolingo
argentini	argentini	adjective	Duolingo
argentino	argentino	adjective	Duolingo
argento	argento	noun	Duolingo
argomenti	argomenti	noun	Duolingo
argomento	argomento	noun	Duolingo
aria	aria	noun	Duolingo
arma	arma	noun	Duolingo
armi	armi	noun	Duolingo
arrabbiata	arrabbiata	adjective	Duolingo
arrabbiati	arrabbiati	adjective	Duolingo
arrabbiato	arrabbiato	adjective	Duolingo
arresto	arresto	noun	Duolingo
arriva	arriva	verb	Duolingo
arrivai	arrivai	verb	Duolingo
arrivando	arrivando	verb	Duolingo
arrivano	arrivano	verb	Duolingo
arrivare	arrivare	verb	Duolingo
arrivarono	arrivarono	verb	Duolingo
arrivasse	arrivasse	verb	Duolingo
arrivassi	arrivassi	verb	Duolingo
arrivate	arrivate	verb	Duolingo
arrivava	arrivava	verb	Duolingo
arrivederci	arrivederci	interjection	Duolingo
arriverà	arrivera	verb	Duolingo
arriverai	arriverai	verb	Duolingo
arriveranno	arriveranno	verb	Duolingo
arriverebbe	arriverebbe	verb	Duolingo
arriverei	arriverei	verb	Duolingo
arriveremo	arriveremo	verb	Duolingo
arriveresti	arriveresti	verb	Duolingo
arrivi	arrivi	noun	Duolingo
arrivi	arrivi	verb	Duolingo
arriviamo	arriviamo	verb	Duolingo
arrivino	arrivino	verb	Duolingo
arrivo	arrivo	noun	Duolingo
arrivò	arrivo	verb	Duolingo
arrostiamo	arrostiamo	verb	Duolingo
arrostisci	arrostisci	verb	Duolingo
arrostisco	arrostisco	verb	Duolingo
arte	arte	noun	Duolingo
articoli	articoli	noun	Duolingo
articolo	articolo	noun	Duolingo
artista	artista	noun	Duolingo
artisti	artisti	noun	Duolingo
ascensore	ascensore	noun	Duolingo
ascensori	ascensori	noun	Duolingo
asciuga	asciuga	verb	Duolingo
asciugamani	asciugamani	noun	Duolingo
asciugo	asciugo	verb	Duolingo
ascolta	ascolta	verb	Duolingo
ascoltano	ascoltano	verb	Duolingo
ascoltare	ascoltare	verb	Duolingo
ascoltiamo	ascoltiamo	verb	Duolingo
asia	asia	proper noun	Duolingo
asini	asini	noun	Duolingo
asino	asino	noun	Duolingo
aspetta	aspetta	verb	Duolingo
aspettai	aspettai	verb	Duolingo
aspettando	aspettando	verb	Duolingo
aspettare	aspettare	verb	Duolingo
aspettarono	aspettarono	verb	Duolingo
aspettasse	aspettasse	verb	Duolingo
aspettassero	aspettassero	verb	Duolingo
aspettassi	aspettassi	verb	Duolingo
aspettassimo	aspettassimo	verb	Duolingo
aspettate	aspettate	verb	Duolingo
aspettava	aspettava	verb	Duolingo
aspettavo	aspettavo	verb	Duolingo
aspetterà	aspettera	verb	Duolingo
aspetterai	aspetterai	verb	Duolingo
aspetteranno	aspetteranno	verb	Duolingo
aspetterei	aspetterei	verb	Duolingo
aspetteremo	aspetteremo	verb	Duolingo
aspettereste	aspettereste	verb	Duolingo
aspetterò	aspettero	verb	Duolingo
aspetti	aspetti	verb	Duolingo
aspettiamo	aspettiamo	verb	Duolingo
aspettino	aspettino	verb	Duolingo
aspetto	aspetto	noun	Duolingo
aspetto	aspetto	verb	Duolingo
assicurazione	assicurazione	noun	Duolingo
associazione	associazione	noun	Duolingo
assolutamente	assolutamente	adverb	Duolingo
atleta	atleta	noun	Duolingo
atleti	atleti	noun	Duolingo
atmosfera	atmosfera	noun	Duolingo
attacchi	attacchi	noun	Duolingo
attenta	attenta	adjective	Duolingo
attente	attente	adjective	Duolingo
attenti	attenti	adjective	Duolingo
attento	attento	adjective	Duolingo
attività	attivita	noun	Duolingo
attore	attore	noun	Duolingo
attori	attori	noun	Duolingo
attorno	attorno	adverb	Duolingo
attraversa	attraversa	verb	Duolingo
attraversano	attraversano	verb	Duolingo
attraversare	attraversare	verb	Duolingo
attraversi	attraversi	verb	Duolingo
attraverso	attraverso	adverb	Duolingo
attraverso	attraverso	verb	Duolingo
aula	aula	noun	Duolingo
australiana	australiana	adjective	Duolingo
australiano	australiano	adjective	Duolingo
austriaca	austriaca	adjective	Duolingo
austriaci	austriaci	adjective	Duolingo
austriaco	austriaco	adjective	Duolingo
auto	auto	noun	Duolingo
autobus	autobus	noun	Duolingo
automobile	automobile	noun	Duolingo
automobili	automobili	noun	Duolingo
autorità	autorita	noun	Duolingo
autunno	autunno	noun	Duolingo
avanti	avanti	adverb	Duolingo
avanzata	avanzata	adjective	Duolingo
avanzato	avanzato	adjective	Duolingo
avemmo	avemmo	verb	Duolingo
avendo	avendo	verb	Duolingo
aver	aver	verb	Duolingo
avere	avere	verb	Duolingo
avesse	avesse	verb	Duolingo
avessi	avessi	verb	Duolingo
avete	avete	verb	Duolingo
aveva	aveva	verb	Duolingo
avevamo	avevamo	verb	Duolingo
avevano	avevano	verb	Duolingo
avevate	avevate	verb	Duolingo
avevi	avevi	verb	Duolingo
avevo	avevo	verb	Duolingo
avrà	avra	verb	Duolingo
avrai	avrai	verb	Duolingo
avrebbe	avrebbe	verb	Duolingo
avremo	avremo	verb	Duolingo
avrò	avro	verb	Duolingo
avventura	avventura	noun	Duolingo
avventure	avventure	noun	Duolingo
avvocati	avvocati	noun	Duolingo
avvocato	avvocato	noun	Duolingo
azione	azione	noun	Duolingo
azzurra	azzurra	adjective	Duolingo
azzurre	azzurre	adjective	Duolingo
azzurri	azzurri	noun	Duolingo
azzurro	azzurro	noun	Duolingo
baci	baci	noun	Duolingo
bacia	bacia	verb	Duolingo
baciando	baciando	verb	Duolingo
baciano	baciano	verb	Duolingo
bacio	bacio	noun	Duolingo
bagnate	bagnate	adjective	Duolingo
bagnati	bagnati	adjective	Duolingo
bagnato	bagnato	adjective	Duolingo
bagno	bagno	noun	Duolingo
balcone	balcone	noun	Duolingo
balconi	balconi	noun	Duolingo
balena	balena	noun	Duolingo
ballando	ballando	verb	Duolingo
ballare	ballare	verb	Duolingo
balli	balli	noun	Duolingo
balliamo	balliamo	verb	Duolingo
ballo	ballo	noun	Duolingo
bambina	bambina	noun	Duolingo
bambine	bambine	noun	Duolingo
bambini	bambini	noun	Duolingo
bambino	bambino	noun	Duolingo
banana	banana	noun	Duolingo
banane	banane	noun	Duolingo
banca	banca	noun	Duolingo
bandiera	bandiera	noun	Duolingo
bar	bar	noun	Duolingo
barba	barba	noun	Duolingo
barca	barca	noun	Duolingo
bari	bari	proper noun	Duolingo
bassa	bassa	adjective	Duolingo
basse	basse	adjective	Duolingo
bassi	bassi	adjective	Duolingo
basso	basso	adjective	Duolingo
basta	basta	interjection	Duolingo
basta	basta	verb	Duolingo
battaglia	battaglia	noun	Duolingo
batteria	batteria	noun	Duolingo
bei	bei	adjective	Duolingo
bel	bel	adjective	Duolingo
bell'	bell'	adjective	Duolingo
bella	bella	adjective	Duolingo
belle	belle	adjective	Duolingo
bellezza	bellezza	noun	Duolingo
belli	belli	adjective	Duolingo
bello	bello	adjective	Duolingo
ben	ben	adverb	Duolingo
bene	bene	adverb	Duolingo
benessere	benessere	noun	Duolingo
benissimo	benissimo	adverb	Duolingo
bensì	bensi	conjunction	Duolingo
benzina	benzina	noun	Duolingo
bere	bere	verb	Duolingo
bevanda	bevanda	noun	Duolingo
beve	beve	verb	Duolingo
bevendo	bevendo	verb	Duolingo
bevete	bevete	verb	Duolingo
bevi	bevi	verb	Duolingo
beviamo	beviamo	verb	Duolingo
bevo	bevo	verb	Duolingo
bevono	bevono	verb	Duolingo
bianca	bianca	adjective	Duolingo
bianche	bianche	adjective	Duolingo
bianchi	bianchi	adjective	Duolingo
bianco	bianco	adjective	Duolingo
bianco	bianco	noun	Duolingo
biblioteca	biblioteca	noun	Duolingo
bicchiere	bicchiere	noun	Duolingo
bicchieri	bicchieri	noun	Duolingo
bici	bici	noun	Duolingo
bicicletta	bicicletta	noun	Duolingo
biciclette	biciclette	noun	Duolingo
biglietti	biglietti	noun	Duolingo
biglietto	biglietto	noun	Duolingo
biologia	biologia	noun	Duolingo
bionde	bionde	adjective	Duolingo
biondo	biondo	adjective	Duolingo
birra	birra	noun	Duolingo
biscotti	biscotti	noun	Duolingo
biscotto	biscotto	noun	Duolingo
bisogno	bisogno	noun	Duolingo
bistecca	bistecca	noun	Duolingo
bloccata	bloccata	verb	Duolingo
bloccate	bloccate	verb	Duolingo
bloccato	bloccato	verb	Duolingo
blu	blu	adjective	Duolingo
bocca	bocca	noun	Duolingo
bolle	bolle	verb	Duolingo
bolletta	bolletta	noun	Duolingo
borsa	borsa	noun	Duolingo
borse	borse	noun	Duolingo
boschi	boschi	noun	Duolingo
bosco	bosco	noun	Duolingo
bottiglia	bottiglia	noun	Duolingo
bottiglie	bottiglie	noun	Duolingo
bracci	bracci	noun	Duolingo
braccio	braccio	noun	Duolingo
brasile	brasile	proper noun	Duolingo
brasiliana	brasiliana		Duolingo
brasiliani	brasiliani	adjective	Duolingo
brasiliano	brasiliano		Duolingo
brasiliano	brasiliano	adjective	Duolingo
brava	brava	adjective	Duolingo
bravi	bravi	adjective	Duolingo
bravo	bravo	adjective	Duolingo
bretagna	bretagna	proper noun	Duolingo
breve	breve	adjective	Duolingo
brillante	brillante	adjective	Duolingo
brillanti	brillanti	adjective	Duolingo
brioche	brioche	noun	Duolingo
bruci	bruci	verb	Duolingo
brucia	brucia	verb	Duolingo
bruciare	bruciare	verb	Duolingo
brutta	brutta	adjective	Duolingo
brutte	brutte	adjective	Duolingo
brutti	brutti	adjective	Duolingo
brutto	brutto	adjective	Duolingo
bugia	bugia	noun	Duolingo
bugie	bugie	noun	Duolingo
buia	buia	adjective	Duolingo
buio	buio	adjective	Duolingo
buio	buio	noun	Duolingo
buon	buon	adjective	Duolingo
buona	buona	adjective	Duolingo
buonanotte	buonanotte	interjection	Duolingo
buonasera	buonasera	interjection	Duolingo
buone	buone	adjective	Duolingo
buongiorno	buongiorno	interjection	Duolingo
buoni	buoni	adjective	Duolingo
buono	buono	adjective	Duolingo
burro	burro	noun	Duolingo
busta	busta	noun	Duolingo
c'	c'	adverb	Duolingo
c'è	c'e		Duolingo
cade	cade	verb	Duolingo
cadere	cadere	verb	Duolingo
cadi	cadi	verb	Duolingo
cado	cado	verb	Duolingo
cadono	cadono	verb	Duolingo
caduta	caduta	noun	Duolingo
caffè	caffe	noun	Duolingo
cagna	cagna	noun	Duolingo
cagne	cagne	noun	Duolingo
calabria	calabria	proper noun	Duolingo
calciatore	calciatore	noun	Duolingo
calciatori	calciatori	noun	Duolingo
calciatrice	calciatrice	noun	Duolingo
calcio	calcio	noun	Duolingo
calda	calda	adjective	Duolingo
caldi	caldi	adjective	Duolingo
caldo	caldo	adjective	Duolingo
caldo	caldo	noun	Duolingo
calendario	calendario	noun	Duolingo
calma	calma	adjective	Duolingo
calme	calme	adjective	Duolingo
calza	calza	noun	Duolingo
calze	calze	noun	Duolingo
cambi	cambi	verb	Duolingo
cambia	cambia	verb	Duolingo
cambiando	cambiando	verb	Duolingo
cambiano	cambiano	verb	Duolingo
cambiare	cambiare	verb	Duolingo
cambiarono	cambiarono	verb	Duolingo
cambiasse	cambiasse	verb	Duolingo
cambiassero	cambiassero	verb	Duolingo
cambiassi	cambiassi	verb	Duolingo
cambiava	cambiava	verb	Duolingo
cambierà	cambiera	verb	Duolingo
cambierebbe	cambierebbe	verb	Duolingo
cambieremo	cambieremo	verb	Duolingo
cambieresti	cambieresti	verb	Duolingo
cambierò	cambiero	verb	Duolingo
cambino	cambino	verb	Duolingo
cambio	cambio	noun	Duolingo
cambio	cambio	verb	Duolingo
camera	camera	noun	Duolingo
camere	camere	noun	Duolingo
cameriere	cameriere	noun	Duolingo
camicetta	camicetta	noun	Duolingo
camicette	camicette	noun	Duolingo
camicia	camicia	noun	Duolingo
camicie	camicie	noun	Duolingo
caminetto	caminetto	noun	Duolingo
camion	camion	noun	Duolingo
cammina	cammina	verb	Duolingo
camminando	camminando	verb	Duolingo
camminano	camminano	verb	Duolingo
camminare	camminare	verb	Duolingo
cammini	cammini	verb	Duolingo
camminiamo	camminiamo	verb	Duolingo
cammino	cammino	verb	Duolingo
campagna	campagna	noun	Duolingo
campania	campania	proper noun	Duolingo
campeggi	campeggi	noun	Duolingo
campeggio	campeggio	noun	Duolingo
campi	campi	noun	Duolingo
campionati	campionati	noun	Duolingo
campionato	campionato	noun	Duolingo
campione	campione	noun	Duolingo
campo	campo	noun	Duolingo
canadese	canadese	adjective	Duolingo
canadesi	canadesi	adjective	Duolingo
canale	canale	noun	Duolingo
cancelli	cancelli	noun	Duolingo
cancello	cancello	noun	Duolingo
candidata	candidata	noun	Duolingo
candidati	candidati	noun	Duolingo
candidato	candidato	noun	Duolingo
cane	cane	noun	Duolingo
cani	cani	noun	Duolingo
canta	canta	verb	Duolingo
cantano	cantano	verb	Duolingo
cantante	cantante	noun	Duolingo
cantare	cantare	verb	Duolingo
cantiamo	cantiamo	verb	Duolingo
cantina	cantina	noun	Duolingo
canto	canto	verb	Duolingo
canzone	canzone	noun	Duolingo
canzoni	canzoni	noun	Duolingo
capace	capace	adjective	Duolingo
capaci	capaci	adjective	Duolingo
capacità	capacita	noun	Duolingo
capelli	capelli	noun	Duolingo
capello	capello	noun	Duolingo
capendo	capendo	verb	Duolingo
capi	capi	noun	Duolingo
capii	capii	verb	Duolingo
capimmo	capimmo	verb	Duolingo
capirai	capirai	verb	Duolingo
capiranno	capiranno	verb	Duolingo
capire	capire	verb	Duolingo
capirebbe	capirebbe	verb	Duolingo
capirebbero	capirebbero	verb	Duolingo
capiremo	capiremo	verb	Duolingo
capisca	capisca	verb	Duolingo
capisce	capisce	verb	Duolingo
capisci	capisci	verb	Duolingo
capisco	capisco	verb	Duolingo
capisse	capisse	verb	Duolingo
capissi	capissi	verb	Duolingo
capitano	capitano	noun	Duolingo
capitoli	capitoli	noun	Duolingo
capitolo	capitolo	noun	Duolingo
capiva	capiva	verb	Duolingo
capivo	capivo	verb	Duolingo
capo	capo	noun	Duolingo
capoluogo	capoluogo	noun	Duolingo
cappelli	cappelli	noun	Duolingo
cappello	cappello	noun	Duolingo
cappotti	cappotti	noun	Duolingo
cappotto	cappotto	noun	Duolingo
cappuccini	cappuccini	noun	Duolingo
cappuccino	cappuccino	noun	Duolingo
caramella	caramella	noun	Duolingo
caramelle	caramelle	noun	Duolingo
carattere	carattere	noun	Duolingo
carcere	carcere	noun	Duolingo
cari	cari	adjective	Duolingo
carina	carina	adjective	Duolingo
carino	carino	adjective	Duolingo
carne	carne	noun	Duolingo
caro	caro	adjective	Duolingo
carota	carota	noun	Duolingo
carriera	carriera	noun	Duolingo
carta	carta	noun	Duolingo
carta d'identità	carta d'identita		Duolingo
carta di credito	carta di credito		Duolingo
cartolina	cartolina	noun	Duolingo
cartoline	cartoline	noun	Duolingo
casa	casa	noun	Duolingo
cascata	cascata	noun	Duolingo
case	case	noun	Duolingo
caso	caso	noun	Duolingo
cassetto	cassetto	noun	Duolingo
castelli	castelli	noun	Duolingo
castello	castello	noun	Duolingo
categoria	categoria	noun	Duolingo
categorie	categorie	noun	Duolingo
cattedrale	cattedrale	noun	Duolingo
cattiva	cattiva	adjective	Duolingo
cattivi	cattivi	adjective	Duolingo
cattivo	cattivo	adjective	Duolingo
causa	causa	noun	Duolingo
cause	cause	noun	Duolingo
cavalla	cavalla	noun	Duolingo
cavalle	cavalle	noun	Duolingo
cavalli	cavalli	noun	Duolingo
cavallo	cavallo	noun	Duolingo
caviglia	caviglia	noun	Duolingo
cavolo	cavolo	noun	Duolingo
ce	ce		Duolingo
ce	ce	adverb	Duolingo
ce	ce	pronoun	Duolingo
celebrazione	celebrazione	noun	Duolingo
cena	cena	noun	Duolingo
cena	cena	verb	Duolingo
ceniamo	ceniamo	verb	Duolingo
centimetri	centimetri	noun	Duolingo
centimetro	centimetro	noun	Duolingo
cento	cento	numeral	Duolingo
centocinquanta	centocinquanta	numeral	Duolingo
centodieci	centodieci	numeral	Duolingo
centododici	centododici	numeral	Duolingo
centonove	centonove	numeral	Duolingo
centootto	centootto	numeral	Duolingo
centosessanta	centosessanta	numeral	Duolingo
centosette	centosette	numeral	Duolingo
centotrenta	centotrenta	numeral	Duolingo
centouno	centouno	numeral	Duolingo
centoventi	centoventi	numeral	Duolingo
centoventicinque	centoventicinque	numeral	Duolingo
centro	centro	noun	Duolingo
cerca	cerca	verb	Duolingo
cercando	cercando	verb	Duolingo
cercate	cercate	verb	Duolingo
cerchi	cerchi	verb	Duolingo
certa	certa	determiner	Duolingo
certamente	certamente	adverb	Duolingo
certe	certe	adjective	Duolingo
certe	certe	determiner	Duolingo
certi	certi	adjective	Duolingo
certi	certi	determiner	Duolingo
certo	certo	adverb	Duolingo
cervello	cervello	noun	Duolingo
che	che		Duolingo
che	che	adjective	Duolingo
che	che	conjunction	Duolingo
che	che	pronoun	Duolingo
che cosa	che cosa		Duolingo
chi	chi		Duolingo
chi	chi	pronoun	Duolingo
chiama	chiama	verb	Duolingo
chiamai	chiamai	verb	Duolingo
chiamando	chiamando	verb	Duolingo
chiamare	chiamare	verb	Duolingo
chiamarono	chiamarono	verb	Duolingo
chiamasse	chiamasse	verb	Duolingo
chiamassi	chiamassi	verb	Duolingo
chiamata	chiamata	noun	Duolingo
chiamate	chiamate	verb	Duolingo
chiamava	chiamava	verb	Duolingo
chiamavo	chiamavo	verb	Duolingo
chiamerà	chiamera	verb	Duolingo
chiamerai	chiamerai	verb	Duolingo
chiameranno	chiameranno	verb	Duolingo
chiamerei	chiamerei	verb	Duolingo
chiamereste	chiamereste	verb	Duolingo
chiamerò	chiamero	verb	Duolingo
chiami	chiami	verb	Duolingo
chiamiamoci	chiamiamoci	pronoun	Duolingo
chiamino	chiamino	verb	Duolingo
chiamo	chiamo	verb	Duolingo
chiara	chiara	adjective	Duolingo
chiaramente	chiaramente	adverb	Duolingo
chiaro	chiaro	adjective	Duolingo
chiave	chiave	noun	Duolingo
chiavi	chiavi	noun	Duolingo
chieda	chieda	verb	Duolingo
chiedano	chiedano	verb	Duolingo
chiede	chiede	verb	Duolingo
chiedemmo	chiedemmo	verb	Duolingo
chiedendo	chiedendo	verb	Duolingo
chiederanno	chiederanno	verb	Duolingo
chiedere	chiedere	verb	Duolingo
chiederei	chiederei	verb	Duolingo
chiederemo	chiederemo	verb	Duolingo
chiederò	chiedero	verb	Duolingo
chiedesse	chiedesse	verb	Duolingo
chiedete	chiedete	verb	Duolingo
chiedeva	chiedeva	verb	Duolingo
chiedi	chiedi	verb	Duolingo
chiediamo	chiediamo	verb	Duolingo
chiedo	chiedo	verb	Duolingo
chiesa	chiesa	noun	Duolingo
chiese	chiese	noun	Duolingo
chiese	chiese	verb	Duolingo
chilogrammi	chilogrammi	noun	Duolingo
chilogrammo	chilogrammo	noun	Duolingo
chilometri	chilometri	noun	Duolingo
chilometro	chilometro	noun	Duolingo
chimica	chimica	noun	Duolingo
chissà	chissa	adverb	Duolingo
chitarra	chitarra	noun	Duolingo
chiude	chiude	verb	Duolingo
chiudendo	chiudendo	verb	Duolingo
chiudere	chiudere	verb	Duolingo
chiudete	chiudete	verb	Duolingo
chiudi	chiudi	verb	Duolingo
chiudo	chiudo	verb	Duolingo
chiudono	chiudono	verb	Duolingo
chiunque	chiunque	pronoun	Duolingo
chiusa	chiusa	adjective	Duolingo
chiuse	chiuse	adjective	Duolingo
chiusi	chiusi	adjective	Duolingo
chiuso	chiuso	adjective	Duolingo
ci	ci	adverb	Duolingo
ci	ci	pronoun	Duolingo
ci piacciono	ci piacciono		Duolingo
ci piace	ci piace		Duolingo
ci sono	ci sono		Duolingo
ciao	ciao	interjection	Duolingo
cibo	cibo	noun	Duolingo
cielo	cielo	noun	Duolingo
cima	cima	noun	Duolingo
cina	cina	proper noun	Duolingo
cinema	cinema	noun	Duolingo
cinese	cinese	adjective	Duolingo
cinese	cinese	noun	Duolingo
cinesi	cinesi	adjective	Duolingo
cinghiale	cinghiale	noun	Duolingo
cinghiali	cinghiali	noun	Duolingo
cinquant'	cinquant'	numeral	Duolingo
cinquanta	cinquanta	numeral	Duolingo
cinquantanove	cinquantanove	numeral	Duolingo
cinque	cinque	numeral	Duolingo
cinquecento	cinquecento	numeral	Duolingo
cintura	cintura	noun	Duolingo
ciò	cio	pronoun	Duolingo
cioccolato	cioccolato	noun	Duolingo
ciotola	ciotola	noun	Duolingo
cipolla	cipolla	noun	Duolingo
circa	circa	adverb	Duolingo
circo	circo	noun	Duolingo
città	citta	noun	Duolingo
cittadina	cittadina	noun	Duolingo
cittadini	cittadini	noun	Duolingo
cittadino	cittadino	noun	Duolingo
classe	classe	noun	Duolingo
classica	classica	adjective	Duolingo
classico	classico	adjective	Duolingo
cliente	cliente	noun	Duolingo
clienti	clienti	noun	Duolingo
clima	clima	noun	Duolingo
clinica	clinica	noun	Duolingo
club	club	noun	Duolingo
coda	coda	noun	Duolingo
codice	codice	noun	Duolingo
codici	codici	noun	Duolingo
cognome	cognome	noun	Duolingo
cognomi	cognomi	noun	Duolingo
col	col	preposition	Duolingo
colazione	colazione	noun	Duolingo
collana	collana	noun	Duolingo
collane	collane	noun	Duolingo
collant	collant	noun	Duolingo
collega	collega	noun	Duolingo
collegamenti	collegamenti	noun	Duolingo
collegamento	collegamento	noun	Duolingo
colleghe	colleghe	noun	Duolingo
colleghi	colleghi	noun	Duolingo
collezione	collezione	noun	Duolingo
collina	collina	noun	Duolingo
colline	colline	noun	Duolingo
collo	collo	noun	Duolingo
colonnelli	colonnelli	noun	Duolingo
colorata	colorata	adjective	Duolingo
colorati	colorati	adjective	Duolingo
colore	colore	noun	Duolingo
colori	colori	noun	Duolingo
colpa	colpa	noun	Duolingo
colpiamo	colpiamo	verb	Duolingo
colpire	colpire	verb	Duolingo
colpisci	colpisci	verb	Duolingo
colpisco	colpisco	verb	Duolingo
coltello	coltello	noun	Duolingo
coltiva	coltiva	verb	Duolingo
coltivano	coltivano	verb	Duolingo
coltivare	coltivare	verb	Duolingo
coltivo	coltivo	verb	Duolingo
com'	com'	adverb	Duolingo
come	come	adverb	Duolingo
come	come	conjunction	Duolingo
come mai	come mai		Duolingo
come va	come va		Duolingo
cominciare	cominciare	verb	Duolingo
commenti	commenti	noun	Duolingo
commerciale	commerciale	adjective	Duolingo
commerciali	commerciali	adjective	Duolingo
commercio	commercio	noun	Duolingo
commessa	commessa	noun	Duolingo
commesso	commesso	noun	Duolingo
comoda	comoda	adjective	Duolingo
comode	comode	adjective	Duolingo
comodini	comodini	noun	Duolingo
comodino	comodino	noun	Duolingo
comodo	comodo	adjective	Duolingo
compagni	compagni	noun	Duolingo
compagnia	compagnia	noun	Duolingo
compagno	compagno	noun	Duolingo
compiti	compiti	noun	Duolingo
compito	compito	noun	Duolingo
compleanno	compleanno	noun	Duolingo
complesso	complesso	noun	Duolingo
completamente	completamente	adverb	Duolingo
comportamento	comportamento	noun	Duolingo
compra	compra	verb	Duolingo
comprando	comprando	verb	Duolingo
comprare	comprare	verb	Duolingo
compri	compri	verb	Duolingo
compriamo	compriamo	verb	Duolingo
compro	compro	verb	Duolingo
compromessi	compromessi	noun	Duolingo
compromesso	compromesso	noun	Duolingo
computer	computer	noun	Duolingo
comune	comune	adjective	Duolingo
comunicazione	comunicazione	noun	Duolingo
comunicazioni	comunicazioni	noun	Duolingo
comunità	comunita	noun	Duolingo
comunque	comunque	adverb	Duolingo
con	con	preposition	Duolingo
con chi	con chi		Duolingo
con cui	con cui		Duolingo
con quali	con quali	adjective	Duolingo
concerti	concerti	noun	Duolingo
concerto	concerto	noun	Duolingo
concetto	concetto	noun	Duolingo
concordare	concordare	verb	Duolingo
concorrenza	concorrenza	noun	Duolingo
condominio	condominio	noun	Duolingo
conduttore	conduttore	noun	Duolingo
conduttrice	conduttrice	noun	Duolingo
conferenza	conferenza	noun	Duolingo
confondere	confondere	verb	Duolingo
congressi	congressi	noun	Duolingo
congresso	congresso	noun	Duolingo
coniglio	coniglio	noun	Duolingo
conobbe	conobbe	verb	Duolingo
conobbi	conobbi	verb	Duolingo
conosca	conosca	verb	Duolingo
conoscano	conoscano	verb	Duolingo
conoscemmo	conoscemmo	verb	Duolingo
conoscendo	conoscendo	verb	Duolingo
conoscenza	conoscenza	noun	Duolingo
conoscere	conoscere	verb	Duolingo
conoscerebbe	conoscerebbe	verb	Duolingo
conoscerei	conoscerei	verb	Duolingo
conoscerete	conoscerete	verb	Duolingo
conoscesse	conoscesse	verb	Duolingo
conoscessi	conoscessi	verb	Duolingo
conoscete	conoscete	verb	Duolingo
conosceva	conosceva	verb	Duolingo
conosci	conosci	verb	Duolingo
conosciamo	conosciamo	verb	Duolingo
conosco	conosco	verb	Duolingo
conoscono	conoscono	verb	Duolingo
consapevole	consapevole	adjective	Duolingo
conseguenza	conseguenza	noun	Duolingo
conseguenze	conseguenze	noun	Duolingo
consigli	consigli	noun	Duolingo
consiglio	consiglio	noun	Duolingo
contadini	contadini	noun	Duolingo
contadino	contadino	noun	Duolingo
contando	contando	verb	Duolingo
contanti	contanti	noun	Duolingo
contenta	contenta	adjective	Duolingo
contenti	contenti	adjective	Duolingo
conti	conti	verb	Duolingo
continente	continente	noun	Duolingo
conto	conto	noun	Duolingo
contorno	contorno	noun	Duolingo
contratti	contratti	noun	Duolingo
contratto	contratto	noun	Duolingo
contro	contro	preposition	Duolingo
controllare	controllare	verb	Duolingo
controllo	controllo	verb	Duolingo
conversazione	conversazione	noun	Duolingo
conversazioni	conversazioni	noun	Duolingo
coperta	coperta	noun	Duolingo
coperte	coperte	noun	Duolingo
coppia	coppia	noun	Duolingo
coraggio	coraggio	noun	Duolingo
cornetti	cornetti	noun	Duolingo
cornetto	cornetto	noun	Duolingo
corona	corona	noun	Duolingo
corpi	corpi	noun	Duolingo
corpo	corpo	noun	Duolingo
corre	corre	verb	Duolingo
correndo	correndo	verb	Duolingo
correre	correre	verb	Duolingo
corretta	corretta	adjective	Duolingo
corri	corri	verb	Duolingo
corriamo	corriamo	verb	Duolingo
corro	corro	verb	Duolingo
corrono	corrono	verb	Duolingo
corruzione	corruzione	noun	Duolingo
corsa	corsa	noun	Duolingo
corso	corso	noun	Duolingo
corta	corta	adjective	Duolingo
corte	corte	adjective	Duolingo
cortile	cortile	noun	Duolingo
corto	corto	adjective	Duolingo
cos'	cos'	pronoun	Duolingo
cosa	cosa		Duolingo
cosa	cosa	noun	Duolingo
cosa	cosa	pronoun	Duolingo
coscienza	coscienza	noun	Duolingo
cose	cose	noun	Duolingo
così	cosi	adverb	Duolingo
così	cosi	conjunction	Duolingo
costa	costa	verb	Duolingo
costano	costano	verb	Duolingo
costante	costante	adjective	Duolingo
costare	costare	verb	Duolingo
costi	costi	noun	Duolingo
costo	costo	noun	Duolingo
costosa	costosa	adjective	Duolingo
costose	costose	adjective	Duolingo
costosi	costosi	adjective	Duolingo
costoso	costoso	adjective	Duolingo
costruendo	costruendo	verb	Duolingo
costruì	costrui	verb	Duolingo
costruiamo	costruiamo	verb	Duolingo
costruiate	costruiate	verb	Duolingo
costruimmo	costruimmo	verb	Duolingo
costruire	costruire	verb	Duolingo
costruirebbe	costruirebbe	verb	Duolingo
costruirei	costruirei	verb	Duolingo
costruiremo	costruiremo	verb	Duolingo
costruisca	costruisca	verb	Duolingo
costruiscano	costruiscano	verb	Duolingo
costruisci	costruisci	verb	Duolingo
costruissero	costruissero	verb	Duolingo
costruiva	costruiva	verb	Duolingo
costruzione	costruzione	noun	Duolingo
costruzioni	costruzioni	noun	Duolingo
costume	costume	noun	Duolingo
cotte	cotte	adjective	Duolingo
cotti	cotti	adjective	Duolingo
cotto	cotto	adjective	Duolingo
cravatta	cravatta	noun	Duolingo
cravatte	cravatte	noun	Duolingo
creda	creda	verb	Duolingo
credano	credano	verb	Duolingo
crede	crede	verb	Duolingo
credemmo	credemmo	verb	Duolingo
credendo	credendo	verb	Duolingo
crederà	credera	verb	Duolingo
crederai	crederai	verb	Duolingo
credere	credere	verb	Duolingo
crederebbe	crederebbe	verb	Duolingo
crederebbero	crederebbero	verb	Duolingo
credesse	credesse	verb	Duolingo
credessimo	credessimo	verb	Duolingo
credettero	credettero	verb	Duolingo
credeva	credeva	verb	Duolingo
credevano	credevano	verb	Duolingo
credevo	credevo	verb	Duolingo
credi	credi	verb	Duolingo
crediamo	crediamo	verb	Duolingo
credito	credito	noun	Duolingo
credo	credo	verb	Duolingo
credono	credono	verb	Duolingo
crema	crema	noun	Duolingo
cresce	cresce	verb	Duolingo
crescente	crescente	adjective	Duolingo
crescere	crescere	verb	Duolingo
cresciamo	cresciamo	verb	Duolingo
crescita	crescita	noun	Duolingo
crescono	crescono	verb	Duolingo
crimine	crimine	noun	Duolingo
crisi	crisi	noun	Duolingo
crostata	crostata	noun	Duolingo
cruciverba	cruciverba	noun	Duolingo
cruda	cruda	adjective	Duolingo
crude	crude	adjective	Duolingo
crudi	crudi	adjective	Duolingo
crudo	crudo	adjective	Duolingo
cucchiaio	cucchiaio	noun	Duolingo
cucina	cucina	noun	Duolingo
cucina	cucina	verb	Duolingo
cucinando	cucinando	verb	Duolingo
cuciniamo	cuciniamo	verb	Duolingo
cucino	cucino	verb	Duolingo
cugini	cugini	noun	Duolingo
cugino	cugino	noun	Duolingo
cui	cui		Duolingo
cultura	cultura	noun	Duolingo
culturale	culturale	adjective	Duolingo
culturali	culturali	adjective	Duolingo
culture	culture	noun	Duolingo
cuoca	cuoca	noun	Duolingo
cuochi	cuochi	noun	Duolingo
cuoco	cuoco	noun	Duolingo
cuoio	cuoio	noun	Duolingo
cuore	cuore	noun	Duolingo
cura	cura	noun	Duolingo
cuscini	cuscini	noun	Duolingo
cuscino	cuscino	noun	Duolingo
d'	d'	preposition	Duolingo
d'acqua	d'acqua		Duolingo
da	da	preposition	Duolingo
dà	da	verb	Duolingo
da chi	da chi		Duolingo
da cui	da cui		Duolingo
da donna	da donna		Duolingo
da quale	da quale	adjective	Duolingo
da quando	da quando		Duolingo
da quanto tempo	da quanto tempo		Duolingo
da tempo	da tempo	adverb	Duolingo
dagli	dagli	preposition	Duolingo
dai	dai	preposition	Duolingo
dal	dal	preposition	Duolingo
dall'	dall'	preposition	Duolingo
dalla	dalla	preposition	Duolingo
dalle	dalle	preposition	Duolingo
dallo	dallo	preposition	Duolingo
dammi	dammi	pronoun	Duolingo
dando	dando	verb	Duolingo
danni	danni	noun	Duolingo
danno	danno	noun	Duolingo
danno	danno	verb	Duolingo
dante	dante	proper noun	Duolingo
danza	danza	noun	Duolingo
dappertutto	dappertutto	adverb	Duolingo
darai	darai	verb	Duolingo
daranno	daranno	verb	Duolingo
dare	dare	verb	Duolingo
darebbe	darebbe	verb	Duolingo
darei	darei	verb	Duolingo
daresti	daresti	verb	Duolingo
darò	daro	verb	Duolingo
data	data	noun	Duolingo
date	date	noun	Duolingo
date	date	verb	Duolingo
dava	dava	verb	Duolingo
davamo	davamo	verb	Duolingo
davanti	davanti	preposition	Duolingo
davvero	davvero	adverb	Duolingo
debole	debole	adjective	Duolingo
deboli	deboli	adjective	Duolingo
decenni	decenni	noun	Duolingo
decennio	decennio	noun	Duolingo
decida	decida	verb	Duolingo
decide	decide	verb	Duolingo
decidendo	decidendo	verb	Duolingo
decideranno	decideranno	verb	Duolingo
decidere	decidere	verb	Duolingo
deciderebbe	deciderebbe	verb	Duolingo
deciderei	deciderei	verb	Duolingo
decideremo	decideremo	verb	Duolingo
decidesse	decidesse	verb	Duolingo
decidessero	decidessero	verb	Duolingo
decideva	decideva	verb	Duolingo
decidi	decidi	verb	Duolingo
decidiamo	decidiamo	verb	Duolingo
decima	decima	adjective	Duolingo
decimo	decimo	adjective	Duolingo
decise	decise	verb	Duolingo
decisione	decisione	noun	Duolingo
decisioni	decisioni	noun	Duolingo
decorando	decorando	verb	Duolingo
decorano	decorano	verb	Duolingo
decorare	decorare	verb	Duolingo
decoro	decoro	verb	Duolingo
definitiva	definitiva	adjective	Duolingo
definitivi	definitivi	adjective	Duolingo
definizione	definizione	noun	Duolingo
degli	degli		Duolingo
degli	degli	preposition	Duolingo
dei	dei		Duolingo
dei	dei	noun	Duolingo
dei	dei	preposition	Duolingo
del	del		Duolingo
del	del	preposition	Duolingo
delfino	delfino	noun	Duolingo
delitti	delitti	noun	Duolingo
dell'	dell'		Duolingo
dell'	dell'	preposition	Duolingo
della	della		Duolingo
della	della	preposition	Duolingo
delle	delle		Duolingo
delle	delle	preposition	Duolingo
dello	dello		Duolingo
dello	dello	preposition	Duolingo
democratica	democratica	adjective	Duolingo
democratici	democratici	adjective	Duolingo
democratico	democratico	adjective	Duolingo
democrazia	democrazia	noun	Duolingo
denaro	denaro	noun	Duolingo
dente	dente	noun	Duolingo
denti	denti	noun	Duolingo
dentifricio	dentifricio	noun	Duolingo
dentista	dentista	noun	Duolingo
dentro	dentro	adverb	Duolingo
dentro	dentro	preposition	Duolingo
depressione	depressione	noun	Duolingo
descrive	descrive	verb	Duolingo
descrivere	descrivere	verb	Duolingo
descrivi	descrivi	verb	Duolingo
descrizione	descrizione	noun	Duolingo
desideri	desideri	noun	Duolingo
desiderio	desiderio	noun	Duolingo
desse	desse	verb	Duolingo
dessert	dessert	noun	Duolingo
destinazione	destinazione	noun	Duolingo
destino	destino	noun	Duolingo
destra	destra	noun	Duolingo
destro	destro	adjective	Duolingo
dettagli	dettagli	noun	Duolingo
deve	deve	verb	Duolingo
devi	devi	verb	Duolingo
devo	devo	verb	Duolingo
devono	devono	verb	Duolingo
di	di	preposition	Duolingo
di chi	di chi		Duolingo
di chi è	di chi e		Duolingo
di cui	di cui		Duolingo
di fronte	di fronte	adverb	Duolingo
di latte	di latte		Duolingo
di mia madre	di mia madre		Duolingo
di mia zia	di mia zia		Duolingo
di mio padre	di mio padre		Duolingo
di più	di piu		Duolingo
di quale	di quale	adjective	Duolingo
di solito	di solito		Duolingo
di tanto in tanto	di tanto in tanto		Duolingo
di vino	di vino		Duolingo
dia	dia	verb	Duolingo
diagnosi	diagnosi	noun	Duolingo
dialoghi	dialoghi	noun	Duolingo
dialogo	dialogo	noun	Duolingo
diano	diano	verb	Duolingo
diario	diario	noun	Duolingo
dica	dica	verb	Duolingo
dice	dice	verb	Duolingo
dicembre	dicembre	noun	Duolingo
dicendo	dicendo	verb	Duolingo
dicessero	dicessero	verb	Duolingo
dicessi	dicessi	verb	Duolingo
dicessimo	dicessimo	verb	Duolingo
diceva	diceva	verb	Duolingo
dicevi	dicevi	verb	Duolingo
dicevo	dicevo	verb	Duolingo
diciamo	diciamo	verb	Duolingo
diciannove	diciannove	numeral	Duolingo
diciassette	diciassette	numeral	Duolingo
diciotto	diciotto	numeral	Duolingo
dico	dico	verb	Duolingo
dicono	dicono	verb	Duolingo
dieci	dieci	numeral	Duolingo
diede	diede	verb	Duolingo
dieta	dieta	noun	Duolingo
dietro	dietro	adverb	Duolingo
differente	differente	adjective	Duolingo
differenti	differenti	adjective	Duolingo
differenza	differenza	noun	Duolingo
differenze	differenze	noun	Duolingo
difficile	difficile	adjective	Duolingo
difficili	difficili	adjective	Duolingo
difficoltà	difficolta	noun	Duolingo
dignità	dignita	noun	Duolingo
dimentica	dimentica	verb	Duolingo
dimenticare	dimenticare	verb	Duolingo
dimentichiamo	dimentichiamo	verb	Duolingo
dimmi	dimmi	pronoun	Duolingo
dimostra	dimostra	verb	Duolingo
dimostrare	dimostrare	verb	Duolingo
dimostrazione	dimostrazione	noun	Duolingo
dimostro	dimostro	verb	Duolingo
dio	dio	noun	Duolingo
dipartimenti	dipartimenti	noun	Duolingo
dipartimento	dipartimento	noun	Duolingo
dipingere	dipingere	verb	Duolingo
diploma	diploma	noun	Duolingo
diplomazia	diplomazia	noun	Duolingo
dir	dir	verb	Duolingo
dirà	dira	verb	Duolingo
dirai	dirai	verb	Duolingo
dire	dire	verb	Duolingo
direbbe	direbbe	verb	Duolingo
direbbero	direbbero	verb	Duolingo
diremmo	diremmo	verb	Duolingo
direttamente	direttamente	adverb	Duolingo
direttore	direttore	noun	Duolingo
direttori	direttori	noun	Duolingo
direttrice	direttrice	noun	Duolingo
direzione	direzione	noun	Duolingo
dirgli	dirgli	pronoun	Duolingo
dirigenza	dirigenza	noun	Duolingo
diritta	diritta	adjective	Duolingo
diritte	diritte	adjective	Duolingo
diritti	diritti	noun	Duolingo
diritto	diritto	noun	Duolingo
dirò	diro	verb	Duolingo
discorsi	discorsi	noun	Duolingo
discorso	discorso	noun	Duolingo
discussione	discussione	noun	Duolingo
disegna	disegna	verb	Duolingo
disegnano	disegnano	verb	Duolingo
disegnare	disegnare	verb	Duolingo
disegni	disegni	verb	Duolingo
disegniamo	disegniamo	verb	Duolingo
disegno	disegno	noun	Duolingo
disegno	disegno	verb	Duolingo
dispiace	dispiace	verb	Duolingo
disponibile	disponibile	adjective	Duolingo
disponibili	disponibili	adjective	Duolingo
disse	disse	verb	Duolingo
dissi	dissi	verb	Duolingo
distanza	distanza	noun	Duolingo
dita	dita	noun	Duolingo
dite	dite	verb	Duolingo
dito	dito	noun	Duolingo
ditta	ditta	noun	Duolingo
dittatura	dittatura	noun	Duolingo
divani	divani	noun	Duolingo
divano	divano	noun	Duolingo
diventa	diventa	verb	Duolingo
diventammo	diventammo	verb	Duolingo
diventando	diventando	verb	Duolingo
diventare	diventare	verb	Duolingo
diventasse	diventasse	verb	Duolingo
diventassero	diventassero	verb	Duolingo
diventassi	diventassi	verb	Duolingo
diventava	diventava	verb	Duolingo
diventerai	diventerai	verb	Duolingo
diventerebbe	diventerebbe	verb	Duolingo
diventeremo	diventeremo	verb	Duolingo
diventi	diventi	verb	Duolingo
diventino	diventino	verb	Duolingo
divento	divento	verb	Duolingo
diversa	diversa	adjective	Duolingo
diverse	diverse	adjective	Duolingo
diverse	diverse	determiner	Duolingo
diversi	diversi	adjective	Duolingo
diversi	diversi	determiner	Duolingo
diverso	diverso	adjective	Duolingo
divertente	divertente	adjective	Duolingo
divertimenti	divertimenti	noun	Duolingo
divertimento	divertimento	noun	Duolingo
divisa	divisa	noun	Duolingo
divisione	divisione	noun	Duolingo
dizionari	dizionari	noun	Duolingo
dizionario	dizionario	noun	Duolingo
do	do	verb	Duolingo
dobbiamo	dobbiamo	verb	Duolingo
docce	docce	noun	Duolingo
doccia	doccia	noun	Duolingo
documentari	documentari	noun	Duolingo
documentario	documentario	noun	Duolingo
documenti	documenti	noun	Duolingo
documento	documento	noun	Duolingo
dodici	dodici	numeral	Duolingo
dolce	dolce	adjective	Duolingo
dolce	dolce	noun	Duolingo
dolci	dolci	adjective	Duolingo
dolci	dolci	noun	Duolingo
dollari	dollari	noun	Duolingo
dollaro	dollaro	noun	Duolingo
dolore	dolore	noun	Duolingo
dolori	dolori	noun	Duolingo
domanda	domanda	noun	Duolingo
domande	domande	noun	Duolingo
domani	domani	adverb	Duolingo
domenica	domenica	noun	Duolingo
donna	donna	noun	Duolingo
donne	donne	noun	Duolingo
dopo	dopo	adverb	Duolingo
dopo	dopo	preposition	Duolingo
dopodomani	dopodomani	adverb	Duolingo
doppio	doppio	adjective	Duolingo
doppio	doppio	noun	Duolingo
dorme	dorme	verb	Duolingo
dormendo	dormendo	verb	Duolingo
dormi	dormi	verb	Duolingo
dormiamo	dormiamo	verb	Duolingo
dormire	dormire	verb	Duolingo
dormo	dormo	verb	Duolingo
dormono	dormono	verb	Duolingo
dottore	dottore	noun	Duolingo
dottoressa	dottoressa	noun	Duolingo
dottoresse	dottoresse	noun	Duolingo
dottori	dottori	noun	Duolingo
dov'	dov'	adverb	Duolingo
dove	dove		Duolingo
dove	dove	adverb	Duolingo
dover	dover	verb	Duolingo
doveva	doveva	verb	Duolingo
dovevi	dovevi	verb	Duolingo
dovevo	dovevo	verb	Duolingo
dovrà	dovra	verb	Duolingo
dovrai	dovrai	verb	Duolingo
dovranno	dovranno	verb	Duolingo
dovrebbe	dovrebbe	verb	Duolingo
dovrei	dovrei	verb	Duolingo
dovremo	dovremo	verb	Duolingo
dovrò	dovro	verb	Duolingo
due	due	numeral	Duolingo
duecentosei	duecentosei	numeral	Duolingo
dunque	dunque	conjunction	Duolingo
duomo	duomo	noun	Duolingo
dura	dura	adjective	Duolingo
dura	dura	verb	Duolingo
durante	durante	preposition	Duolingo
durata	durata	noun	Duolingo
duro	duro	adjective	Duolingo
e	e	conjunction	Duolingo
è	e	verb	Duolingo
e-mail	e-mail	noun	Duolingo
ebbe	ebbe	verb	Duolingo
ebbi	ebbi	verb	Duolingo
eccellente	eccellente	adjective	Duolingo
eccellenti	eccellenti	adjective	Duolingo
ecco	ecco	adverb	Duolingo
economia	economia	noun	Duolingo
economici	economici	adjective	Duolingo
economico	economico	adjective	Duolingo
ed	ed	conjunction	Duolingo
ed io	ed io		Duolingo
edifici	edifici	noun	Duolingo
edificio	edificio	noun	Duolingo
educazione	educazione	noun	Duolingo
effetti	effetti	noun	Duolingo
effettivamente	effettivamente	adverb	Duolingo
effetto	effetto	noun	Duolingo
efficace	efficace	adjective	Duolingo
efficaci	efficaci	adjective	Duolingo
eguaglianza	eguaglianza	noun	Duolingo
elefante	elefante	noun	Duolingo
elefanti	elefanti	noun	Duolingo
elegante	elegante	adjective	Duolingo
elementi	elementi	noun	Duolingo
elemento	elemento	noun	Duolingo
elenco	elenco	noun	Duolingo
elettrica	elettrica	adjective	Duolingo
elettriche	elettriche	adjective	Duolingo
elettrici	elettrici	adjective	Duolingo
elettricità	elettricita	noun	Duolingo
elezioni	elezioni	noun	Duolingo
emanuela	emanuela	proper noun	Duolingo
emergenza	emergenza	noun	Duolingo
emilia	emilia	proper noun	Duolingo
emozionante	emozionante	adjective	Duolingo
emozione	emozione	noun	Duolingo
emozioni	emozioni	noun	Duolingo
energia	energia	noun	Duolingo
enorme	enorme	adjective	Duolingo
enormi	enormi	adjective	Duolingo
entra	entra	verb	Duolingo
entrambe	entrambe	pronoun	Duolingo
entrambi	entrambi	pronoun	Duolingo
entrando	entrando	verb	Duolingo
entrare	entrare	verb	Duolingo
entrarono	entrarono	verb	Duolingo
entrasse	entrasse	verb	Duolingo
entrassero	entrassero	verb	Duolingo
entrassi	entrassi	verb	Duolingo
entrata	entrata	noun	Duolingo
entrate	entrate	verb	Duolingo
entrava	entrava	verb	Duolingo
entravano	entravano	verb	Duolingo
entrerà	entrera	verb	Duolingo
entreranno	entreranno	verb	Duolingo
entrerebbe	entrerebbe	verb	Duolingo
entrerete	entrerete	verb	Duolingo
entri	entri	verb	Duolingo
entrino	entrino	verb	Duolingo
entro	entro	preposition	Duolingo
entrò	entro	verb	Duolingo
epoca	epoca	noun	Duolingo
eppure	eppure	adverb	Duolingo
era	era	verb	Duolingo
erano	erano	verb	Duolingo
eravamo	eravamo	verb	Duolingo
eravate	eravate	verb	Duolingo
erba	erba	noun	Duolingo
eri	eri	verb	Duolingo
ero	ero	verb	Duolingo
errore	errore	noun	Duolingo
errori	errori	noun	Duolingo
esame	esame	noun	Duolingo
esami	esami	noun	Duolingo
esattamente	esattamente	adverb	Duolingo
esecuzione	esecuzione	noun	Duolingo
esempi	esempi	noun	Duolingo
esempio	esempio	noun	Duolingo
eserciti	eserciti	noun	Duolingo
esercito	esercito	noun	Duolingo
esercizi	esercizi	noun	Duolingo
esercizio	esercizio	noun	Duolingo
esibizione	esibizione	noun	Duolingo
esistenza	esistenza	noun	Duolingo
esperienza	esperienza	noun	Duolingo
esperienze	esperienze	noun	Duolingo
esperta	esperta	noun	Duolingo
esperti	esperti	noun	Duolingo
esperto	esperto	noun	Duolingo
esplorate	esplorate	verb	Duolingo
esploriamo	esploriamo	verb	Duolingo
essendo	essendo	verb	Duolingo
essenza	essenza	noun	Duolingo
essenzialmente	essenzialmente	adverb	Duolingo
essere	essere	verb	Duolingo
est	est	noun	Duolingo
estate	estate	noun	Duolingo
estero	estero	noun	Duolingo
estremamente	estremamente	adverb	Duolingo
età	eta	noun	Duolingo
etica	etica	adjective	Duolingo
etico	etico	adjective	Duolingo
euro	euro	noun	Duolingo
europa	europa	proper noun	Duolingo
europea	europea	adjective	Duolingo
europeo	europeo	adjective	Duolingo
evoluzione	evoluzione	noun	Duolingo
ex	ex	adjective	Duolingo
fa	fa	adverb	Duolingo
fa	fa	verb	Duolingo
fa'	fa'	verb	Duolingo
fabbrica	fabbrica	noun	Duolingo
fabbriche	fabbriche	noun	Duolingo
faccia	faccia	noun	Duolingo
faccia	faccia	verb	Duolingo
facciamo	facciamo	verb	Duolingo
faccio	faccio	verb	Duolingo
facendo	facendo	verb	Duolingo
facesse	facesse	verb	Duolingo
facessi	facessi	verb	Duolingo
faceva	faceva	verb	Duolingo
facevano	facevano	verb	Duolingo
facevi	facevi	verb	Duolingo
facile	facile	adjective	Duolingo
facilmente	facilmente	adverb	Duolingo
fagiolo	fagiolo	noun	Duolingo
fai	fai	verb	Duolingo
fallimenti	fallimenti	noun	Duolingo
fallimento	fallimento	noun	Duolingo
fallire	fallire	verb	Duolingo
fallisce	fallisce	verb	Duolingo
fallisci	fallisci	verb	Duolingo
fallisco	fallisco	verb	Duolingo
falliscono	falliscono	verb	Duolingo
fama	fama	noun	Duolingo
fame	fame	noun	Duolingo
famiglia	famiglia	noun	Duolingo
familiare	familiare	adjective	Duolingo
famosa	famosa	adjective	Duolingo
famoso	famoso	adjective	Duolingo
fantasma	fantasma	noun	Duolingo
fantasmi	fantasmi	noun	Duolingo
farà	fara	verb	Duolingo
farai	farai	verb	Duolingo
faranno	faranno	verb	Duolingo
fare	fare	verb	Duolingo
farebbe	farebbe	verb	Duolingo
farebbero	farebbero	verb	Duolingo
farei	farei	verb	Duolingo
faremmo	faremmo	verb	Duolingo
faremo	faremo	verb	Duolingo
faresti	faresti	verb	Duolingo
farfalla	farfalla	noun	Duolingo
farfalle	farfalle	noun	Duolingo
farlo	farlo	pronoun	Duolingo
farmacia	farmacia	noun	Duolingo
farò	faro	verb	Duolingo
fase	fase	noun	Duolingo
fasi	fasi	noun	Duolingo
fate	fate	verb	Duolingo
fattoria	fattoria	noun	Duolingo
favore	favore	noun	Duolingo
fazzoletti	fazzoletti	noun	Duolingo
fazzoletto	fazzoletto	noun	Duolingo
febbraio	febbraio	noun	Duolingo
febbre	febbre	noun	Duolingo
fece	fece	verb	Duolingo
feci	feci	verb	Duolingo
fede	fede	noun	Duolingo
fegato	fegato	noun	Duolingo
felice	felice	adjective	Duolingo
felici	felici	adjective	Duolingo
felicità	felicita	noun	Duolingo
fellini	fellini	proper noun	Duolingo
femmina	femmina	noun	Duolingo
fenice	fenice	proper noun	Duolingo
fenomeni	fenomeni	noun	Duolingo
fenomeno	fenomeno	noun	Duolingo
feriamo	feriamo	verb	Duolingo
ferire	ferire	verb	Duolingo
ferisce	ferisce	verb	Duolingo
feriscono	feriscono	verb	Duolingo
ferma	ferma	verb	Duolingo
fermano	fermano	verb	Duolingo
fermare	fermare	verb	Duolingo
fermata	fermata	noun	Duolingo
fermo	fermo	verb	Duolingo
ferragosto	ferragosto	noun	Duolingo
ferroviaria	ferroviaria	adjective	Duolingo
ferroviario	ferroviario	adjective	Duolingo
festa	festa	noun	Duolingo
feste	feste	noun	Duolingo
festivo	festivo	adjective	Duolingo
fidanzata	fidanzata	noun	Duolingo
fidanzate	fidanzate	noun	Duolingo
fidanzato	fidanzato	noun	Duolingo
figli	figli	noun	Duolingo
figlia	figlia	noun	Duolingo
figlie	figlie	noun	Duolingo
figlio	figlio	noun	Duolingo
fila	fila	noun	Duolingo
file	file	noun	Duolingo
film	film	noun	Duolingo
filmare	filmare	verb	Duolingo
filosofia	filosofia	noun	Duolingo
filosofie	filosofie	noun	Duolingo
finale	finale	adjective	Duolingo
finalmente	finalmente	adverb	Duolingo
finanza	finanza	noun	Duolingo
finanziamenti	finanziamenti	noun	Duolingo
finanziamento	finanziamento	noun	Duolingo
finché	finche	conjunction	Duolingo
fine	fine	noun	Duolingo
finendo	finendo	verb	Duolingo
finestra	finestra	noun	Duolingo
finestre	finestre	noun	Duolingo
finì	fini	verb	Duolingo
finiamo	finiamo	verb	Duolingo
finirà	finira	verb	Duolingo
finirai	finirai	verb	Duolingo
finiranno	finiranno	verb	Duolingo
finire	finire	verb	Duolingo
finirebbe	finirebbe	verb	Duolingo
finiremo	finiremo	verb	Duolingo
finisca	finisca	verb	Duolingo
finisce	finisce	verb	Duolingo
finisci	finisci	verb	Duolingo
finisse	finisse	verb	Duolingo
finissero	finissero	verb	Duolingo
finiva	finiva	verb	Duolingo
finivamo	finivamo	verb	Duolingo
fino	fino	preposition	Duolingo
fiore	fiore	noun	Duolingo
fiori	fiori	noun	Duolingo
firenze	firenze	proper noun	Duolingo
fisica	fisica	adjective	Duolingo
fisica	fisica	noun	Duolingo
fisici	fisici	adjective	Duolingo
fiume	fiume	noun	Duolingo
fiumi	fiumi	noun	Duolingo
flauti	flauti	noun	Duolingo
flauto	flauto	noun	Duolingo
fogli	fogli	noun	Duolingo
foglio	foglio	noun	Duolingo
folla	folla	noun	Duolingo
fondamentale	fondamentale	adjective	Duolingo
fondo	fondo	noun	Duolingo
forchetta	forchetta	noun	Duolingo
forchette	forchette	noun	Duolingo
foresta	foresta	noun	Duolingo
forma	forma	noun	Duolingo
formaggio	formaggio	noun	Duolingo
formale	formale	adjective	Duolingo
formali	formali	adjective	Duolingo
forme	forme	noun	Duolingo
formica	formica	noun	Duolingo
formula	formula	noun	Duolingo
forno	forno	noun	Duolingo
forse	forse	adverb	Duolingo
forte	forte	adjective	Duolingo
fortemente	fortemente	adverb	Duolingo
forti	forti	adjective	Duolingo
fortuna	fortuna	noun	Duolingo
fortunata	fortunata	adjective	Duolingo
fortunatamente	fortunatamente	adverb	Duolingo
fortunati	fortunati	adjective	Duolingo
forza	forza	noun	Duolingo
forze	forze	noun	Duolingo
fosse	fosse	verb	Duolingo
fossi	fossi	verb	Duolingo
foste	foste	verb	Duolingo
foto	foto	noun	Duolingo
fotografare	fotografare	verb	Duolingo
fotografia	fotografia	noun	Duolingo
fotografica	fotografica	adjective	Duolingo
fotografiche	fotografiche	adjective	Duolingo
fotografie	fotografie	noun	Duolingo
fra	fra	preposition	Duolingo
fra cui	fra cui		Duolingo
fragola	fragola	noun	Duolingo
fragole	fragole	noun	Duolingo
francese	francese	adjective	Duolingo
francese	francese	noun	Duolingo
francesi	francesi	adjective	Duolingo
francesi	francesi	noun	Duolingo
francia	francia	proper noun	Duolingo
francobolli	francobolli	noun	Duolingo
francobollo	francobollo	noun	Duolingo
frase	frase	noun	Duolingo
fratelli	fratelli	noun	Duolingo
fratello	fratello	noun	Duolingo
fredda	fredda	adjective	Duolingo
freddo	freddo	adjective	Duolingo
frequente	frequente	adjective	Duolingo
frequentemente	frequentemente	adverb	Duolingo
frequenti	frequenti	adjective	Duolingo
frequenza	frequenza	noun	Duolingo
fresca	fresca	adjective	Duolingo
fresco	fresco	adjective	Duolingo
frigge	frigge	verb	Duolingo
friggi	friggi	verb	Duolingo
friggiamo	friggiamo	verb	Duolingo
frigoriferi	frigoriferi	noun	Duolingo
frigorifero	frigorifero	noun	Duolingo
fritto	fritto	adjective	Duolingo
fronte	fronte	noun	Duolingo
frontiera	frontiera	noun	Duolingo
frutta	frutta	noun	Duolingo
fruttivendoli	fruttivendoli	noun	Duolingo
fruttivendolo	fruttivendolo	noun	Duolingo
fu	fu	verb	Duolingo
fuma	fuma	verb	Duolingo
fumando	fumando	verb	Duolingo
fumare	fumare	verb	Duolingo
fumi	fumi	noun	Duolingo
fumiamo	fumiamo	verb	Duolingo
fummo	fummo	verb	Duolingo
fumo	fumo	noun	Duolingo
funghi	funghi	noun	Duolingo
fuoco	fuoco	noun	Duolingo
fuori	fuori	adverb	Duolingo
fuori	fuori	preposition	Duolingo
furba	furba	adjective	Duolingo
furbi	furbi	adjective	Duolingo
furbo	furbo	adjective	Duolingo
futura	futura	adjective	Duolingo
gabbia	gabbia	noun	Duolingo
galleria	galleria	noun	Duolingo
gallerie	gallerie	noun	Duolingo
gallina	gallina	noun	Duolingo
galline	galline	noun	Duolingo
gallo	gallo	noun	Duolingo
gamba	gamba	noun	Duolingo
gambe	gambe	noun	Duolingo
gara	gara	noun	Duolingo
garage	garage	noun	Duolingo
gas	gas	noun	Duolingo
gatte	gatte	noun	Duolingo
gatti	gatti	noun	Duolingo
gatto	gatto	noun	Duolingo
gelati	gelati	noun	Duolingo
gelato	gelato	noun	Duolingo
generale	generale	adjective	Duolingo
generalmente	generalmente	adverb	Duolingo
generazione	generazione	noun	Duolingo
generazioni	generazioni	noun	Duolingo
genitore	genitore	noun	Duolingo
genitori	genitori	noun	Duolingo
gennaio	gennaio	noun	Duolingo
gente	gente	noun	Duolingo
gentile	gentile	adjective	Duolingo
gentili	gentili	adjective	Duolingo
geografia	geografia	noun	Duolingo
germania	germania	proper noun	Duolingo
ghiaccio	ghiaccio	noun	Duolingo
già	gia	adverb	Duolingo
giacca	giacca	noun	Duolingo
gialla	gialla	adjective	Duolingo
gialle	gialle	adjective	Duolingo
gialli	gialli	adjective	Duolingo
giallo	giallo	adjective	Duolingo
giardini	giardini	noun	Duolingo
giardino	giardino	noun	Duolingo
ginocchio	ginocchio	noun	Duolingo
gioca	gioca	verb	Duolingo
giocammo	giocammo	verb	Duolingo
giocando	giocando	verb	Duolingo
giocano	giocano	verb	Duolingo
giocare	giocare	verb	Duolingo
giocarono	giocarono	verb	Duolingo
giocasse	giocasse	verb	Duolingo
giocassero	giocassero	verb	Duolingo
giocatore	giocatore	noun	Duolingo
giocatori	giocatori	noun	Duolingo
giocattoli	giocattoli	noun	Duolingo
giocattolo	giocattolo	noun	Duolingo
giocava	giocava	verb	Duolingo
giocavamo	giocavamo	verb	Duolingo
giocavano	giocavano	verb	Duolingo
giocherà	giochera	verb	Duolingo
giocheranno	giocheranno	verb	Duolingo
giocherebbe	giocherebbe	verb	Duolingo
giocherei	giocherei	verb	Duolingo
giocheresti	giocheresti	verb	Duolingo
giocherò	giochero	verb	Duolingo
giochi	giochi	noun	Duolingo
giochi	giochi	verb	Duolingo
giochiamo	giochiamo	verb	Duolingo
giochiate	giochiate	verb	Duolingo
gioco	gioco	noun	Duolingo
gioco	gioco	verb	Duolingo
gioia	gioia	noun	Duolingo
gioielleria	gioielleria	noun	Duolingo
giornale	giornale	noun	Duolingo
giornali	giornali	noun	Duolingo
giornalista	giornalista	noun	Duolingo
giornalisti	giornalisti	noun	Duolingo
giorni	giorni	noun	Duolingo
giorno	giorno	noun	Duolingo
giovane	giovane	adjective	Duolingo
giovane	giovane	noun	Duolingo
giovani	giovani	adjective	Duolingo
giovani	giovani	noun	Duolingo
giovedì	giovedi	noun	Duolingo
gira	gira	verb	Duolingo
girare	girare	verb	Duolingo
girate	girate	verb	Duolingo
giù	giu	adverb	Duolingo
giudica	giudica	verb	Duolingo
giudicare	giudicare	verb	Duolingo
giudice	giudice	noun	Duolingo
giudichiamo	giudichiamo	verb	Duolingo
giudici	giudici	noun	Duolingo
giudico	giudico	verb	Duolingo
giudizi	giudizi	noun	Duolingo
giudizio	giudizio	noun	Duolingo
giugno	giugno	noun	Duolingo
giusta	giusta	adjective	Duolingo
giustizia	giustizia	noun	Duolingo
giusto	giusto	adjective	Duolingo
gli	gli		Duolingo
gli	gli	determiner	Duolingo
gli	gli	pronoun	Duolingo
gli piace	gli piace		Duolingo
glielo	glielo	pronoun	Duolingo
globale	globale	adjective	Duolingo
gol	gol	noun	Duolingo
gola	gola	noun	Duolingo
gonna	gonna	noun	Duolingo
gonne	gonne	noun	Duolingo
gorilla	gorilla	noun	Duolingo
governatore	governatore	noun	Duolingo
governatrice	governatrice	noun	Duolingo
governi	governi	noun	Duolingo
governo	governo	noun	Duolingo
grammi	grammi	noun	Duolingo
grammo	grammo	noun	Duolingo
grande	grande	adjective	Duolingo
grandi	grandi	adjective	Duolingo
grandiosa	grandiosa	adjective	Duolingo
grandioso	grandioso	adjective	Duolingo
grassa	grassa	adjective	Duolingo
grasso	grasso	adjective	Duolingo
gratuita	gratuita	adjective	Duolingo
gratuito	gratuito	adjective	Duolingo
grave	grave	adjective	Duolingo
gravemente	gravemente	adverb	Duolingo
gravità	gravita	noun	Duolingo
grazie	grazie	interjection	Duolingo
greca	greca	adjective	Duolingo
greco	greco	adjective	Duolingo
grida	grida	verb	Duolingo
gridano	gridano	verb	Duolingo
grido	grido	noun	Duolingo
grigi	grigi	adjective	Duolingo
grigia	grigia	adjective	Duolingo
grigie	grigie	adjective	Duolingo
grigio	grigio	adjective	Duolingo
griglia	griglia	noun	Duolingo
grossi	grossi	adjective	Duolingo
grosso	grosso	adjective	Duolingo
gruppo	gruppo	noun	Duolingo
guadagna	guadagna	verb	Duolingo
guadagnare	guadagnare	verb	Duolingo
guai	guai	noun	Duolingo
guanti	guanti	noun	Duolingo
guanto	guanto	noun	Duolingo
guarda	guarda	verb	Duolingo
guardai	guardai	verb	Duolingo
guardammo	guardammo	verb	Duolingo
guardando	guardando	verb	Duolingo
guardare	guardare	verb	Duolingo
guardarono	guardarono	verb	Duolingo
guardasse	guardasse	verb	Duolingo
guardassi	guardassi	verb	Duolingo
guardate	guardate	verb	Duolingo
guardava	guardava	verb	Duolingo
guarderai	guarderai	verb	Duolingo
guarderebbe	guarderebbe	verb	Duolingo
guarderò	guardero	verb	Duolingo
guardi	guardi	verb	Duolingo
guardia	guardia	noun	Duolingo
guardiamo	guardiamo	verb	Duolingo
guardie	guardie	noun	Duolingo
guardò	guardo	verb	Duolingo
guerra	guerra	noun	Duolingo
guerre	guerre	noun	Duolingo
guida	guida	noun	Duolingo
guida	guida	verb	Duolingo
guidare	guidare	verb	Duolingo
guidiamo	guidiamo	verb	Duolingo
guido	guido	verb	Duolingo
gusto	gusto	noun	Duolingo
gustosa	gustosa	adjective	Duolingo
gustoso	gustoso	adjective	Duolingo
ha	ha	verb	Duolingo
hai	hai	verb	Duolingo
hanno	hanno	verb	Duolingo
ho	ho	verb	Duolingo
i	i		Duolingo
i	i	determiner	Duolingo
idea	idea	noun	Duolingo
ideale	ideale	adjective	Duolingo
idraulici	idraulici	noun	Duolingo
idraulico	idraulico	noun	Duolingo
ieri	ieri	adverb	Duolingo
il	il		Duolingo
il	il	determiner	Duolingo
imbarazzata	imbarazzata	adjective	Duolingo
immaginare	immaginare	verb	Duolingo
immaginazione	immaginazione	noun	Duolingo
immagine	immagine	noun	Duolingo
immagini	immagini	noun	Duolingo
immediatamente	immediatamente	adverb	Duolingo
imparare	imparare	verb	Duolingo
impari	impari	verb	Duolingo
impariamo	impariamo	verb	Duolingo
impegnata	impegnata	adjective	Duolingo
impegnato	impegnato	adjective	Duolingo
impermeabile	impermeabile	adjective	Duolingo
impermeabile	impermeabile	noun	Duolingo
impiegata	impiegata	noun	Duolingo
impiegato	impiegato	noun	Duolingo
importante	importante	adjective	Duolingo
importanza	importanza	noun	Duolingo
impossibile	impossibile	adjective	Duolingo
imprenditore	imprenditore	noun	Duolingo
impresa	impresa	noun	Duolingo
in	in	preposition	Duolingo
in cui	in cui		Duolingo
in mano	in mano		Duolingo
in quale	in quale	adjective	Duolingo
incidente	incidente	noun	Duolingo
includendo	includendo	verb	Duolingo
incontra	incontra	verb	Duolingo
incontrano	incontrano	verb	Duolingo
incontrare	incontrare	verb	Duolingo
incontri	incontri	noun	Duolingo
incontri	incontri	verb	Duolingo
incontriamo	incontriamo	verb	Duolingo
incontro	incontro	noun	Duolingo
indica	indica	verb	Duolingo
indicai	indicai	verb	Duolingo
indicando	indicando	verb	Duolingo
indicare	indicare	verb	Duolingo
indicasse	indicasse	verb	Duolingo
indicassi	indicassi	verb	Duolingo
indicava	indicava	verb	Duolingo
indicherebbe	indicherebbe	verb	Duolingo
indicherei	indicherei	verb	Duolingo
indicherò	indichero	verb	Duolingo
indichi	indichi	verb	Duolingo
indichiate	indichiate	verb	Duolingo
indicò	indico	verb	Duolingo
indietro	indietro	adverb	Duolingo
indipendente	indipendente	adjective	Duolingo
indipendenti	indipendenti	adjective	Duolingo
indipendenza	indipendenza	noun	Duolingo
indirizzi	indirizzi	noun	Duolingo
indirizzo	indirizzo	noun	Duolingo
individui	individui	noun	Duolingo
individuo	individuo	noun	Duolingo
indossa	indossa	verb	Duolingo
indossando	indossando	verb	Duolingo
indossare	indossare	verb	Duolingo
indossiamo	indossiamo	verb	Duolingo
indosso	indosso	verb	Duolingo
industria	industria	noun	Duolingo
industriale	industriale	adjective	Duolingo
industriali	industriali	adjective	Duolingo
infantile	infantile	adjective	Duolingo
infanzia	infanzia	noun	Duolingo
infatti	infatti	adverb	Duolingo
infermiera	infermiera	noun	Duolingo
infermiere	infermiere	noun	Duolingo
infine	infine	adverb	Duolingo
influenza	influenza	noun	Duolingo
informatica	informatica	noun	Duolingo
informazione	informazione	noun	Duolingo
informazioni	informazioni	noun	Duolingo
ingegnere	ingegnere	noun	Duolingo
ingegneri	ingegneri	noun	Duolingo
inghilterra	inghilterra	proper noun	Duolingo
inglese	inglese	adjective	Duolingo
inglese	inglese	noun	Duolingo
inglesi	inglesi	adjective	Duolingo
ingrediente	ingrediente	noun	Duolingo
ingressi	ingressi	noun	Duolingo
ingresso	ingresso	noun	Duolingo
inizi	inizi	noun	Duolingo
iniziare	iniziare	verb	Duolingo
inizio	inizio	noun	Duolingo
inquilini	inquilini	noun	Duolingo
inquilino	inquilino	noun	Duolingo
insalata	insalata	noun	Duolingo
insegna	insegna	verb	Duolingo
insegnante	insegnante	noun	Duolingo
insegnanti	insegnanti	noun	Duolingo
insegnare	insegnare	verb	Duolingo
insegni	insegni	verb	Duolingo
insegno	insegno	verb	Duolingo
insetti	insetti	noun	Duolingo
insetto	insetto	noun	Duolingo
insieme	insieme	adverb	Duolingo
insomma	insomma	adverb	Duolingo
intanto	intanto	adverb	Duolingo
intellettuale	intellettuale	adjective	Duolingo
intellettuali	intellettuali	adjective	Duolingo
intelligente	intelligente	adjective	Duolingo
intelligenza	intelligenza	noun	Duolingo
intenzione	intenzione	noun	Duolingo
interessante	interessante	adjective	Duolingo
interessanti	interessanti	adjective	Duolingo
interessata	interessata	adjective	Duolingo
interessato	interessato	adjective	Duolingo
interesse	interesse	noun	Duolingo
interessi	interessi	noun	Duolingo
interiore	interiore	noun	Duolingo
interiori	interiori	noun	Duolingo
internazionale	internazionale	adjective	Duolingo
internazionali	internazionali	adjective	Duolingo
internet	internet	noun	Duolingo
intero	intero	adjective	Duolingo
interpretazione	interpretazione	noun	Duolingo
interventi	interventi	noun	Duolingo
intervento	intervento	noun	Duolingo
intervista	intervista	noun	Duolingo
intorno	intorno	adverb	Duolingo
invece	invece	adverb	Duolingo
invenzione	invenzione	noun	Duolingo
invenzioni	invenzioni	noun	Duolingo
inverno	inverno	noun	Duolingo
inviamo	inviamo	verb	Duolingo
inviando	inviando	verb	Duolingo
inviare	inviare	verb	Duolingo
inviate	inviate	verb	Duolingo
invii	invii	verb	Duolingo
invita	invita	verb	Duolingo
invitare	invitare	verb	Duolingo
inviti	inviti	verb	Duolingo
invitiamo	invitiamo	verb	Duolingo
invito	invito	noun	Duolingo
io	io	pronoun	Duolingo
isola	isola	noun	Duolingo
isole	isole	noun	Duolingo
istituti	istituti	noun	Duolingo
istituto	istituto	noun	Duolingo
istituzione	istituzione	noun	Duolingo
istituzioni	istituzioni	noun	Duolingo
istruzioni	istruzioni	noun	Duolingo
italia	italia	proper noun	Duolingo
italiana	italiana	adjective	Duolingo
italiana	italiana	noun	Duolingo
italiani	italiani	adjective	Duolingo
italiani	italiani	noun	Duolingo
italiano	italiano	adjective	Duolingo
italiano	italiano	noun	Duolingo
jeans	jeans	noun	Duolingo
l'	l'		Duolingo
l'	l'	determiner	Duolingo
l'	l'	pronoun	Duolingo
la	la		Duolingo
là	la	adverb	Duolingo
la	la	determiner	Duolingo
la	la	pronoun	Duolingo
la preghiamo	la preghiamo	verb	Duolingo
la prego	la prego	verb	Duolingo
labbra	labbra	noun	Duolingo
laboratori	laboratori	noun	Duolingo
laboratorio	laboratorio	noun	Duolingo
lacrime	lacrime	noun	Duolingo
laghi	laghi	noun	Duolingo
lago	lago	noun	Duolingo
lampada	lampada	noun	Duolingo
lana	lana	noun	Duolingo
lascerà	lascera	verb	Duolingo
lascerai	lascerai	verb	Duolingo
lascerebbe	lascerebbe	verb	Duolingo
lascerebbero	lascerebbero	verb	Duolingo
lasceresti	lasceresti	verb	Duolingo
lascerò	lascero	verb	Duolingo
lasci	lasci	verb	Duolingo
lascia	lascia	verb	Duolingo
lasciai	lasciai	verb	Duolingo
lasciamo	lasciamo	verb	Duolingo
lasciando	lasciando	verb	Duolingo
lasciare	lasciare	verb	Duolingo
lasciarvi	lasciarvi	pronoun	Duolingo
lasciasse	lasciasse	verb	Duolingo
lasciate	lasciate	verb	Duolingo
lasciava	lasciava	verb	Duolingo
lasciavano	lasciavano	verb	Duolingo
lasciavo	lasciavo	verb	Duolingo
lasciò	lascio	verb	Duolingo
lati	lati	noun	Duolingo
latino	latino	noun	Duolingo
lato	lato	noun	Duolingo
latte	latte	noun	Duolingo
laurea	laurea	noun	Duolingo
lava	lava	verb	Duolingo
lavando	lavando	verb	Duolingo
lavare	lavare	verb	Duolingo
lavate	lavate	verb	Duolingo
lavi	lavi	verb	Duolingo
laviamo	laviamo	verb	Duolingo
lavo	lavo	verb	Duolingo
lavora	lavora	verb	Duolingo
lavorammo	lavorammo	verb	Duolingo
lavorando	lavorando	verb	Duolingo
lavorano	lavorano	verb	Duolingo
lavorare	lavorare	verb	Duolingo
lavorasse	lavorasse	verb	Duolingo
lavorate	lavorate	verb	Duolingo
lavorava	lavorava	verb	Duolingo
lavoravano	lavoravano	verb	Duolingo
lavoreranno	lavoreranno	verb	Duolingo
lavorerebbe	lavorerebbe	verb	Duolingo
lavorerebbero	lavorerebbero	verb	Duolingo
lavoreremo	lavoreremo	verb	Duolingo
lavorerò	lavorero	verb	Duolingo
lavori	lavori	noun	Duolingo
lavori	lavori	verb	Duolingo
lavoro	lavoro	noun	Duolingo
lavoro	lavoro	verb	Duolingo
lazio	lazio	proper noun	Duolingo
le	le		Duolingo
le	le	determiner	Duolingo
le	le	pronoun	Duolingo
le piace	le piace		Duolingo
legale	legale	adjective	Duolingo
legali	legali	adjective	Duolingo
legga	legga	verb	Duolingo
legge	legge	noun	Duolingo
legge	legge	verb	Duolingo
leggendo	leggendo	verb	Duolingo
leggera	leggera	adjective	Duolingo
leggerà	leggera	verb	Duolingo
leggeranno	leggeranno	verb	Duolingo
leggere	leggere	adjective	Duolingo
leggere	leggere	verb	Duolingo
leggerebbe	leggerebbe	verb	Duolingo
leggerei	leggerei	verb	Duolingo
leggeremo	leggeremo	verb	Duolingo
leggeresti	leggeresti	verb	Duolingo
leggeri	leggeri	adjective	Duolingo
leggero	leggero	adjective	Duolingo
leggerò	leggero	verb	Duolingo
leggesse	leggesse	verb	Duolingo
leggessero	leggessero	verb	Duolingo
leggessi	leggessi	verb	Duolingo
leggesti	leggesti	verb	Duolingo
leggete	leggete	verb	Duolingo
leggeva	leggeva	verb	Duolingo
leggevano	leggevano	verb	Duolingo
leggevo	leggevo	verb	Duolingo
leggi	leggi	noun	Duolingo
leggi	leggi	verb	Duolingo
leggiamo	leggiamo	verb	Duolingo
leggiate	leggiate	verb	Duolingo
leggo	leggo	verb	Duolingo
leggono	leggono	verb	Duolingo
legno	legno	noun	Duolingo
lei	lei	pronoun	Duolingo
lenta	lenta	adjective	Duolingo
lentamente	lentamente	adverb	Duolingo
lenti	lenti	adjective	Duolingo
lento	lento	adjective	Duolingo
lenzuola	lenzuola	noun	Duolingo
lenzuoli	lenzuoli	noun	Duolingo
leone	leone	noun	Duolingo
leonessa	leonessa	noun	Duolingo
lesse	lesse	verb	Duolingo
lessi	lessi	verb	Duolingo
lettera	lettera	noun	Duolingo
letteratura	letteratura	noun	Duolingo
lettere	lettere	noun	Duolingo
letti	letti	noun	Duolingo
letto	letto	noun	Duolingo
lettore	lettore	noun	Duolingo
lezione	lezione	noun	Duolingo
lezioni	lezioni	noun	Duolingo
lì	li	adverb	Duolingo
li	li	pronoun	Duolingo
libera	libera	adjective	Duolingo
liberazione	liberazione	noun	Duolingo
liberi	liberi	adjective	Duolingo
libero	libero	adjective	Duolingo
libertà	liberta	noun	Duolingo
libreria	libreria	noun	Duolingo
libri	libri	noun	Duolingo
libro	libro	noun	Duolingo
liceo	liceo	noun	Duolingo
liguria	liguria	proper noun	Duolingo
limonata	limonata	noun	Duolingo
limone	limone	noun	Duolingo
limpida	limpida	adjective	Duolingo
limpido	limpido	adjective	Duolingo
lingua	lingua	noun	Duolingo
linguaggio	linguaggio	noun	Duolingo
lingue	lingue	noun	Duolingo
litri	litri	noun	Duolingo
litro	litro	noun	Duolingo
livelli	livelli	noun	Duolingo
livello	livello	noun	Duolingo
lo	lo	determiner	Duolingo
lo	lo	pronoun	Duolingo
lo stesso	lo stesso		Duolingo
locale	locale	adjective	Duolingo
logica	logica	adjective	Duolingo
logico	logico	adjective	Duolingo
lombardia	lombardia	proper noun	Duolingo
lontana	lontana	adjective	Duolingo
lontano	lontano	adjective	Duolingo
loro	loro	determiner	Duolingo
loro	loro	pronoun	Duolingo
luce	luce	noun	Duolingo
luci	luci	noun	Duolingo
luglio	luglio	noun	Duolingo
lui	lui	pronoun	Duolingo
luminosa	luminosa	adjective	Duolingo
luminose	luminose	adjective	Duolingo
luminoso	luminoso	adjective	Duolingo
luna	luna	noun	Duolingo
lunedì	lunedi	noun	Duolingo
lunga	lunga	adjective	Duolingo
lunghe	lunghe	adjective	Duolingo
lunghi	lunghi	adjective	Duolingo
lungo	lungo	adjective	Duolingo
lungo	lungo	preposition	Duolingo
luoghi	luoghi	noun	Duolingo
luogo	luogo	noun	Duolingo
lupo	lupo	noun	Duolingo
ma	ma	conjunction	Duolingo
macchina	macchina	noun	Duolingo
macchine	macchine	noun	Duolingo
macedonia	macedonia	noun	Duolingo
macelleria	macelleria	noun	Duolingo
madre	madre	noun	Duolingo
madri	madri	noun	Duolingo
maestra	maestra	noun	Duolingo
maestri	maestri	noun	Duolingo
magari	magari	adverb	Duolingo
maggio	maggio	noun	Duolingo
maggioranza	maggioranza	noun	Duolingo
maggiore	maggiore	proper noun	Duolingo
maglia	maglia	noun	Duolingo
maglie	maglie	noun	Duolingo
maglietta	maglietta	noun	Duolingo
magliette	magliette	noun	Duolingo
maglione	maglione	noun	Duolingo
maglioni	maglioni	noun	Duolingo
magra	magra	adjective	Duolingo
magre	magre	adjective	Duolingo
mai	mai	adverb	Duolingo
maiale	maiale	noun	Duolingo
mal	mal	noun	Duolingo
malata	malata	adjective	Duolingo
malati	malati	adjective	Duolingo
malato	malato	adjective	Duolingo
malattia	malattia	noun	Duolingo
male	male	adverb	Duolingo
maleducata	maleducata	adjective	Duolingo
maleducate	maleducate	adjective	Duolingo
maleducati	maleducati	adjective	Duolingo
malissimo	malissimo	adverb	Duolingo
mamma	mamma	noun	Duolingo
manca	manca	verb	Duolingo
mancano	mancano	verb	Duolingo
mancare	mancare	verb	Duolingo
manco	manco	verb	Duolingo
manda	manda	verb	Duolingo
mandare	mandare	verb	Duolingo
mandarini	mandarini	noun	Duolingo
mandarino	mandarino	noun	Duolingo
mangerebbe	mangerebbe	verb	Duolingo
mangerebbero	mangerebbero	verb	Duolingo
mangeresti	mangeresti	verb	Duolingo
mangi	mangi	verb	Duolingo
mangia	mangia	verb	Duolingo
mangiamo	mangiamo	verb	Duolingo
mangiando	mangiando	verb	Duolingo
mangiano	mangiano	verb	Duolingo
mangiare	mangiare	verb	Duolingo
mangiate	mangiate	verb	Duolingo
mangio	mangio	verb	Duolingo
mani	mani	noun	Duolingo
manica	manica	noun	Duolingo
maniche	maniche	noun	Duolingo
maniera	maniera	noun	Duolingo
mano	mano	noun	Duolingo
manzo	manzo	noun	Duolingo
mappa	mappa	noun	Duolingo
mare	mare	noun	Duolingo
marie	marie	proper noun	Duolingo
mariti	mariti	noun	Duolingo
marito	marito	noun	Duolingo
marmellata	marmellata	noun	Duolingo
marrone	marrone	adjective	Duolingo
martedì	martedi	noun	Duolingo
marzo	marzo	noun	Duolingo
matematica	matematica	noun	Duolingo
matita	matita	noun	Duolingo
matite	matite	noun	Duolingo
matrimonio	matrimonio	noun	Duolingo
mattina	mattina	noun	Duolingo
matura	matura	adjective	Duolingo
mature	mature	adjective	Duolingo
maturi	maturi	adjective	Duolingo
maturo	maturo	adjective	Duolingo
me	me	pronoun	Duolingo
meccanici	meccanici	noun	Duolingo
meccanico	meccanico	noun	Duolingo
meccanismi	meccanismi	noun	Duolingo
meccanismo	meccanismo	noun	Duolingo
medici	medici	noun	Duolingo
medicina	medicina	noun	Duolingo
medicine	medicine	noun	Duolingo
medico	medico	noun	Duolingo
meditazione	meditazione	noun	Duolingo
meditazioni	meditazioni	noun	Duolingo
mediterraneo	mediterraneo	adjective	Duolingo
meglio	meglio	adverb	Duolingo
mela	mela	noun	Duolingo
mele	mele	noun	Duolingo
memoria	memoria	noun	Duolingo
meno	meno	adjective	Duolingo
meno	meno	adverb	Duolingo
meno	meno	preposition	Duolingo
meno male	meno male	adverb	Duolingo
mente	mente	noun	Duolingo
mente	mente	verb	Duolingo
menti	menti	noun	Duolingo
mentire	mentire	verb	Duolingo
mento	mento	verb	Duolingo
mentono	mentono	verb	Duolingo
mentre	mentre	conjunction	Duolingo
menu	menu	noun	Duolingo
meraviglioso	meraviglioso	adjective	Duolingo
mercati	mercati	noun	Duolingo
mercato	mercato	noun	Duolingo
mercoledì	mercoledi	noun	Duolingo
meridionale	meridionale	adjective	Duolingo
mese	mese	noun	Duolingo
mesi	mesi	noun	Duolingo
messaggi	messaggi	noun	Duolingo
messaggio	messaggio	noun	Duolingo
metà	meta	noun	Duolingo
metalli	metalli	noun	Duolingo
metallo	metallo	noun	Duolingo
metodi	metodi	noun	Duolingo
metodo	metodo	noun	Duolingo
metri	metri	noun	Duolingo
metro	metro	noun	Duolingo
metta	metta	verb	Duolingo
mettano	mettano	verb	Duolingo
mette	mette	verb	Duolingo
mettendo	mettendo	verb	Duolingo
metterà	mettera	verb	Duolingo
metterai	metterai	verb	Duolingo
metteranno	metteranno	verb	Duolingo
mettere	mettere	verb	Duolingo
metterebbe	metterebbe	verb	Duolingo
metterei	metterei	verb	Duolingo
metterla	metterla	pronoun	Duolingo
mettesse	mettesse	verb	Duolingo
mettessero	mettessero	verb	Duolingo
mettessi	mettessi	verb	Duolingo
mettete	mettete	verb	Duolingo
metteva	metteva	verb	Duolingo
mettevo	mettevo	verb	Duolingo
metti	metti	verb	Duolingo
metto	metto	verb	Duolingo
mezza	mezza	noun	Duolingo
mezzanotte	mezzanotte	noun	Duolingo
mezzi	mezzi	noun	Duolingo
mezzo	mezzo	adverb	Duolingo
mezzo	mezzo	noun	Duolingo
mezzogiorno	mezzogiorno	noun	Duolingo
mi	mi	pronoun	Duolingo
mi chiamo	mi chiamo		Duolingo
mi chiamo	mi chiamo	verb	Duolingo
mi fanno paura	mi fanno paura		Duolingo
mi metto	mi metto	verb	Duolingo
mi piacciono	mi piacciono		Duolingo
mi piace	mi piace		Duolingo
mia	mia	determiner	Duolingo
mia	mia	pronoun	Duolingo
mica	mica	adverb	Duolingo
mie	mie	determiner	Duolingo
mie	mie	pronoun	Duolingo
miei	miei	determiner	Duolingo
miei	miei	pronoun	Duolingo
miglio	miglio	noun	Duolingo
migliora	migliora	verb	Duolingo
migliorare	migliorare	verb	Duolingo
migliore	migliore	adjective	Duolingo
migliori	migliori	adjective	Duolingo
mila	mila	numeral	Duolingo
milione	milione	noun	Duolingo
milioni	milioni	noun	Duolingo
mille	mille	numeral	Duolingo
minestra	minestra	noun	Duolingo
minigonna	minigonna	noun	Duolingo
minuti	minuti	noun	Duolingo
minuto	minuto	noun	Duolingo
mio	mio	determiner	Duolingo
mio	mio	pronoun	Duolingo
mise	mise	verb	Duolingo
misi	misi	verb	Duolingo
mista	mista	adjective	Duolingo
misti	misti	adjective	Duolingo
misto	misto	adjective	Duolingo
misura	misura	noun	Duolingo
misure	misure	noun	Duolingo
mobile	mobile	noun	Duolingo
mobili	mobili	noun	Duolingo
mocassini	mocassini	noun	Duolingo
moda	moda	noun	Duolingo
moderna	moderna	adjective	Duolingo
moderne	moderne	adjective	Duolingo
moderni	moderni	adjective	Duolingo
moderno	moderno	adjective	Duolingo
modo	modo	noun	Duolingo
mogli	mogli	noun	Duolingo
moglie	moglie	noun	Duolingo
molta	molta	determiner	Duolingo
molte	molte	determiner	Duolingo
molti	molti	determiner	Duolingo
molti	molti	pronoun	Duolingo
moltissimo	moltissimo	adverb	Duolingo
molto	molto	adverb	Duolingo
molto	molto	determiner	Duolingo
momento	momento	noun	Duolingo
mondiale	mondiale	adjective	Duolingo
mondo	mondo	noun	Duolingo
moneta	moneta	noun	Duolingo
monete	monete	noun	Duolingo
monopattino	monopattino	noun	Duolingo
montagna	montagna	noun	Duolingo
montagne	montagne	noun	Duolingo
morendo	morendo	verb	Duolingo
morì	mori	verb	Duolingo
moriamo	moriamo	verb	Duolingo
moriate	moriate	verb	Duolingo
morirà	morira	verb	Duolingo
morirai	morirai	verb	Duolingo
morire	morire	verb	Duolingo
morirebbe	morirebbe	verb	Duolingo
morirei	morirei	verb	Duolingo
morirono	morirono	verb	Duolingo
morisse	morisse	verb	Duolingo
morissi	morissi	verb	Duolingo
moriva	moriva	verb	Duolingo
morivano	morivano	verb	Duolingo
morta	morta	adjective	Duolingo
morte	morte	adjective	Duolingo
morte	morte	noun	Duolingo
morti	morti	adjective	Duolingo
morti	morti	noun	Duolingo
mosca	mosca	noun	Duolingo
moschea	moschea	noun	Duolingo
mostra	mostra	noun	Duolingo
mostrando	mostrando	verb	Duolingo
mostriamo	mostriamo	verb	Duolingo
mostro	mostro	verb	Duolingo
motivi	motivi	noun	Duolingo
motivo	motivo	noun	Duolingo
moto	moto	noun	Duolingo
motocicletta	motocicletta	noun	Duolingo
motore	motore	noun	Duolingo
motorino	motorino	noun	Duolingo
movimenti	movimenti	noun	Duolingo
mucca	mucca	noun	Duolingo
mucche	mucche	noun	Duolingo
muoia	muoia	verb	Duolingo
muoiano	muoiano	verb	Duolingo
muoiono	muoiono	verb	Duolingo
muore	muore	verb	Duolingo
muri	muri	noun	Duolingo
muro	muro	noun	Duolingo
muscoli	muscoli	noun	Duolingo
muscolo	muscolo	noun	Duolingo
musei	musei	noun	Duolingo
museo	museo	noun	Duolingo
musica	musica	noun	Duolingo
musicista	musicista	noun	Duolingo
musicisti	musicisti	noun	Duolingo
mutande	mutande	noun	Duolingo
n'	n'	pronoun	Duolingo
nascita	nascita	noun	Duolingo
naso	naso	noun	Duolingo
natale	natale	noun	Duolingo
nati	nati	adjective	Duolingo
nato	nato	adjective	Duolingo
natura	natura	noun	Duolingo
naturale	naturale	adjective	Duolingo
naturali	naturali	adjective	Duolingo
naturalmente	naturalmente	adverb	Duolingo
nave	nave	noun	Duolingo
navi	navi	noun	Duolingo
nazionale	nazionale	adjective	Duolingo
nazionali	nazionali	adjective	Duolingo
nazione	nazione	noun	Duolingo
nazioni	nazioni	noun	Duolingo
né	ne	conjunction	Duolingo
ne	ne	pronoun	Duolingo
neanch'	neanch'	adverb	Duolingo
neanche	neanche	adverb	Duolingo
nebbia	nebbia	noun	Duolingo
necessari	necessari	adjective	Duolingo
necessariamente	necessariamente	adverb	Duolingo
necessario	necessario	adjective	Duolingo
necessità	necessita	noun	Duolingo
negativa	negativa	adjective	Duolingo
negative	negative	adjective	Duolingo
negativo	negativo	adjective	Duolingo
negli	negli	preposition	Duolingo
negozi	negozi	noun	Duolingo
negoziazione	negoziazione	noun	Duolingo
negoziazioni	negoziazioni	noun	Duolingo
negozio	negozio	noun	Duolingo
nei	nei	preposition	Duolingo
nel	nel	preposition	Duolingo
nell'	nell'	preposition	Duolingo
nella	nella	preposition	Duolingo
nelle	nelle	preposition	Duolingo
nello	nello	preposition	Duolingo
nemica	nemica	noun	Duolingo
nemici	nemici	noun	Duolingo
nemico	nemico	noun	Duolingo
nemmeno	nemmeno	adverb	Duolingo
neppure	neppure	adverb	Duolingo
nera	nera	adjective	Duolingo
nere	nere	adjective	Duolingo
neri	neri	adjective	Duolingo
nero	nero	adjective	Duolingo
nervosa	nervosa	adjective	Duolingo
nervose	nervose	adjective	Duolingo
nervosi	nervosi	adjective	Duolingo
nervoso	nervoso	adjective	Duolingo
nessun	nessun	determiner	Duolingo
nessuna	nessuna	determiner	Duolingo
nessuna	nessuna	pronoun	Duolingo
nessuno	nessuno	pronoun	Duolingo
neve	neve	noun	Duolingo
nevicando	nevicando	verb	Duolingo
nevicare	nevicare	verb	Duolingo
niente	niente	adjective	Duolingo
niente	niente	adverb	Duolingo
niente	niente	pronoun	Duolingo
nipote	nipote	noun	Duolingo
nipoti	nipoti	noun	Duolingo
no	no	adverb	Duolingo
noi	noi	pronoun	Duolingo
noiosa	noiosa	adjective	Duolingo
noioso	noioso	adjective	Duolingo
noleggiare	noleggiare	verb	Duolingo
nome	nome	noun	Duolingo
nomi	nomi	noun	Duolingo
non	non	adverb	Duolingo
nona	nona	adjective	Duolingo
nonna	nonna	noun	Duolingo
nonni	nonni	noun	Duolingo
nonno	nonno	noun	Duolingo
nono	nono	adjective	Duolingo
nonostante	nonostante	preposition	Duolingo
nord	nord	noun	Duolingo
normale	normale	adjective	Duolingo
normalmente	normalmente	adverb	Duolingo
nostra	nostra	determiner	Duolingo
nostra	nostra	pronoun	Duolingo
nostre	nostre	determiner	Duolingo
nostre	nostre	pronoun	Duolingo
nostri	nostri	determiner	Duolingo
nostri	nostri	pronoun	Duolingo
nostro	nostro	determiner	Duolingo
nostro	nostro	pronoun	Duolingo
nota	nota	noun	Duolingo
note	note	noun	Duolingo
notizia	notizia	noun	Duolingo
notizie	notizie	noun	Duolingo
notte	notte	noun	Duolingo
notti	notti	noun	Duolingo
novanta	novanta	numeral	Duolingo
nove	nove	numeral	Duolingo
novecento	novecento	numeral	Duolingo
novecentouno	novecentouno	numeral	Duolingo
novembre	novembre	noun	Duolingo
nulla	nulla	pronoun	Duolingo
numeri	numeri	noun	Duolingo
numero	numero	noun	Duolingo
numerosa	numerosa	adjective	Duolingo
numerose	numerose	adjective	Duolingo
nuota	nuota	verb	Duolingo
nuotando	nuotando	verb	Duolingo
nuotano	nuotano	verb	Duolingo
nuotare	nuotare	verb	Duolingo
nuotiamo	nuotiamo	verb	Duolingo
nuoto	nuoto	verb	Duolingo
nuova	nuova	adjective	Duolingo
nuove	nuove	adjective	Duolingo
nuovi	nuovi	adjective	Duolingo
nuovo	nuovo	adjective	Duolingo
nuvola	nuvola	noun	Duolingo
nuvole	nuvole	noun	Duolingo
nuvoloso	nuvoloso	adjective	Duolingo
o	o	conjunction	Duolingo
obiettivi	obiettivi	noun	Duolingo
obiettivo	obiettivo	noun	Duolingo
occasione	occasione	noun	Duolingo
occhi	occhi	noun	Duolingo
occhiali	occhiali	noun	Duolingo
occupando	occupando	verb	Duolingo
occupate	occupate	verb	Duolingo
occupo	occupo	verb	Duolingo
oceano	oceano	noun	Duolingo
oche	oche	noun	Duolingo
odiare	odiare	verb	Duolingo
odio	odio	noun	Duolingo
odore	odore	noun	Duolingo
offerta	offerta	noun	Duolingo
offra	offra	verb	Duolingo
offre	offre	verb	Duolingo
offrendo	offrendo	verb	Duolingo
offrì	offri	verb	Duolingo
offriamo	offriamo	verb	Duolingo
offrii	offrii	verb	Duolingo
offriranno	offriranno	verb	Duolingo
offrire	offrire	verb	Duolingo
offrirebbe	offrirebbe	verb	Duolingo
offrirebbero	offrirebbero	verb	Duolingo
offrirei	offrirei	verb	Duolingo
offriremo	offriremo	verb	Duolingo
offrirete	offrirete	verb	Duolingo
offrirò	offriro	verb	Duolingo
offrisse	offrisse	verb	Duolingo
offrissero	offrissero	verb	Duolingo
offrissi	offrissi	verb	Duolingo
offriva	offriva	verb	Duolingo
offrivano	offrivano	verb	Duolingo
offro	offro	verb	Duolingo
oggetti	oggetti	noun	Duolingo
oggetto	oggetto	noun	Duolingo
oggi	oggi	adverb	Duolingo
ogni	ogni	determiner	Duolingo
ognuna	ognuna	pronoun	Duolingo
ognuno	ognuno	pronoun	Duolingo
oh	oh	interjection	Duolingo
olandese	olandese	adjective	Duolingo
olio	olio	noun	Duolingo
oliva	oliva	noun	Duolingo
olive	olive		Duolingo
oltre	oltre	adverb	Duolingo
oltretutto	oltretutto	adverb	Duolingo
ombra	ombra	noun	Duolingo
ombrelli	ombrelli	noun	Duolingo
ombrello	ombrello	noun	Duolingo
online	online	adjective	Duolingo
onore	onore	noun	Duolingo
operai	operai	noun	Duolingo
operaia	operaia	noun	Duolingo
operaio	operaio	noun	Duolingo
opinione	opinione	noun	Duolingo
opinioni	opinioni	noun	Duolingo
opportunità	opportunita	noun	Duolingo
oppure	oppure	conjunction	Duolingo
opzione	opzione	noun	Duolingo
opzioni	opzioni	noun	Duolingo
ora	ora	adverb	Duolingo
ora	ora	noun	Duolingo
ora che	ora che	conjunction	Duolingo
ordina	ordina	verb	Duolingo
ordinare	ordinare	verb	Duolingo
ordino	ordino	verb	Duolingo
ore	ore	noun	Duolingo
orecchi	orecchi	noun	Duolingo
orecchio	orecchio	noun	Duolingo
organi	organi	noun	Duolingo
organizzazione	organizzazione	noun	Duolingo
organo	organo	noun	Duolingo
originale	originale	adjective	Duolingo
originali	originali	adjective	Duolingo
origine	origine	noun	Duolingo
orologi	orologi	noun	Duolingo
orologio	orologio	noun	Duolingo
orso	orso	noun	Duolingo
ospedale	ospedale	noun	Duolingo
ospite	ospite	noun	Duolingo
ospiti	ospiti	noun	Duolingo
osso	osso	noun	Duolingo
ottanta	ottanta	numeral	Duolingo
ottavo	ottavo	adjective	Duolingo
ottima	ottima	adjective	Duolingo
ottimi	ottimi	adjective	Duolingo
ottimo	ottimo	adjective	Duolingo
otto	otto	numeral	Duolingo
ottobre	ottobre	noun	Duolingo
ottocento	ottocento	numeral	Duolingo
ottocentocinquanta	ottocentocinquanta	numeral	Duolingo
ottocentoventisette	ottocentoventisette	numeral	Duolingo
ovest	ovest	noun	Duolingo
ovunque	ovunque	adverb	Duolingo
ovviamente	ovviamente	adverb	Duolingo
pace	pace	noun	Duolingo
padre	padre	noun	Duolingo
padri	padri	noun	Duolingo
paesaggio	paesaggio	noun	Duolingo
paese	paese	noun	Duolingo
paesi	paesi	noun	Duolingo
paga	paga	verb	Duolingo
pagamenti	pagamenti	noun	Duolingo
pagamento	pagamento	noun	Duolingo
pagando	pagando	verb	Duolingo
pagano	pagano	verb	Duolingo
pagare	pagare	verb	Duolingo
pagate	pagate	verb	Duolingo
pagella	pagella	noun	Duolingo
pagelle	pagelle	noun	Duolingo
paghiamo	paghiamo	verb	Duolingo
pagina	pagina	noun	Duolingo
pagine	pagine	noun	Duolingo
pagliacci	pagliacci	noun	Duolingo
pagliaccio	pagliaccio	noun	Duolingo
paio	paio	noun	Duolingo
palazzi	palazzi	noun	Duolingo
palazzo	palazzo	noun	Duolingo
palchi	palchi	noun	Duolingo
palco	palco	noun	Duolingo
palcoscenico	palcoscenico	noun	Duolingo
palestra	palestra	noun	Duolingo
palla	palla	noun	Duolingo
pallacanestro	pallacanestro	noun	Duolingo
pancia	pancia	noun	Duolingo
pane	pane	noun	Duolingo
panetteria	panetteria	noun	Duolingo
panini	panini	noun	Duolingo
panino	panino	noun	Duolingo
pantaloni	pantaloni	noun	Duolingo
papà	papa	noun	Duolingo
paragrafi	paragrafi	noun	Duolingo
paragrafo	paragrafo	noun	Duolingo
parcheggi	parcheggi	verb	Duolingo
parcheggiamo	parcheggiamo	verb	Duolingo
parcheggiano	parcheggiano	verb	Duolingo
parco	parco	noun	Duolingo
parecchi	parecchi	determiner	Duolingo
parecchia	parecchia	determiner	Duolingo
parecchie	parecchie	determiner	Duolingo
parecchio	parecchio	determiner	Duolingo
parete	parete	noun	Duolingo
pareti	pareti	noun	Duolingo
parla	parla	verb	Duolingo
parlai	parlai	verb	Duolingo
parlamenti	parlamenti	noun	Duolingo
parlamento	parlamento	noun	Duolingo
parlammo	parlammo	verb	Duolingo
parlando	parlando	verb	Duolingo
parlano	parlano	verb	Duolingo
parlar	parlar	verb	Duolingo
parlare	parlare	verb	Duolingo
parlasse	parlasse	verb	Duolingo
parlassi	parlassi	verb	Duolingo
parlate	parlate	verb	Duolingo
parlava	parlava	verb	Duolingo
parlavano	parlavano	verb	Duolingo
parlerebbe	parlerebbe	verb	Duolingo
parlerei	parlerei	verb	Duolingo
parlerò	parlero	verb	Duolingo
parli	parli	verb	Duolingo
parliamo	parliamo	verb	Duolingo
parlò	parlo	verb	Duolingo
parola	parola	noun	Duolingo
parole	parole	noun	Duolingo
parte	parte	noun	Duolingo
parte	parte	verb	Duolingo
partendo	partendo	verb	Duolingo
partenza	partenza	noun	Duolingo
parti	parti	verb	Duolingo
partiamo	partiamo	verb	Duolingo
particolare	particolare	adjective	Duolingo
particolari	particolari	adjective	Duolingo
particolarmente	particolarmente	adverb	Duolingo
partirai	partirai	verb	Duolingo
partire	partire	verb	Duolingo
partiremo	partiremo	verb	Duolingo
partirò	partiro	verb	Duolingo
partita	partita	noun	Duolingo
partite	partite	noun	Duolingo
partite	partite	verb	Duolingo
partiti	partiti	noun	Duolingo
partito	partito	noun	Duolingo
parto	parto	verb	Duolingo
passa	passa	verb	Duolingo
passai	passai	verb	Duolingo
passammo	passammo	verb	Duolingo
passando	passando	verb	Duolingo
passano	passano	verb	Duolingo
passaporto	passaporto	noun	Duolingo
passare	passare	verb	Duolingo
passarono	passarono	verb	Duolingo
passarti	passarti	pronoun	Duolingo
passasse	passasse	verb	Duolingo
passassero	passassero	verb	Duolingo
passava	passava	verb	Duolingo
passeggeri	passeggeri	noun	Duolingo
passeggiata	passeggiata	noun	Duolingo
passerai	passerai	verb	Duolingo
passerebbe	passerebbe	verb	Duolingo
passeremmo	passeremmo	verb	Duolingo
passeresti	passeresti	verb	Duolingo
passi	passi	noun	Duolingo
passi	passi	verb	Duolingo
passiamo	passiamo	verb	Duolingo
passiamola	passiamola	pronoun	Duolingo
passino	passino	verb	Duolingo
passione	passione	noun	Duolingo
passo	passo	noun	Duolingo
passo	passo	verb	Duolingo
password	password	noun	Duolingo
pasta	pasta	noun	Duolingo
pasticceria	pasticceria	noun	Duolingo
pasticcerie	pasticcerie	noun	Duolingo
pasto	pasto	noun	Duolingo
patata	patata	noun	Duolingo
patente	patente	noun	Duolingo
patria	patria	noun	Duolingo
paura	paura	noun	Duolingo
pavimento	pavimento	noun	Duolingo
paziente	paziente	noun	Duolingo
pazienti	pazienti	noun	Duolingo
pazienza	pazienza	noun	Duolingo
pechino	pechino	proper noun	Duolingo
pecora	pecora	noun	Duolingo
pecore	pecore	noun	Duolingo
pedonale	pedonale	adjective	Duolingo
pedonali	pedonali	adjective	Duolingo
peggio	peggio	adverb	Duolingo
peggiore	peggiore	adjective	Duolingo
peggiori	peggiori	adjective	Duolingo
pelle	pelle	noun	Duolingo
penna	penna	noun	Duolingo
penne	penne	noun	Duolingo
pensa	pensa	verb	Duolingo
pensammo	pensammo	verb	Duolingo
pensando	pensando	verb	Duolingo
pensano	pensano	verb	Duolingo
pensarci	pensarci	pronoun	Duolingo
pensare	pensare	verb	Duolingo
pensarono	pensarono	verb	Duolingo
pensasse	pensasse	verb	Duolingo
pensassi	pensassi	verb	Duolingo
pensava	pensava	verb	Duolingo
pensavi	pensavi	verb	Duolingo
pensavo	pensavo	verb	Duolingo
penserà	pensera	verb	Duolingo
penserai	penserai	verb	Duolingo
penseranno	penseranno	verb	Duolingo
penserebbero	penserebbero	verb	Duolingo
penserei	penserei	verb	Duolingo
penseremo	penseremo	verb	Duolingo
penserò	pensero	verb	Duolingo
pensi	pensi	verb	Duolingo
pensiamo	pensiamo	verb	Duolingo
pensiamoci	pensiamoci	pronoun	Duolingo
pensieri	pensieri	noun	Duolingo
pensiero	pensiero	noun	Duolingo
pensione	pensione	noun	Duolingo
penso	penso	verb	Duolingo
pepe	pepe	noun	Duolingo
peperone	peperone	noun	Duolingo
peperoni	peperoni	noun	Duolingo
per	per	preposition	Duolingo
per chi	per chi		Duolingo
per cui	per cui		Duolingo
per favore	per favore		Duolingo
per favore	per favore	interjection	Duolingo
per noi	per noi		Duolingo
pera	pera	noun	Duolingo
percento	percento	adverb	Duolingo
perché	perche	adverb	Duolingo
perché	perche	conjunction	Duolingo
perda	perda	verb	Duolingo
perde	perde	verb	Duolingo
perdendo	perdendo	verb	Duolingo
perderà	perdera	verb	Duolingo
perderai	perderai	verb	Duolingo
perdere	perdere	verb	Duolingo
perderebbe	perderebbe	verb	Duolingo
perderemmo	perderemmo	verb	Duolingo
perderò	perdero	verb	Duolingo
perdessero	perdessero	verb	Duolingo
perdessi	perdessi	verb	Duolingo
perdessimo	perdessimo	verb	Duolingo
perdete	perdete	verb	Duolingo
perdevamo	perdevamo	verb	Duolingo
perdevano	perdevano	verb	Duolingo
perdita	perdita	noun	Duolingo
perdo	perdo	verb	Duolingo
perdono	perdono	verb	Duolingo
pere	pere	noun	Duolingo
perfetta	perfetta	adjective	Duolingo
perfettamente	perfettamente	adverb	Duolingo
perfetti	perfetti	adjective	Duolingo
perfetto	perfetto	adjective	Duolingo
perfino	perfino	adverb	Duolingo
pericoli	pericoli	noun	Duolingo
pericolo	pericolo	noun	Duolingo
pericolosa	pericolosa	adjective	Duolingo
pericolosi	pericolosi	adjective	Duolingo
pericoloso	pericoloso	adjective	Duolingo
periodo	periodo	noun	Duolingo
però	pero	adverb	Duolingo
perse	perse	verb	Duolingo
persi	persi	verb	Duolingo
persona	persona	noun	Duolingo
personaggi	personaggi	noun	Duolingo
personaggio	personaggio	noun	Duolingo
personale	personale	adjective	Duolingo
personale	personale	noun	Duolingo
personali	personali	adjective	Duolingo
personalità	personalita	noun	Duolingo
persone	persone	noun	Duolingo
pesante	pesante	adjective	Duolingo
pesanti	pesanti	adjective	Duolingo
pesca	pesca	verb	Duolingo
pescano	pescano	verb	Duolingo
pescare	pescare	verb	Duolingo
pescatore	pescatore	noun	Duolingo
pescatrice	pescatrice	noun	Duolingo
pesce	pesce	noun	Duolingo
pesci	pesci	noun	Duolingo
petizione	petizione	noun	Duolingo
pettinando	pettinando	verb	Duolingo
pettine	pettine	noun	Duolingo
pettino	pettino	verb	Duolingo
petto	petto	noun	Duolingo
pezzi	pezzi	noun	Duolingo
pezzo	pezzo	noun	Duolingo
piaccia	piaccia	verb	Duolingo
piaccio	piaccio	verb	Duolingo
piacciono	piacciono	verb	Duolingo
piace	piace	verb	Duolingo
piacendo	piacendo	verb	Duolingo
piacerà	piacera	verb	Duolingo
piacere	piacere	interjection	Duolingo
piacere	piacere	noun	Duolingo
piacere	piacere	verb	Duolingo
piacerebbe	piacerebbe	verb	Duolingo
piacesse	piacesse	verb	Duolingo
piaceva	piaceva	verb	Duolingo
piacque	piacque	verb	Duolingo
piacquero	piacquero	verb	Duolingo
pianeta	pianeta	noun	Duolingo
piange	piange	verb	Duolingo
piangere	piangere	verb	Duolingo
piangi	piangi	verb	Duolingo
piani	piani	noun	Duolingo
pianifica	pianifica	verb	Duolingo
pianifichi	pianifichi	verb	Duolingo
pianifichiamo	pianifichiamo	verb	Duolingo
piano	piano	noun	Duolingo
pianoforte	pianoforte	noun	Duolingo
pianta	pianta	noun	Duolingo
piante	piante	noun	Duolingo
piatti	piatti	noun	Duolingo
piatto	piatto	noun	Duolingo
piazza	piazza	noun	Duolingo
piccione	piccione	noun	Duolingo
piccola	piccola	adjective	Duolingo
piccoli	piccoli	adjective	Duolingo
piccolo	piccolo	adjective	Duolingo
piede	piede	noun	Duolingo
piedi	piedi	noun	Duolingo
piemonte	piemonte	proper noun	Duolingo
piena	piena	adjective	Duolingo
pieni	pieni	adjective	Duolingo
pieno	pieno	adjective	Duolingo
pietra	pietra	noun	Duolingo
pigiama	pigiama	noun	Duolingo
pigiami	pigiami	noun	Duolingo
pilota	pilota	noun	Duolingo
pinguino	pinguino	noun	Duolingo
pioggia	pioggia	noun	Duolingo
piove	piove	verb	Duolingo
piovendo	piovendo	verb	Duolingo
piovere	piovere	verb	Duolingo
pisa	pisa	proper noun	Duolingo
piscina	piscina	noun	Duolingo
pista	pista	noun	Duolingo
pittore	pittore	noun	Duolingo
più	piu		Duolingo
più	piu	adjective	Duolingo
più	piu	adverb	Duolingo
più	piu	preposition	Duolingo
più di	piu di		Duolingo
piuttosto	piuttosto	adverb	Duolingo
pizza	pizza	noun	Duolingo
pizze	pizze	noun	Duolingo
pizzeria	pizzeria	noun	Duolingo
pizzerie	pizzerie	noun	Duolingo
plastica	plastica	noun	Duolingo
po	po	proper noun	Duolingo
po'	po'	pronoun	Duolingo
poca	poca	determiner	Duolingo
pochi	pochi	determiner	Duolingo
pochino	pochino	noun	Duolingo
pochissimo	pochissimo	adverb	Duolingo
poco	poco	adverb	Duolingo
poco	poco	determiner	Duolingo
poesia	poesia	noun	Duolingo
poesie	poesie	noun	Duolingo
poeta	poeta	noun	Duolingo
poi	poi	adverb	Duolingo
poi così	poi cosi		Duolingo
politica	politica	adjective	Duolingo
politica	politica	noun	Duolingo
politici	politici	adjective	Duolingo
politico	politico	adjective	Duolingo
polizia	polizia	noun	Duolingo
poliziotta	poliziotta	noun	Duolingo
poliziotti	poliziotti	noun	Duolingo
poliziotto	poliziotto	noun	Duolingo
polli	polli	noun	Duolingo
pollo	pollo	noun	Duolingo
poltrona	poltrona	noun	Duolingo
poltrone	poltrone	noun	Duolingo
pomeriggio	pomeriggio	noun	Duolingo
pomodori	pomodori		Duolingo
pomodori	pomodori	noun	Duolingo
pomodoro	pomodoro	noun	Duolingo
pompei	pompei	proper noun	Duolingo
ponte	ponte	noun	Duolingo
ponti	ponti	noun	Duolingo
popolare	popolare	adjective	Duolingo
popolari	popolari	adjective	Duolingo
popolazione	popolazione	noun	Duolingo
popoli	popoli	noun	Duolingo
popolo	popolo	noun	Duolingo
porta	porta	noun	Duolingo
porta	porta	verb	Duolingo
portafogli	portafogli	noun	Duolingo
portafoglio	portafoglio	noun	Duolingo
portai	portai	verb	Duolingo
portando	portando	verb	Duolingo
portano	portano	verb	Duolingo
portare	portare	verb	Duolingo
portasse	portasse	verb	Duolingo
portassimo	portassimo	verb	Duolingo
portate	portate	verb	Duolingo
portava	portava	verb	Duolingo
portavano	portavano	verb	Duolingo
porte	porte	noun	Duolingo
porterà	portera	verb	Duolingo
porterebbe	porterebbe	verb	Duolingo
porterei	porterei	verb	Duolingo
porteresti	porteresti	verb	Duolingo
porterò	portero	verb	Duolingo
porti	porti	verb	Duolingo
porto	porto	noun	Duolingo
porto	porto	verb	Duolingo
portogallo	portogallo	proper noun	Duolingo
portoghese	portoghese	adjective	Duolingo
portoghesi	portoghesi	adjective	Duolingo
portone	portone	noun	Duolingo
positiva	positiva	adjective	Duolingo
positive	positive	adjective	Duolingo
positivo	positivo	adjective	Duolingo
posizione	posizione	noun	Duolingo
possa	possa	verb	Duolingo
possiamo	possiamo	verb	Duolingo
possibile	possibile	adjective	Duolingo
possibilità	possibilita	noun	Duolingo
possibilmente	possibilmente	adverb	Duolingo
posso	posso	verb	Duolingo
possono	possono	verb	Duolingo
posta	posta	noun	Duolingo
posti	posti	noun	Duolingo
postini	postini	noun	Duolingo
postino	postino	noun	Duolingo
posto	posto	noun	Duolingo
potei	potei	verb	Duolingo
potemmo	potemmo	verb	Duolingo
potendo	potendo	verb	Duolingo
potenziale	potenziale	adjective	Duolingo
potenziali	potenziali	adjective	Duolingo
poter	poter	verb	Duolingo
potere	potere	noun	Duolingo
poteri	poteri	noun	Duolingo
potesse	potesse	verb	Duolingo
potete	potete	verb	Duolingo
poteva	poteva	verb	Duolingo
potevano	potevano	verb	Duolingo
potevo	potevo	verb	Duolingo
potrà	potra	verb	Duolingo
potrebbe	potrebbe	verb	Duolingo
potrebbero	potrebbero	verb	Duolingo
potrei	potrei	verb	Duolingo
potremmo	potremmo	verb	Duolingo
potreste	potreste	verb	Duolingo
potresti	potresti	verb	Duolingo
potrete	potrete	verb	Duolingo
potrò	potro	verb	Duolingo
pover'	pover'	adjective	Duolingo
povera	povera	adjective	Duolingo
poveri	poveri	adjective	Duolingo
povertà	poverta	noun	Duolingo
pranza	pranza	verb	Duolingo
pranzano	pranzano	verb	Duolingo
pranzo	pranzo	noun	Duolingo
pratica	pratica	noun	Duolingo
praticamente	praticamente	adverb	Duolingo
prato	prato	noun	Duolingo
preferiamo	preferiamo	verb	Duolingo
preferire	preferire	verb	Duolingo
preferisce	preferisce	verb	Duolingo
preferisci	preferisci	verb	Duolingo
preferisco	preferisco	verb	Duolingo
preferita	preferita	adjective	Duolingo
preferite	preferite	verb	Duolingo
preferito	preferito	adjective	Duolingo
preghiamo	preghiamo	verb	Duolingo
preghiera	preghiera	noun	Duolingo
prego	prego	interjection	Duolingo
prego	prego	verb	Duolingo
premi	premi	noun	Duolingo
premio	premio	noun	Duolingo
prenda	prenda	verb	Duolingo
prende	prende	verb	Duolingo
prendendo	prendendo	verb	Duolingo
prender	prender	verb	Duolingo
prenderà	prendera	verb	Duolingo
prenderai	prenderai	verb	Duolingo
prendere	prendere	verb	Duolingo
prenderebbe	prenderebbe	verb	Duolingo
prenderebbero	prenderebbero	verb	Duolingo
prendereste	prendereste	verb	Duolingo
prenderò	prendero	verb	Duolingo
prendesse	prendesse	verb	Duolingo
prendessi	prendessi	verb	Duolingo
prendete	prendete	verb	Duolingo
prendeva	prendeva	verb	Duolingo
prendi	prendi	verb	Duolingo
prendiamo	prendiamo	verb	Duolingo
prendo	prendo	verb	Duolingo
prendono	prendono	verb	Duolingo
prenota	prenota	verb	Duolingo
prenotano	prenotano	verb	Duolingo
prenotare	prenotare	verb	Duolingo
prenotazione	prenotazione	noun	Duolingo
prenotiamo	prenotiamo	verb	Duolingo
preoccupare	preoccupare	verb	Duolingo
prepara	prepara	verb	Duolingo
preparando	preparando	verb	Duolingo
preparare	preparare	verb	Duolingo
preparate	preparate	verb	Duolingo
prepariamo	prepariamo	verb	Duolingo
prese	prese	verb	Duolingo
presentazione	presentazione	noun	Duolingo
presenti	presenti	verb	Duolingo
presenza	presenza	noun	Duolingo
presidente	presidente	noun	Duolingo
presidenza	presidenza	noun	Duolingo
pressione	pressione	noun	Duolingo
presta	presta	verb	Duolingo
prestano	prestano	verb	Duolingo
prestare	prestare	verb	Duolingo
prestiamo	prestiamo	verb	Duolingo
presto	presto	adjective	Duolingo
presto	presto	adverb	Duolingo
prezzemolo	prezzemolo	noun	Duolingo
prezzi	prezzi	noun	Duolingo
prezzo	prezzo	noun	Duolingo
prigione	prigione	noun	Duolingo
prima	prima	adjective	Duolingo
prima	prima	adverb	Duolingo
prima o poi	prima o poi		Duolingo
primavera	primavera	noun	Duolingo
primi	primi	adjective	Duolingo
primo	primo	adjective	Duolingo
principale	principale	adjective	Duolingo
principiante	principiante	noun	Duolingo
probabile	probabile	adjective	Duolingo
probabilmente	probabilmente	adverb	Duolingo
problema	problema	noun	Duolingo
problemi	problemi	noun	Duolingo
processi	processi	noun	Duolingo
processo	processo	noun	Duolingo
prodotti	prodotti	noun	Duolingo
produzione	produzione	noun	Duolingo
professionale	professionale	adjective	Duolingo
professionali	professionali	adjective	Duolingo
professor	professor	noun	Duolingo
professore	professore	noun	Duolingo
professoressa	professoressa	noun	Duolingo
profonda	profonda	adjective	Duolingo
profondo	profondo	adjective	Duolingo
progetti	progetti	noun	Duolingo
progetto	progetto	noun	Duolingo
programma	programma	noun	Duolingo
programmi	programmi	noun	Duolingo
pronta	pronta	adjective	Duolingo
pronto	pronto	adjective	Duolingo
pronto	pronto	interjection	Duolingo
proposta	proposta	noun	Duolingo
proposte	proposte	noun	Duolingo
propri	propri	determiner	Duolingo
propria	propria	determiner	Duolingo
proprietà	proprieta	noun	Duolingo
proprietaria	proprietaria	noun	Duolingo
proprietario	proprietario	noun	Duolingo
proprio	proprio	adverb	Duolingo
proprio	proprio	determiner	Duolingo
prosciutto	prosciutto	noun	Duolingo
prossima	prossima	adjective	Duolingo
prossimi	prossimi	adjective	Duolingo
prossimo	prossimo	adjective	Duolingo
protezione	protezione	noun	Duolingo
prova	prova	noun	Duolingo
prova	prova	verb	Duolingo
provai	provai	verb	Duolingo
provando	provando	verb	Duolingo
provano	provano	verb	Duolingo
provasse	provasse	verb	Duolingo
provassi	provassi	verb	Duolingo
provassimo	provassimo	verb	Duolingo
provava	provava	verb	Duolingo
provavamo	provavamo	verb	Duolingo
provavo	provavo	verb	Duolingo
prove	prove	noun	Duolingo
provengono	provengono	verb	Duolingo
proverà	provera	verb	Duolingo
proverebbe	proverebbe	verb	Duolingo
proveremmo	proveremmo	verb	Duolingo
proverò	provero	verb	Duolingo
provi	provi	verb	Duolingo
proviamo	proviamo	verb	Duolingo
proviene	proviene	verb	Duolingo
provincia	provincia	noun	Duolingo
provinciale	provinciale	adjective	Duolingo
provo	provo	verb	Duolingo
psicologia	psicologia	noun	Duolingo
pubblica	pubblica	adjective	Duolingo
pubblicità	pubblicita	noun	Duolingo
pubblico	pubblico	noun	Duolingo
puglia	puglia	proper noun	Duolingo
puliamo	puliamo	verb	Duolingo
pulire	pulire	verb	Duolingo
pulisci	pulisci	verb	Duolingo
pulisco	pulisco	verb	Duolingo
pulita	pulita	adjective	Duolingo
pulite	pulite	adjective	Duolingo
pulite	pulite	verb	Duolingo
puliti	puliti	adjective	Duolingo
pulito	pulito	adjective	Duolingo
pullman	pullman	noun	Duolingo
punti	punti	noun	Duolingo
punto	punto	noun	Duolingo
puntura	puntura	noun	Duolingo
può	puo	verb	Duolingo
puoi	puoi	verb	Duolingo
pura	pura	adjective	Duolingo
pure	pure	adverb	Duolingo
puro	puro	adjective	Duolingo
purtroppo	purtroppo	adverb	Duolingo
qua	qua	adverb	Duolingo
quaderni	quaderni	noun	Duolingo
quaderno	quaderno	noun	Duolingo
qual	qual	adjective	Duolingo
qualche	qualche	determiner	Duolingo
qualcos'	qualcos'	pronoun	Duolingo
qualcosa	qualcosa	pronoun	Duolingo
qualcuna	qualcuna	pronoun	Duolingo
qualcuno	qualcuno	pronoun	Duolingo
quale	quale		Duolingo
quale	quale	adjective	Duolingo
quale	quale	pronoun	Duolingo
quali	quali		Duolingo
quali	quali	adjective	Duolingo
quali	quali	pronoun	Duolingo
qualità	qualita	noun	Duolingo
qualsiasi	qualsiasi	determiner	Duolingo
qualsiasi	qualsiasi	pronoun	Duolingo
qualunque	qualunque	determiner	Duolingo
quando	quando		Duolingo
quando	quando	adverb	Duolingo
quanta	quanta	adjective	Duolingo
quanta	quanta	pronoun	Duolingo
quante	quante	adjective	Duolingo
quante	quante	pronoun	Duolingo
quanti	quanti	adjective	Duolingo
quanti	quanti	pronoun	Duolingo
quantità	quantita	noun	Duolingo
quanto	quanto		Duolingo
quanto	quanto	adjective	Duolingo
quanto	quanto	adverb	Duolingo
quanto	quanto	pronoun	Duolingo
quanto tempo	quanto tempo	adverb	Duolingo
quarant'	quarant'	numeral	Duolingo
quaranta	quaranta	numeral	Duolingo
quarantaquattro	quarantaquattro	numeral	Duolingo
quartiere	quartiere	noun	Duolingo
quarto	quarto	adjective	Duolingo
quarto	quarto	noun	Duolingo
quasi	quasi	adverb	Duolingo
quattordici	quattordici	numeral	Duolingo
quattro	quattro	numeral	Duolingo
quattrocento	quattrocento	numeral	Duolingo
quattrocentosei	quattrocentosei	numeral	Duolingo
quattrocentosettantasei	quattrocentosettantasei	numeral	Duolingo
quegli	quegli	determiner	Duolingo
quei	quei	determiner	Duolingo
quel	quel	determiner	Duolingo
quell'	quell'	determiner	Duolingo
quella	quella	determiner	Duolingo
quella	quella	pronoun	Duolingo
quelle	quelle	determiner	Duolingo
quelle	quelle	pronoun	Duolingo
quelli	quelli	determiner	Duolingo
quelli	quelli	pronoun	Duolingo
quello	quello	determiner	Duolingo
quello	quello	pronoun	Duolingo
quello che	quello che		Duolingo
quest'	quest'	determiner	Duolingo
questa	questa	determiner	Duolingo
questa	questa	pronoun	Duolingo
queste	queste	determiner	Duolingo
queste	queste	pronoun	Duolingo
questi	questi	determiner	Duolingo
questi	questi	pronoun	Duolingo
questo	questo	determiner	Duolingo
questo	questo	pronoun	Duolingo
qui	qui	adverb	Duolingo
qui vicino	qui vicino		Duolingo
quindi	quindi	adverb	Duolingo
quindici	quindici	numeral	Duolingo
quinta	quinta	adjective	Duolingo
quinto	quinto	adjective	Duolingo
quotidiano	quotidiano	adjective	Duolingo
raccontiamo	raccontiamo	verb	Duolingo
racconto	racconto	verb	Duolingo
radicale	radicale	adjective	Duolingo
radicali	radicali	adjective	Duolingo
radice	radice	noun	Duolingo
radici	radici	noun	Duolingo
radio	radio	noun	Duolingo
raffreddore	raffreddore	noun	Duolingo
ragazza	ragazza	noun	Duolingo
ragazze	ragazze	noun	Duolingo
ragazzi	ragazzi	noun	Duolingo
ragazzo	ragazzo	noun	Duolingo
ragione	ragione	noun	Duolingo
ragioni	ragioni	noun	Duolingo
ragno	ragno	noun	Duolingo
rapporti	rapporti	noun	Duolingo
rapporto	rapporto	noun	Duolingo
rappresentante	rappresentante	noun	Duolingo
rappresentanti	rappresentanti	noun	Duolingo
raramente	raramente	adverb	Duolingo
rasoio	rasoio	noun	Duolingo
re	re	noun	Duolingo
realtà	realta	noun	Duolingo
recente	recente	adjective	Duolingo
recentemente	recentemente	adverb	Duolingo
recenti	recenti	adjective	Duolingo
regalano	regalano	verb	Duolingo
regalate	regalate	verb	Duolingo
regali	regali	noun	Duolingo
regaliamo	regaliamo	verb	Duolingo
regalo	regalo	noun	Duolingo
regalo	regalo	verb	Duolingo
reggiseni	reggiseni	noun	Duolingo
reggiseno	reggiseno	noun	Duolingo
regina	regina	noun	Duolingo
regionale	regionale	adjective	Duolingo
regionali	regionali	adjective	Duolingo
regione	regione	noun	Duolingo
regioni	regioni	noun	Duolingo
regole	regole	noun	Duolingo
religione	religione	noun	Duolingo
repubblica	repubblica	noun	Duolingo
resistenza	resistenza	noun	Duolingo
responsabile	responsabile	adjective	Duolingo
responsabili	responsabili	adjective	Duolingo
responsabilità	responsabilita	noun	Duolingo
resterà	restera	verb	Duolingo
resteremo	resteremo	verb	Duolingo
resterò	restero	verb	Duolingo
rete	rete	noun	Duolingo
ricca	ricca	adjective	Duolingo
ricche	ricche	adjective	Duolingo
ricchezza	ricchezza	noun	Duolingo
ricchi	ricchi	adjective	Duolingo
ricco	ricco	adjective	Duolingo
ricerca	ricerca	noun	Duolingo
ricercare	ricercare	verb	Duolingo
ricercatore	ricercatore	noun	Duolingo
ricercatori	ricercatori	noun	Duolingo
ricercatrice	ricercatrice	noun	Duolingo
ricetta	ricetta	noun	Duolingo
riceve	riceve	verb	Duolingo
ricevere	ricevere	verb	Duolingo
ricevo	ricevo	verb	Duolingo
ricorda	ricorda	verb	Duolingo
ricordai	ricordai	verb	Duolingo
ricordano	ricordano	verb	Duolingo
ricordare	ricordare	verb	Duolingo
ricordasse	ricordasse	verb	Duolingo
ricordassi	ricordassi	verb	Duolingo
ricordate	ricordate	verb	Duolingo
ricordava	ricordava	verb	Duolingo
ricordavo	ricordavo	verb	Duolingo
ricorderà	ricordera	verb	Duolingo
ricorderanno	ricorderanno	verb	Duolingo
ricorderebbe	ricorderebbe	verb	Duolingo
ricorderò	ricordero	verb	Duolingo
ricordi	ricordi	verb	Duolingo
ricordo	ricordo	verb	Duolingo
ride	ride	verb	Duolingo
ridere	ridere	verb	Duolingo
ridete	ridete	verb	Duolingo
ridono	ridono	verb	Duolingo
riempi	riempi	verb	Duolingo
riempiamo	riempiamo	verb	Duolingo
riempie	riempie	verb	Duolingo
riempiono	riempiono	verb	Duolingo
riempire	riempire	verb	Duolingo
riflessione	riflessione	noun	Duolingo
riflessioni	riflessioni	noun	Duolingo
rimane	rimane	verb	Duolingo
rimanendo	rimanendo	verb	Duolingo
rimanere	rimanere	verb	Duolingo
rimanesse	rimanesse	verb	Duolingo
rimanessero	rimanessero	verb	Duolingo
rimanete	rimanete	verb	Duolingo
rimaneva	rimaneva	verb	Duolingo
rimanevano	rimanevano	verb	Duolingo
rimanga	rimanga	verb	Duolingo
rimangono	rimangono	verb	Duolingo
rimani	rimani	verb	Duolingo
rimarrai	rimarrai	verb	Duolingo
rimarranno	rimarranno	verb	Duolingo
rimarrebbe	rimarrebbe	verb	Duolingo
rimase	rimase	verb	Duolingo
rimasero	rimasero	verb	Duolingo
ringrazia	ringrazia	verb	Duolingo
ringraziare	ringraziare	verb	Duolingo
ringrazio	ringrazio	verb	Duolingo
ripara	ripara	verb	Duolingo
riparano	riparano	verb	Duolingo
ripariamo	ripariamo	verb	Duolingo
riparo	riparo	verb	Duolingo
ripetere	ripetere	verb	Duolingo
riposa	riposa	verb	Duolingo
riposando	riposando	verb	Duolingo
riposare	riposare	verb	Duolingo
riposate	riposate	verb	Duolingo
riposiamo	riposiamo	verb	Duolingo
riposo	riposo	verb	Duolingo
risata	risata	noun	Duolingo
riscaldamento	riscaldamento	noun	Duolingo
rischi	rischi	noun	Duolingo
riso	riso	noun	Duolingo
risorsa	risorsa	noun	Duolingo
risorse	risorse	noun	Duolingo
rispetto	rispetto	noun	Duolingo
risponda	risponda	verb	Duolingo
risponde	risponde	verb	Duolingo
rispondendo	rispondendo	verb	Duolingo
risponderà	rispondera	verb	Duolingo
risponderanno	risponderanno	verb	Duolingo
rispondere	rispondere	verb	Duolingo
risponderebbe	risponderebbe	verb	Duolingo
risponderebbero	risponderebbero	verb	Duolingo
risponderei	risponderei	verb	Duolingo
risponderemo	risponderemo	verb	Duolingo
rispondesse	rispondesse	verb	Duolingo
rispondessi	rispondessi	verb	Duolingo
rispondete	rispondete	verb	Duolingo
rispondeva	rispondeva	verb	Duolingo
rispondi	rispondi	verb	Duolingo
rispondo	rispondo	verb	Duolingo
rispondono	rispondono	verb	Duolingo
rispose	rispose	verb	Duolingo
risposta	risposta	noun	Duolingo
risposte	risposte	noun	Duolingo
ristorante	ristorante	noun	Duolingo
risultati	risultati	noun	Duolingo
risultato	risultato	noun	Duolingo
ritardo	ritardo	noun	Duolingo
ritmi	ritmi	noun	Duolingo
ritmo	ritmo	noun	Duolingo
ritorna	ritorna	verb	Duolingo
ritornare	ritornare	verb	Duolingo
ritorni	ritorni	noun	Duolingo
ritorni	ritorni	verb	Duolingo
ritorno	ritorno	noun	Duolingo
riunione	riunione	noun	Duolingo
riunioni	riunioni	noun	Duolingo
rivedere	rivedere	verb	Duolingo
rivedete	rivedete	verb	Duolingo
rivediamo	rivediamo	verb	Duolingo
rivista	rivista	noun	Duolingo
riviste	riviste	noun	Duolingo
rivoluzionari	rivoluzionari	adjective	Duolingo
rivoluzionario	rivoluzionario	adjective	Duolingo
rivoluzione	rivoluzione	noun	Duolingo
rocce	rocce	noun	Duolingo
roccia	roccia	noun	Duolingo
romagna	romagna	proper noun	Duolingo
romanzi	romanzi	noun	Duolingo
romanzo	romanzo	noun	Duolingo
rompe	rompe	verb	Duolingo
rompere	rompere	verb	Duolingo
rompono	rompono	verb	Duolingo
rondine	rondine	noun	Duolingo
rondini	rondini	noun	Duolingo
rosa	rosa	adjective	Duolingo
rossa	rossa	adjective	Duolingo
rosse	rosse	adjective	Duolingo
rossetto	rossetto	noun	Duolingo
rossi	rossi	adjective	Duolingo
rosso	rosso	adjective	Duolingo
ruba	ruba	verb	Duolingo
rubano	rubano	verb	Duolingo
rubare	rubare	verb	Duolingo
rubo	rubo	verb	Duolingo
rumore	rumore	noun	Duolingo
rumorosa	rumorosa	adjective	Duolingo
rumorose	rumorose	adjective	Duolingo
rumorosi	rumorosi	adjective	Duolingo
ruoli	ruoli	noun	Duolingo
ruolo	ruolo	noun	Duolingo
ruota	ruota	noun	Duolingo
ruote	ruote	noun	Duolingo
russi	russi	adjective	Duolingo
russo	russo	adjective	Duolingo
sa	sa	verb	Duolingo
sabato	sabato	noun	Duolingo
sabbia	sabbia	noun	Duolingo
sacco a pelo	sacco a pelo		Duolingo
sai	sai	verb	Duolingo
sala	sala	noun	Duolingo
sale	sale	noun	Duolingo
salgono	salgono	verb	Duolingo
saliamo	saliamo	verb	Duolingo
salite	salite	verb	Duolingo
salotti	salotti	noun	Duolingo
salsa	salsa	noun	Duolingo
salsiccia	salsiccia	noun	Duolingo
saltare	saltare	verb	Duolingo
salute	salute	noun	Duolingo
salva	salva	verb	Duolingo
salvano	salvano	verb	Duolingo
salvare	salvare	verb	Duolingo
salve	salve	interjection	Duolingo
salviamo	salviamo	verb	Duolingo
salvo	salvo	verb	Duolingo
sana	sana	adjective	Duolingo
sandali	sandali	noun	Duolingo
sandalo	sandalo	noun	Duolingo
sangue	sangue	noun	Duolingo
sano	sano	adjective	Duolingo
santa	santa	adjective	Duolingo
sapendo	sapendo	verb	Duolingo
saper	saper	verb	Duolingo
sapere	sapere	verb	Duolingo
sapesse	sapesse	verb	Duolingo
sapessero	sapessero	verb	Duolingo
sapessi	sapessi	verb	Duolingo
sapessimo	sapessimo	verb	Duolingo
sapeste	sapeste	verb	Duolingo
sapete	sapete	verb	Duolingo
sapeva	sapeva	verb	Duolingo
sapevo	sapevo	verb	Duolingo
sapone	sapone	noun	Duolingo
sappi	sappi	verb	Duolingo
sappia	sappia	verb	Duolingo
sappiamo	sappiamo	verb	Duolingo
saprà	sapra	verb	Duolingo
sapranno	sapranno	verb	Duolingo
saprebbe	saprebbe	verb	Duolingo
saprei	saprei	verb	Duolingo
sapremo	sapremo	verb	Duolingo
sarà	sara	verb	Duolingo
sarai	sarai	verb	Duolingo
saranno	saranno	verb	Duolingo
sardegna	sardegna	proper noun	Duolingo
sarebbe	sarebbe	verb	Duolingo
sarebbero	sarebbero	verb	Duolingo
sarei	sarei	verb	Duolingo
saremmo	saremmo	verb	Duolingo
saremo	saremo	verb	Duolingo
sareste	sareste	verb	Duolingo
saresti	saresti	verb	Duolingo
sarete	sarete	verb	Duolingo
sarò	saro	verb	Duolingo
sbagliato	sbagliato	adjective	Duolingo
scaffali	scaffali	noun	Duolingo
scala	scala	noun	Duolingo
scale	scale	noun	Duolingo
scarpa	scarpa	noun	Duolingo
scarpe	scarpe	noun	Duolingo
scarponi	scarponi	noun	Duolingo
scatola	scatola	noun	Duolingo
scatole	scatole	noun	Duolingo
scegli	scegli	verb	Duolingo
sceglie	sceglie	verb	Duolingo
scegliere	scegliere	verb	Duolingo
scena	scena	noun	Duolingo
scende	scende	verb	Duolingo
scendendo	scendendo	verb	Duolingo
scendere	scendere	verb	Duolingo
scendono	scendono	verb	Duolingo
schermo	schermo	noun	Duolingo
schiena	schiena	noun	Duolingo
sci di fondo	sci di fondo		Duolingo
sciampi	sciampi	noun	Duolingo
sciampo	sciampo	noun	Duolingo
sciarpa	sciarpa	noun	Duolingo
sciarpe	sciarpe	noun	Duolingo
scienza	scienza	noun	Duolingo
scienze	scienze	noun	Duolingo
scienziata	scienziata	noun	Duolingo
scienziate	scienziate	noun	Duolingo
scienziati	scienziati	noun	Duolingo
scienziato	scienziato	noun	Duolingo
scimmia	scimmia	noun	Duolingo
sciopero	sciopero	noun	Duolingo
sciroppo	sciroppo	noun	Duolingo
sconti	sconti	noun	Duolingo
sconto	sconto	noun	Duolingo
scoperta	scoperta	noun	Duolingo
scorsa	scorsa	adjective	Duolingo
scorso	scorso	adjective	Duolingo
scrisse	scrisse	verb	Duolingo
scrissi	scrissi	verb	Duolingo
scrittore	scrittore	noun	Duolingo
scrittori	scrittori	noun	Duolingo
scrittrice	scrittrice	noun	Duolingo
scrittrici	scrittrici	noun	Duolingo
scriva	scriva	verb	Duolingo
scrivania	scrivania	noun	Duolingo
scrivanie	scrivanie	noun	Duolingo
scrive	scrive	verb	Duolingo
scrivendo	scrivendo	verb	Duolingo
scrivere	scrivere	verb	Duolingo
scriverebbe	scriverebbe	verb	Duolingo
scriverebbero	scriverebbero	verb	Duolingo
scriverei	scriverei	verb	Duolingo
scriveremo	scriveremo	verb	Duolingo
scriveresti	scriveresti	verb	Duolingo
scriverò	scrivero	verb	Duolingo
scrivesse	scrivesse	verb	Duolingo
scrivete	scrivete	verb	Duolingo
scriveva	scriveva	verb	Duolingo
scrivi	scrivi	verb	Duolingo
scriviamo	scriviamo	verb	Duolingo
scrivo	scrivo	verb	Duolingo
scrivono	scrivono	verb	Duolingo
scuola	scuola	noun	Duolingo
scuole	scuole	noun	Duolingo
scura	scura	adjective	Duolingo
scure	scure	adjective	Duolingo
scuri	scuri	adjective	Duolingo
scusa	scusa	verb	Duolingo
scusare	scusare	verb	Duolingo
scusate	scusate	verb	Duolingo
scusi	scusi	verb	Duolingo
se	se	conjunction	Duolingo
se	se	pronoun	Duolingo
secca	secca	adjective	Duolingo
secchi	secchi	adjective	Duolingo
secoli	secoli	noun	Duolingo
secolo	secolo	noun	Duolingo
seconda	seconda	adjective	Duolingo
secondi	secondi	noun	Duolingo
secondo	secondo	adjective	Duolingo
secondo	secondo	noun	Duolingo
secondo	secondo	preposition	Duolingo
sedere	sedere	verb	Duolingo
sedete	sedete	verb	Duolingo
sedia	sedia	noun	Duolingo
sediamo	sediamo	verb	Duolingo
sedici	sedici	numeral	Duolingo
sedie	sedie	noun	Duolingo
seggiola	seggiola	noun	Duolingo
seggiole	seggiole	noun	Duolingo
segnale	segnale	noun	Duolingo
segno	segno	noun	Duolingo
segretaria	segretaria	noun	Duolingo
segretario	segretario	noun	Duolingo
segreto	segreto	noun	Duolingo
segua	segua	verb	Duolingo
seguano	seguano	verb	Duolingo
segue	segue	verb	Duolingo
seguendo	seguendo	verb	Duolingo
seguenti	seguenti	adjective	Duolingo
segui	segui	verb	Duolingo
seguiamo	seguiamo	verb	Duolingo
seguiate	seguiate	verb	Duolingo
seguirà	seguira	verb	Duolingo
seguire	seguire	verb	Duolingo
seguirebbe	seguirebbe	verb	Duolingo
seguirebbero	seguirebbero	verb	Duolingo
seguirei	seguirei	verb	Duolingo
seguiremo	seguiremo	verb	Duolingo
seguirò	seguiro	verb	Duolingo
seguirono	seguirono	verb	Duolingo
seguisse	seguisse	verb	Duolingo
seguissero	seguissero	verb	Duolingo
seguite	seguite	verb	Duolingo
seguiva	seguiva	verb	Duolingo
seguivamo	seguivamo	verb	Duolingo
seguivano	seguivano	verb	Duolingo
sei	sei	numeral	Duolingo
sei	sei	verb	Duolingo
seicento	seicento	numeral	Duolingo
selvaggi	selvaggi	adjective	Duolingo
selvaggio	selvaggio	adjective	Duolingo
sembra	sembra	verb	Duolingo
sembrano	sembrano	verb	Duolingo
semestre	semestre	noun	Duolingo
semplice	semplice	adjective	Duolingo
semplicemente	semplicemente	adverb	Duolingo
semplici	semplici	adjective	Duolingo
sempre	sempre	adverb	Duolingo
senatore	senatore	noun	Duolingo
senatori	senatori	noun	Duolingo
senatrice	senatrice	noun	Duolingo
sensazione	sensazione	noun	Duolingo
senso	senso	noun	Duolingo
senta	senta	verb	Duolingo
sentano	sentano	verb	Duolingo
sente	sente	verb	Duolingo
sentendo	sentendo	verb	Duolingo
senti	senti	verb	Duolingo
sentiamo	sentiamo	verb	Duolingo
sentii	sentii	verb	Duolingo
sentimenti	sentimenti	noun	Duolingo
sentimento	sentimento	noun	Duolingo
sentimmo	sentimmo	verb	Duolingo
sentirai	sentirai	verb	Duolingo
sentiranno	sentiranno	verb	Duolingo
sentire	sentire	verb	Duolingo
sentirebbe	sentirebbe	verb	Duolingo
sentirei	sentirei	verb	Duolingo
sentireste	sentireste	verb	Duolingo
sentirò	sentiro	verb	Duolingo
sentisse	sentisse	verb	Duolingo
sentissi	sentissi	verb	Duolingo
sentiva	sentiva	verb	Duolingo
sentivamo	sentivamo	verb	Duolingo
sentivi	sentivi	verb	Duolingo
sentivo	sentivo	verb	Duolingo
sento	sento	verb	Duolingo
senz'	senz'	preposition	Duolingo
senza	senza	preposition	Duolingo
seppe	seppe	verb	Duolingo
seppero	seppero	verb	Duolingo
sera	sera	noun	Duolingo
serata	serata	noun	Duolingo
serate	serate	noun	Duolingo
sere	sere	noun	Duolingo
seria	seria	adjective	Duolingo
serie	serie	adjective	Duolingo
serpente	serpente	noun	Duolingo
servizi	servizi	noun	Duolingo
servizio	servizio	noun	Duolingo
sessant'	sessant'	numeral	Duolingo
sessanta	sessanta	numeral	Duolingo
sesto	sesto	adjective	Duolingo
sete	sete	noun	Duolingo
settant'	settant'	numeral	Duolingo
settanta	settanta	numeral	Duolingo
settantanove	settantanove	numeral	Duolingo
sette	sette	numeral	Duolingo
settecento	settecento	numeral	Duolingo
settembre	settembre	noun	Duolingo
settentrionale	settentrionale	adjective	Duolingo
settima	settima	adjective	Duolingo
settimana	settimana	noun	Duolingo
settimanalmente	settimanalmente	adverb	Duolingo
settimane	settimane	noun	Duolingo
settimo	settimo	adjective	Duolingo
sezione	sezione	noun	Duolingo
sforzi	sforzi	noun	Duolingo
sforzo	sforzo	noun	Duolingo
sì	si	adverb	Duolingo
si	si	pronoun	Duolingo
si chiama	si chiama		Duolingo
si chiama	si chiama	verb	Duolingo
sia	sia	conjunction	Duolingo
sia	sia	verb	Duolingo
siamo	siamo	verb	Duolingo
siano	siano	verb	Duolingo
siccome	siccome	conjunction	Duolingo
sicura	sicura	adjective	Duolingo
sicuramente	sicuramente	adverb	Duolingo
sicurezza	sicurezza	noun	Duolingo
sicuro	sicuro	adjective	Duolingo
siede	siede	verb	Duolingo
siedi	siedi	verb	Duolingo
siedo	siedo	verb	Duolingo
siedono	siedono	verb	Duolingo
siete	siete	verb	Duolingo
sigaretta	sigaretta	noun	Duolingo
significa	significa	verb	Duolingo
significano	significano	verb	Duolingo
significare	significare	verb	Duolingo
significati	significati	noun	Duolingo
significato	significato	noun	Duolingo
signor	signor	noun	Duolingo
signora	signora	noun	Duolingo
signore	signore	noun	Duolingo
signori	signori	noun	Duolingo
silenzio	silenzio	noun	Duolingo
silenziosa	silenziosa	adjective	Duolingo
silenzioso	silenzioso	adjective	Duolingo
simboli	simboli	noun	Duolingo
simbolo	simbolo	noun	Duolingo
simile	simile	adjective	Duolingo
simili	simili	adjective	Duolingo
simpatica	simpatica	adjective	Duolingo
simpatiche	simpatiche	adjective	Duolingo
simpatici	simpatici	adjective	Duolingo
simpatico	simpatico	adjective	Duolingo
sinceramente	sinceramente	adverb	Duolingo
sindacati	sindacati	noun	Duolingo
sindacato	sindacato	noun	Duolingo
sindaco	sindaco	noun	Duolingo
sinistra	sinistra	noun	Duolingo
sinistro	sinistro	adjective	Duolingo
sistema	sistema	noun	Duolingo
sistemi	sistemi	noun	Duolingo
situazione	situazione	noun	Duolingo
situazioni	situazioni	noun	Duolingo
slip	slip	noun	Duolingo
so	so	verb	Duolingo
società	societa	noun	Duolingo
soddisfazione	soddisfazione	noun	Duolingo
soddisfazioni	soddisfazioni	noun	Duolingo
sofà	sofa	noun	Duolingo
soffice	soffice	adjective	Duolingo
soffici	soffici	adjective	Duolingo
soffitta	soffitta	noun	Duolingo
soggetto	soggetto	noun	Duolingo
sognare	sognare	verb	Duolingo
sogni	sogni	noun	Duolingo
sogno	sogno	noun	Duolingo
sola	sola	adjective	Duolingo
solamente	solamente	adverb	Duolingo
soldi	soldi	noun	Duolingo
sole	sole	adjective	Duolingo
sole	sole	noun	Duolingo
soleggiata	soleggiata	adjective	Duolingo
soleggiate	soleggiate	adjective	Duolingo
soleggiato	soleggiato	adjective	Duolingo
soli	soli	adjective	Duolingo
solo	solo	adjective	Duolingo
solo	solo	adverb	Duolingo
soltanto	soltanto	adverb	Duolingo
sonno	sonno	noun	Duolingo
sono	sono	verb	Duolingo
sopra	sopra	adverb	Duolingo
soprattutto	soprattutto	adverb	Duolingo
sorella	sorella	noun	Duolingo
sorelle	sorelle	noun	Duolingo
sorpresa	sorpresa	adjective	Duolingo
sorpresa	sorpresa	noun	Duolingo
sorprese	sorprese	adjective	Duolingo
sorpresi	sorpresi	adjective	Duolingo
sorride	sorride	verb	Duolingo
sorridere	sorridere	verb	Duolingo
sorridi	sorridi	verb	Duolingo
sorriso	sorriso	noun	Duolingo
sottile	sottile	adjective	Duolingo
sotto	sotto	adverb	Duolingo
sottosopra	sottosopra	adverb	Duolingo
spaghetti	spaghetti	noun	Duolingo
spaghetto	spaghetto	noun	Duolingo
spagna	spagna	proper noun	Duolingo
spagnola	spagnola	adjective	Duolingo
spagnoli	spagnoli	adjective	Duolingo
spagnoli	spagnoli	noun	Duolingo
spagnolo	spagnolo	adjective	Duolingo
spagnolo	spagnolo	noun	Duolingo
spalla	spalla	noun	Duolingo
spalle	spalle	noun	Duolingo
spaventare	spaventare	verb	Duolingo
spazio	spazio	noun	Duolingo
spazzola	spazzola	noun	Duolingo
spazzolini	spazzolini	noun	Duolingo
spazzolino	spazzolino	noun	Duolingo
specchi	specchi	noun	Duolingo
specchio	specchio	noun	Duolingo
speciale	speciale	adjective	Duolingo
specialità	specialita	noun	Duolingo
specialmente	specialmente	adverb	Duolingo
speranza	speranza	noun	Duolingo
speranze	speranze	noun	Duolingo
speriamo	speriamo	verb	Duolingo
spero	spero	verb	Duolingo
spesso	spesso	adverb	Duolingo
spettacolo	spettacolo	noun	Duolingo
spettatore	spettatore	noun	Duolingo
spettatori	spettatori	noun	Duolingo
spiacente	spiacente	adjective	Duolingo
spiaggia	spiaggia	noun	Duolingo
spiega	spiega	verb	Duolingo
spiegare	spiegare	verb	Duolingo
spiegazione	spiegazione	noun	Duolingo
spieghiamo	spieghiamo	verb	Duolingo
spinaci	spinaci	noun	Duolingo
spinge	spinge	verb	Duolingo
spingere	spingere	verb	Duolingo
spingiamo	spingiamo	verb	Duolingo
spingo	spingo	verb	Duolingo
spiriti	spiriti	noun	Duolingo
spirito	spirito	noun	Duolingo
sporche	sporche	adjective	Duolingo
sporchi	sporchi	adjective	Duolingo
sport	sport	noun	Duolingo
sposa	sposa	noun	Duolingo
sposano	sposano	verb	Duolingo
sposate	sposate	verb	Duolingo
sposi	sposi	noun	Duolingo
sposi	sposi	verb	Duolingo
sposiamo	sposiamo	verb	Duolingo
sposta	sposta	verb	Duolingo
spostano	spostano	verb	Duolingo
spostare	spostare	verb	Duolingo
spostiamo	spostiamo	verb	Duolingo
squadra	squadra	noun	Duolingo
squadre	squadre	noun	Duolingo
squalo	squalo	noun	Duolingo
sta	sta	verb	Duolingo
stadio	stadio	noun	Duolingo
stagione	stagione	noun	Duolingo
stagioni	stagioni	noun	Duolingo
stai	stai	verb	Duolingo
stai attenta	stai attenta		Duolingo
stamattina	stamattina	adverb	Duolingo
stampa	stampa	noun	Duolingo
stampare	stampare	verb	Duolingo
stanca	stanca	adjective	Duolingo
stanche	stanche	adjective	Duolingo
stanchi	stanchi	adjective	Duolingo
stanco	stanco	adjective	Duolingo
stanno	stanno	verb	Duolingo
stanotte	stanotte	adverb	Duolingo
stanza	stanza	noun	Duolingo
stanze	stanze	noun	Duolingo
starai	starai	verb	Duolingo
stare	stare	verb	Duolingo
starebbe	starebbe	verb	Duolingo
staremo	staremo	verb	Duolingo
stasera	stasera	adverb	Duolingo
statale	statale	adjective	Duolingo
statali	statali	adjective	Duolingo
state	state	verb	Duolingo
stati	stati	noun	Duolingo
stati uniti	stati uniti		Duolingo
stato	stato	noun	Duolingo
stava	stava	verb	Duolingo
stavi	stavi	verb	Duolingo
stavo	stavo	verb	Duolingo
stazione	stazione	noun	Duolingo
stella	stella	noun	Duolingo
stelle	stelle	noun	Duolingo
stessa	stessa	adjective	Duolingo
stessero	stessero	verb	Duolingo
stessi	stessi	verb	Duolingo
stessimo	stessimo	verb	Duolingo
stesso	stesso	adjective	Duolingo
stette	stette	verb	Duolingo
stia	stia	verb	Duolingo
stiamo	stiamo	verb	Duolingo
stile	stile	noun	Duolingo
stipendi	stipendi	noun	Duolingo
stipendio	stipendio	noun	Duolingo
stivale	stivale	noun	Duolingo
stivali	stivali	noun	Duolingo
sto	sto	verb	Duolingo
stomaco	stomaco	noun	Duolingo
storia	storia	noun	Duolingo
storica	storica	adjective	Duolingo
storici	storici	adjective	Duolingo
storico	storico	adjective	Duolingo
storie	storie	noun	Duolingo
strada	strada	noun	Duolingo
strade	strade	noun	Duolingo
strana	strana	adjective	Duolingo
strane	strane	adjective	Duolingo
strani	strani	adjective	Duolingo
straniera	straniera	adjective	Duolingo
straniera	straniera	noun	Duolingo
stranieri	stranieri	adjective	Duolingo
stranieri	stranieri	noun	Duolingo
straniero	straniero	noun	Duolingo
strano	strano	adjective	Duolingo
strategia	strategia	noun	Duolingo
stretta	stretta	adjective	Duolingo
strumenti	strumenti	noun	Duolingo
strumento	strumento	noun	Duolingo
struttura	struttura	noun	Duolingo
studente	studente	noun	Duolingo
studentessa	studentessa	noun	Duolingo
studentesse	studentesse	noun	Duolingo
studenti	studenti	noun	Duolingo
studi	studi	noun	Duolingo
studia	studia	verb	Duolingo
studiamo	studiamo	verb	Duolingo
studiando	studiando	verb	Duolingo
studiano	studiano	verb	Duolingo
studiare	studiare	verb	Duolingo
studiate	studiate	verb	Duolingo
studio	studio	noun	Duolingo
studio	studio	verb	Duolingo
stufato	stufato	noun	Duolingo
su	su	adverb	Duolingo
su	su	preposition	Duolingo
su cui	su cui		Duolingo
sua	sua	determiner	Duolingo
sua	sua	pronoun	Duolingo
subito	subito	adverb	Duolingo
succeda	succeda	verb	Duolingo
succede	succede	verb	Duolingo
succedendo	succedendo	verb	Duolingo
succederà	succedera	verb	Duolingo
succedere	succedere	verb	Duolingo
succederebbe	succederebbe	verb	Duolingo
succedesse	succedesse	verb	Duolingo
succedessero	succedessero	verb	Duolingo
succedeva	succedeva	verb	Duolingo
successe	successe	verb	Duolingo
successi	successi	noun	Duolingo
successo	successo	noun	Duolingo
succo	succo	noun	Duolingo
sud	sud	noun	Duolingo
sue	sue	determiner	Duolingo
sue	sue	pronoun	Duolingo
sufficiente	sufficiente	adjective	Duolingo
sufficienti	sufficienti	adjective	Duolingo
sugli	sugli	preposition	Duolingo
sui	sui	preposition	Duolingo
sul	sul	preposition	Duolingo
sull'	sull'	preposition	Duolingo
sulla	sulla	preposition	Duolingo
sulle	sulle	preposition	Duolingo
sullo	sullo	preposition	Duolingo
suo	suo	determiner	Duolingo
suo	suo	pronoun	Duolingo
suoi	suoi	determiner	Duolingo
suoi	suoi	pronoun	Duolingo
suona	suona	verb	Duolingo
suonando	suonando	verb	Duolingo
suonano	suonano	verb	Duolingo
suonare	suonare	verb	Duolingo
suonarono	suonarono	verb	Duolingo
suonasse	suonasse	verb	Duolingo
suonassimo	suonassimo	verb	Duolingo
suonate	suonate	verb	Duolingo
suonava	suonava	verb	Duolingo
suonavano	suonavano	verb	Duolingo
suonavi	suonavi	verb	Duolingo
suonerebbe	suonerebbe	verb	Duolingo
suonerei	suonerei	verb	Duolingo
suoneremo	suoneremo	verb	Duolingo
suoneresti	suoneresti	verb	Duolingo
suonerete	suonerete	verb	Duolingo
suonerò	suonero	verb	Duolingo
suoni	suoni	verb	Duolingo
suoniamo	suoniamo	verb	Duolingo
suoniate	suoniate	verb	Duolingo
suonino	suonino	verb	Duolingo
suono	suono	verb	Duolingo
superiore	superiore	adjective	Duolingo
superiori	superiori	adjective	Duolingo
supermercato	supermercato	noun	Duolingo
suppongo	suppongo	verb	Duolingo
supponiamo	supponiamo	verb	Duolingo
supporre	supporre	verb	Duolingo
svedese	svedese	adjective	Duolingo
svegli	svegli	verb	Duolingo
svegliare	svegliare	verb	Duolingo
sveglio	sveglio	verb	Duolingo
sviluppo	sviluppo	noun	Duolingo
svizzera	svizzera	adjective	Duolingo
svizzeri	svizzeri	adjective	Duolingo
svizzero	svizzero	adjective	Duolingo
svuota	svuota	verb	Duolingo
svuotano	svuotano	verb	Duolingo
svuoti	svuoti	verb	Duolingo
svuoto	svuoto	verb	Duolingo
tacchino	tacchino	noun	Duolingo
taglia	taglia	noun	Duolingo
taglia	taglia	verb	Duolingo
tagliando	tagliando	verb	Duolingo
taglio	taglio	verb	Duolingo
talmente	talmente	adverb	Duolingo
tamburi	tamburi	noun	Duolingo
tamburo	tamburo	noun	Duolingo
tanta	tanta	determiner	Duolingo
tanto	tanto	adverb	Duolingo
tanto	tanto	determiner	Duolingo
tappeti	tappeti	noun	Duolingo
tappeto	tappeto	noun	Duolingo
tardi	tardi	adverb	Duolingo
tardissimo	tardissimo	adverb	Duolingo
tartaruga	tartaruga	noun	Duolingo
tasca	tasca	noun	Duolingo
tasche	tasche	noun	Duolingo
tassa	tassa	noun	Duolingo
tasse	tasse	noun	Duolingo
tassì	tassi	noun	Duolingo
tastiera	tastiera	noun	Duolingo
tavola	tavola	noun	Duolingo
tavolo	tavolo	noun	Duolingo
tazza	tazza	noun	Duolingo
tazze	tazze	noun	Duolingo
tè	te	noun	Duolingo
te	te	pronoun	Duolingo
teatri	teatri	noun	Duolingo
teatro	teatro	noun	Duolingo
tecnici	tecnici	noun	Duolingo
tecnologia	tecnologia	noun	Duolingo
tedesca	tedesca	adjective	Duolingo
tedesche	tedesche	adjective	Duolingo
tedeschi	tedeschi	adjective	Duolingo
tedeschi	tedeschi	noun	Duolingo
tedesco	tedesco	adjective	Duolingo
tedesco	tedesco	noun	Duolingo
telefonando	telefonando	verb	Duolingo
telefonare	telefonare	verb	Duolingo
telefonate	telefonate	verb	Duolingo
telefoni	telefoni	noun	Duolingo
telefono	telefono	noun	Duolingo
telefono	telefono	verb	Duolingo
telegiornale	telegiornale	noun	Duolingo
televisione	televisione	noun	Duolingo
televisore	televisore	noun	Duolingo
televisori	televisori	noun	Duolingo
temperatura	temperatura	noun	Duolingo
tempo	tempo	noun	Duolingo
temporale	temporale	noun	Duolingo
temporali	temporali	noun	Duolingo
tenda	tenda	noun	Duolingo
tende	tende	noun	Duolingo
tenemmo	tenemmo	verb	Duolingo
tenendo	tenendo	verb	Duolingo
tenere	tenere	verb	Duolingo
tenesse	tenesse	verb	Duolingo
tenessimo	tenessimo	verb	Duolingo
tenete	tenete	verb	Duolingo
teneva	teneva	verb	Duolingo
tenevano	tenevano	verb	Duolingo
tenevo	tenevo	verb	Duolingo
tenga	tenga	verb	Duolingo
tengano	tengano	verb	Duolingo
tengo	tengo	verb	Duolingo
tengono	tengono	verb	Duolingo
teniamo	teniamo	verb	Duolingo
tenne	tenne	verb	Duolingo
tennis	tennis	noun	Duolingo
tentando	tentando	verb	Duolingo
teoria	teoria	noun	Duolingo
teorie	teorie	noun	Duolingo
terra	terra	noun	Duolingo
terrai	terrai	verb	Duolingo
terrazza	terrazza	noun	Duolingo
terre	terre	noun	Duolingo
terrebbe	terrebbe	verb	Duolingo
terrei	terrei	verb	Duolingo
terreni	terreni	noun	Duolingo
terreno	terreno	noun	Duolingo
terribile	terribile	adjective	Duolingo
territorio	territorio	noun	Duolingo
terrò	terro	verb	Duolingo
terza	terza	adjective	Duolingo
terzo	terzo	adjective	Duolingo
tesi	tesi	noun	Duolingo
tessuto	tessuto	noun	Duolingo
testa	testa	noun	Duolingo
testo	testo	noun	Duolingo
tetti	tetti	noun	Duolingo
tetto	tetto	noun	Duolingo
tevere	tevere	proper noun	Duolingo
ti	ti	pronoun	Duolingo
ti chiami	ti chiami		Duolingo
ti piacciono	ti piacciono		Duolingo
ti piace	ti piace		Duolingo
ti sta	ti sta		Duolingo
ti stanno	ti stanno		Duolingo
tieni	tieni	verb	Duolingo
tigre	tigre	noun	Duolingo
tigri	tigri	noun	Duolingo
timore	timore	noun	Duolingo
tipi	tipi	noun	Duolingo
tipo	tipo	noun	Duolingo
tira	tira	verb	Duolingo
tirare	tirare	verb	Duolingo
tiri	tiri	verb	Duolingo
titoli	titoli	noun	Duolingo
titolo	titolo	noun	Duolingo
tocca a	tocca a		Duolingo
toccando	toccando	verb	Duolingo
tonda	tonda	adjective	Duolingo
tonno	tonno	noun	Duolingo
topo	topo	noun	Duolingo
tornei	tornei	noun	Duolingo
torneo	torneo	noun	Duolingo
toro	toro	noun	Duolingo
torta	torta	noun	Duolingo
torte	torte		Duolingo
torte	torte	noun	Duolingo
toscana	toscana	proper noun	Duolingo
toscani	toscani	adjective	Duolingo
totale	totale	noun	Duolingo
totalmente	totalmente	adverb	Duolingo
totti	totti	proper noun	Duolingo
tra	tra	preposition	Duolingo
tradizionale	tradizionale	adjective	Duolingo
tradizionali	tradizionali	adjective	Duolingo
tradizione	tradizione	noun	Duolingo
traduzione	traduzione	noun	Duolingo
traffico	traffico	noun	Duolingo
tranne	tranne	preposition	Duolingo
tranquilla	tranquilla	adjective	Duolingo
tranquilli	tranquilli	adjective	Duolingo
tranquillo	tranquillo	adjective	Duolingo
trasformazione	trasformazione	noun	Duolingo
trasporti	trasporti	noun	Duolingo
trattamento	trattamento	noun	Duolingo
traversano	traversano	verb	Duolingo
traversare	traversare	verb	Duolingo
tre	tre	numeral	Duolingo
trecento	trecento	numeral	Duolingo
tredici	tredici	numeral	Duolingo
treni	treni	noun	Duolingo
treno	treno	noun	Duolingo
trent'	trent'	numeral	Duolingo
trenta	trenta	numeral	Duolingo
trentacinque	trentacinque	numeral	Duolingo
trentasette	trentasette	numeral	Duolingo
trentotto	trentotto	numeral	Duolingo
trentuno	trentuno	numeral	Duolingo
tribunale	tribunale	noun	Duolingo
triste	triste	adjective	Duolingo
tristi	tristi	adjective	Duolingo
troppa	troppa	determiner	Duolingo
troppe	troppe	determiner	Duolingo
troppi	troppi	determiner	Duolingo
troppo	troppo	adverb	Duolingo
troppo	troppo	determiner	Duolingo
trova	trova	verb	Duolingo
trovai	trovai	verb	Duolingo
trovammo	trovammo	verb	Duolingo
trovando	trovando	verb	Duolingo
trovare	trovare	verb	Duolingo
trovasse	trovasse	verb	Duolingo
trovassimo	trovassimo	verb	Duolingo
trovate	trovate	verb	Duolingo
trovava	trovava	verb	Duolingo
trovavamo	trovavamo	verb	Duolingo
trovavano	trovavano	verb	Duolingo
trovavi	trovavi	verb	Duolingo
troverà	trovera	verb	Duolingo
troverai	troverai	verb	Duolingo
troveranno	troveranno	verb	Duolingo
troverebbe	troverebbe	verb	Duolingo
troveremo	troveremo	verb	Duolingo
troveresti	troveresti	verb	Duolingo
troverete	troverete	verb	Duolingo
trovi	trovi	verb	Duolingo
troviamo	troviamo	verb	Duolingo
trovo	trovo	verb	Duolingo
trucchi	trucchi	verb	Duolingo
trucco	trucco	verb	Duolingo
tu	tu	pronoun	Duolingo
tua	tua	determiner	Duolingo
tua	tua	pronoun	Duolingo
tue	tue	determiner	Duolingo
tue	tue	pronoun	Duolingo
tuo	tuo	determiner	Duolingo
tuo	tuo	pronoun	Duolingo
tuoi	tuoi	determiner	Duolingo
tuoi	tuoi	pronoun	Duolingo
turismo	turismo	noun	Duolingo
turista	turista	noun	Duolingo
turisti	turisti	noun	Duolingo
turistica	turistica	adjective	Duolingo
turistici	turistici	adjective	Duolingo
tuta	tuta	noun	Duolingo
tute	tute	noun	Duolingo
tutta	tutta	determiner	Duolingo
tutta	tutta	pronoun	Duolingo
tuttavia	tuttavia	adverb	Duolingo
tutte	tutte	determiner	Duolingo
tutte	tutte	pronoun	Duolingo
tutti	tutti	determiner	Duolingo
tutti	tutti	pronoun	Duolingo
tutto	tutto	determiner	Duolingo
tutto	tutto	pronoun	Duolingo
tutto il tempo	tutto il tempo	adverb	Duolingo
uccelli	uccelli	noun	Duolingo
uccello	uccello	noun	Duolingo
uffici	uffici	noun	Duolingo
ufficio	ufficio	noun	Duolingo
ufficio del turismo	ufficio del turismo	noun	Duolingo
uguale	uguale	adjective	Duolingo
uguale	uguale	adverb	Duolingo
uguali	uguali	adjective	Duolingo
ugualmente	ugualmente	adverb	Duolingo
ultima	ultima	adjective	Duolingo
ultimi	ultimi	adjective	Duolingo
ultimo	ultimo	adjective	Duolingo
umana	umana	adjective	Duolingo
umani	umani	adjective	Duolingo
umano	umano	adjective	Duolingo
un	un	determiner	Duolingo
un'	un'	determiner	Duolingo
una	una	determiner	Duolingo
undici	undici	numeral	Duolingo
unendo	unendo	verb	Duolingo
unghie	unghie	noun	Duolingo
unì	uni	verb	Duolingo
unica	unica	adjective	Duolingo
unico	unico	adjective	Duolingo
unire	unire	verb	Duolingo
unirebbe	unirebbe	verb	Duolingo
unirei	unirei	verb	Duolingo
uniresti	uniresti	verb	Duolingo
unirono	unirono	verb	Duolingo
unisce	unisce	verb	Duolingo
unisse	unisse	verb	Duolingo
unissi	unissi	verb	Duolingo
unisti	unisti	verb	Duolingo
unite	unite	verb	Duolingo
università	universita	noun	Duolingo
universo	universo	noun	Duolingo
uno	uno	determiner	Duolingo
uno	uno	numeral	Duolingo
uno	uno	pronoun	Duolingo
uomini	uomini	noun	Duolingo
uomo	uomo	noun	Duolingo
uovo	uovo	noun	Duolingo
usa	usa	verb	Duolingo
usando	usando	verb	Duolingo
usare	usare	verb	Duolingo
usarono	usarono	verb	Duolingo
usasse	usasse	verb	Duolingo
usassi	usassi	verb	Duolingo
usate	usate	verb	Duolingo
usava	usava	verb	Duolingo
usavamo	usavamo	verb	Duolingo
uscita	uscita	noun	Duolingo
uscite	uscite	verb	Duolingo
userai	userai	verb	Duolingo
useranno	useranno	verb	Duolingo
userebbe	userebbe	verb	Duolingo
userei	userei	verb	Duolingo
useremo	useremo	verb	Duolingo
usi	usi	verb	Duolingo
usiamo	usiamo	verb	Duolingo
usino	usino	verb	Duolingo
usò	uso	verb	Duolingo
utile	utile	adjective	Duolingo
utili	utili	adjective	Duolingo
utilizzare	utilizzare	verb	Duolingo
uva	uva	noun	Duolingo
va	va	verb	Duolingo
vacanza	vacanza	noun	Duolingo
vacanze	vacanze	noun	Duolingo
vada	vada	verb	Duolingo
vado	vado	verb	Duolingo
vai	vai	verb	Duolingo
valigia	valigia	noun	Duolingo
valigie	valigie	noun	Duolingo
valore	valore	noun	Duolingo
vaniglia	vaniglia	noun	Duolingo
vanno	vanno	verb	Duolingo
vantaggi	vantaggi	noun	Duolingo
vantaggio	vantaggio	noun	Duolingo
vaporetto	vaporetto	noun	Duolingo
vasca	vasca	noun	Duolingo
ve	ve	pronoun	Duolingo
vecchi	vecchi	adjective	Duolingo
vecchia	vecchia	adjective	Duolingo
vecchie	vecchie	adjective	Duolingo
vecchio	vecchio	adjective	Duolingo
veda	veda	verb	Duolingo
vede	vede	verb	Duolingo
vedere	vedere	verb	Duolingo
vedesse	vedesse	verb	Duolingo
vedessero	vedessero	verb	Duolingo
vedessi	vedessi	verb	Duolingo
vedete	vedete	verb	Duolingo
vedeva	vedeva	verb	Duolingo
vedevamo	vedevamo	verb	Duolingo
vedevo	vedevo	verb	Duolingo
vediamo	vediamo	verb	Duolingo
vedo	vedo	verb	Duolingo
vedono	vedono	verb	Duolingo
vedrà	vedra	verb	Duolingo
vedrai	vedrai	verb	Duolingo
vedrebbe	vedrebbe	verb	Duolingo
vedrei	vedrei	verb	Duolingo
vedremo	vedremo	verb	Duolingo
vedresti	vedresti	verb	Duolingo
vedrete	vedrete	verb	Duolingo
vedrò	vedro	verb	Duolingo
vegetariana	vegetariana	adjective	Duolingo
vegetariane	vegetariane	adjective	Duolingo
vegetariano	vegetariano	noun	Duolingo
veloce	veloce	adjective	Duolingo
velocemente	velocemente	adverb	Duolingo
velocità	velocita	noun	Duolingo
vende	vende	verb	Duolingo
vendendo	vendendo	verb	Duolingo
vendere	vendere	verb	Duolingo
vendita	vendita	noun	Duolingo
vendite	vendite	noun	Duolingo
venditore	venditore	noun	Duolingo
venditori	venditori	noun	Duolingo
vendo	vendo	verb	Duolingo
vendono	vendono	verb	Duolingo
venendo	venendo	verb	Duolingo
venerdì	venerdi	noun	Duolingo
venga	venga	verb	Duolingo
vengano	vengano	verb	Duolingo
vengo	vengo	verb	Duolingo
venire	venire	verb	Duolingo
venisse	venisse	verb	Duolingo
venissi	venissi	verb	Duolingo
venite	venite	verb	Duolingo
veniva	veniva	verb	Duolingo
venivano	venivano	verb	Duolingo
venivi	venivi	verb	Duolingo
venne	venne	verb	Duolingo
venni	venni	verb	Duolingo
vent'	vent'	adjective	Duolingo
venti	venti	noun	Duolingo
venti	venti	numeral	Duolingo
venticinque	venticinque	numeral	Duolingo
ventidue	ventidue	numeral	Duolingo
ventilatore	ventilatore	noun	Duolingo
ventiquattro	ventiquattro	numeral	Duolingo
ventitré	ventitre	numeral	Duolingo
vento	vento	noun	Duolingo
ventosa	ventosa	adjective	Duolingo
ventoso	ventoso	adjective	Duolingo
ventuno	ventuno	numeral	Duolingo
veramente	veramente	adverb	Duolingo
verde	verde	adjective	Duolingo
verdi	verdi	adjective	Duolingo
verdi	verdi	noun	Duolingo
verdura	verdura	noun	Duolingo
verità	verita	noun	Duolingo
vero	vero	adjective	Duolingo
verranno	verranno	verb	Duolingo
verrebbe	verrebbe	verb	Duolingo
verremmo	verremmo	verb	Duolingo
verremo	verremo	verb	Duolingo
verrò	verro	verb	Duolingo
versione	versione	noun	Duolingo
verso	verso	preposition	Duolingo
vespa	vespa	noun	Duolingo
vespe	vespe	noun	Duolingo
vestendo	vestendo	verb	Duolingo
vestiamo	vestiamo	verb	Duolingo
vestite	vestite	verb	Duolingo
vestiti	vestiti	noun	Duolingo
vestito	vestito	noun	Duolingo
vetrina	vetrina	noun	Duolingo
vi	vi	pronoun	Duolingo
vi piacciono	vi piacciono		Duolingo
vi piace	vi piace		Duolingo
via	via	adverb	Duolingo
viaggi	viaggi	noun	Duolingo
viaggia	viaggia	verb	Duolingo
viaggiamo	viaggiamo	verb	Duolingo
viaggiano	viaggiano	verb	Duolingo
viaggiare	viaggiare	verb	Duolingo
viaggiate	viaggiate	verb	Duolingo
viaggio	viaggio	noun	Duolingo
viaggio	viaggio	verb	Duolingo
vicina	vicina	adjective	Duolingo
vicina	vicina	noun	Duolingo
vicine	vicine	noun	Duolingo
vicini	vicini	adjective	Duolingo
vicini	vicini	noun	Duolingo
vicino	vicino	adjective	Duolingo
vicino	vicino	adverb	Duolingo
vicino	vicino	noun	Duolingo
vide	vide	verb	Duolingo
video	video	noun	Duolingo
videro	videro	verb	Duolingo
vidi	vidi	verb	Duolingo
vie	vie	noun	Duolingo
viene	viene	verb	Duolingo
vieni	vieni	verb	Duolingo
villaggio	villaggio	noun	Duolingo
vincere	vincere	verb	Duolingo
vini	vini		Duolingo
vini	vini	noun	Duolingo
vino	vino	noun	Duolingo
viola	viola	adjective	Duolingo
violenza	violenza	noun	Duolingo
violini	violini	noun	Duolingo
violino	violino	noun	Duolingo
virtù	virtu	noun	Duolingo
virus	virus	noun	Duolingo
visi	visi	noun	Duolingo
visione	visione	noun	Duolingo
visioni	visioni	noun	Duolingo
visita	visita	noun	Duolingo
visita	visita	verb	Duolingo
visitando	visitando	verb	Duolingo
visitano	visitano	verb	Duolingo
visitare	visitare	verb	Duolingo
visitate	visitate	verb	Duolingo
visite	visite	noun	Duolingo
visiti	visiti	verb	Duolingo
visitiamo	visitiamo	verb	Duolingo
visito	visito	verb	Duolingo
viso	viso	noun	Duolingo
visse	visse	verb	Duolingo
vista	vista	noun	Duolingo
vita	vita	noun	Duolingo
vite	vite	noun	Duolingo
vitello	vitello	noun	Duolingo
vittima	vittima	noun	Duolingo
vittime	vittime	noun	Duolingo
viva	viva	adjective	Duolingo
viva	viva	verb	Duolingo
vivace	vivace	adjective	Duolingo
vivano	vivano	verb	Duolingo
vive	vive	adjective	Duolingo
vive	vive	verb	Duolingo
vivendo	vivendo	verb	Duolingo
vivere	vivere	verb	Duolingo
vivesse	vivesse	verb	Duolingo
vivessero	vivessero	verb	Duolingo
vivete	vivete	verb	Duolingo
viveva	viveva	verb	Duolingo
vivevamo	vivevamo	verb	Duolingo
vivi	vivi	verb	Duolingo
viviamo	viviamo	verb	Duolingo
vivo	vivo	adjective	Duolingo
vivo	vivo	verb	Duolingo
vivono	vivono	verb	Duolingo
vivrà	vivra	verb	Duolingo
vivranno	vivranno	verb	Duolingo
vivrebbe	vivrebbe	verb	Duolingo
vivrei	vivrei	verb	Duolingo
vivrò	vivro	verb	Duolingo
voce	voce	noun	Duolingo
voci	voci	noun	Duolingo
voglia	voglia	noun	Duolingo
voglia	voglia	verb	Duolingo
vogliamo	vogliamo	verb	Duolingo
vogliano	vogliano	verb	Duolingo
voglio	voglio	verb	Duolingo
vogliono	vogliono	verb	Duolingo
voi	voi	pronoun	Duolingo
vola	vola	verb	Duolingo
volano	volano	verb	Duolingo
volare	volare	verb	Duolingo
volendo	volendo	verb	Duolingo
volentieri	volentieri	adverb	Duolingo
voler	voler	verb	Duolingo
volesse	volesse	verb	Duolingo
volessi	volessi	verb	Duolingo
volessimo	volessimo	verb	Duolingo
volete	volete	verb	Duolingo
voleva	voleva	verb	Duolingo
volevano	volevano	verb	Duolingo
volevi	volevi	verb	Duolingo
volevo	volevo	verb	Duolingo
voli	voli	noun	Duolingo
voli	voli	verb	Duolingo
volle	volle	verb	Duolingo
vollero	vollero	verb	Duolingo
volo	volo	noun	Duolingo
volo	volo	verb	Duolingo
volta	volta	noun	Duolingo
volte	volte	noun	Duolingo
vorrà	vorra	verb	Duolingo
vorranno	vorranno	verb	Duolingo
vorrebbe	vorrebbe	verb	Duolingo
vorrei	vorrei		Duolingo
vorrei	vorrei	verb	Duolingo
vorremmo	vorremmo	verb	Duolingo
vorremo	vorremo	verb	Duolingo
vorrò	vorro	verb	Duolingo
vostra	vostra	determiner	Duolingo
vostra	vostra	pronoun	Duolingo
vostre	vostre	determiner	Duolingo
vostre	vostre	pronoun	Duolingo
vostri	vostri	determiner	Duolingo
vostri	vostri	pronoun	Duolingo
vostro	vostro	determiner	Duolingo
vostro	vostro	pronoun	Duolingo
votare	votare	verb	Duolingo
voti	voti	noun	Duolingo
voto	voto	noun	Duolingo
vulcano	vulcano	noun	Duolingo
vuoi	vuoi	verb	Duolingo
vuol	vuol	verb	Duolingo
vuole	vuole	verb	Duolingo
vuota	vuota	adjective	Duolingo
vuoti	vuoti	adjective	Duolingo
vuoto	vuoto	adjective	Duolingo
yoga	yoga	noun	Duolingo
yogurt	yogurt	noun	Duolingo
zaini	zaini	noun	Duolingo
zaino	zaino	noun	Duolingo
zanzara	zanzara	noun	Duolingo
zanzare	zanzare	noun	Duolingo
zebra	zebra	noun	Duolingo
zebre	zebre	noun	Duolingo
zero	zero	numeral	Duolingo
zia	zia	noun	Duolingo
zie	zie	noun	Duolingo
zii	zii	noun	Duolingo
zio	zio	noun	Duolingo
zona	zona	noun	Duolingo
zone	zone	noun	Duolingo
zoo	zoo	noun	Duolingo
zucche	zucche	noun	Duolingo
zucchero	zucchero	noun	Duolingo
zuppa	zuppa	noun	Duolingo
