learnable	normalized	partOfSpeech	source
a	a		Duolingo
ab	ab		Duolingo
ad	ad		Duolingo
advenimus	advenimus		Duolingo
advenis	advenis		Duolingo
advenit	advenit		Duolingo
advenitis	advenitis		Duolingo
adveniunt	adveniunt		Duolingo
aedificia	aedificia		Duolingo
aedificio	aedificio		Duolingo
aedificium	aedificium		Duolingo
aeger	aeger		Duolingo
aegra	aegra		Duolingo
aegri	aegri		Duolingo
aegros	aegros		Duolingo
aegrum	aegrum		Duolingo
aestimamus	aestimamus		Duolingo
aestimant	aestimant		Duolingo
aestimare	aestimare		Duolingo
aestimas	aestimas		Duolingo
aestimat	aestimat		Duolingo
aestimatis	aestimatis		Duolingo
agit	agit		Duolingo
agri	agri		Duolingo
agricola	agricola		Duolingo
agricolae	agricolae		Duolingo
agro	agro		Duolingo
agros	agros		Duolingo
agrum	agrum		Duolingo
amamus	amamus		Duolingo
amatis	amatis		Duolingo
ambulamus	ambulamus		Duolingo
ambulare	ambulare		Duolingo
ambulat	ambulat		Duolingo
ambulatis	ambulatis		Duolingo
ambulo	ambulo		Duolingo
americana	americana		Duolingo
americanus	americanus		Duolingo
anglice	anglice		Duolingo
animalia	animalia		Duolingo
ante	ante		Duolingo
antiquae	antiquae		Duolingo
antiquam	antiquam		Duolingo
antiquas	antiquas		Duolingo
antiqui	antiqui		Duolingo
anuli	anuli		Duolingo
anulos	anulos		Duolingo
anulum	anulum		Duolingo
anulus	anulus		Duolingo
appropinquare	appropinquare		Duolingo
appropinquat	appropinquat		Duolingo
aqua	aqua		Duolingo
ara	ara		Duolingo
arae	arae		Duolingo
aram	aram		Duolingo
aras	aras		Duolingo
arbore	arbore		Duolingo
arborem	arborem		Duolingo
arbores	arbores		Duolingo
architecti	architecti		Duolingo
architectus	architectus		Duolingo
armario	armario		Duolingo
ascendere	ascendere		Duolingo
ascendit	ascendit		Duolingo
ascenditis	ascenditis		Duolingo
ascendo	ascendo		Duolingo
ascendunt	ascendunt		Duolingo
atrio	atrio		Duolingo
atrium	atrium		Duolingo
aurea	aurea		Duolingo
aurei	aurei		Duolingo
aureos	aureos		Duolingo
auroram	auroram		Duolingo
aut	aut		Duolingo
bacchum	bacchum		Duolingo
bacchus	bacchus		Duolingo
balnea	balnea		Duolingo
balneo	balneo		Duolingo
balneum	balneum		Duolingo
bellum	bellum		Duolingo
bene	bene	adverb	Duolingo
benigna	benigna		Duolingo
benignae	benignae		Duolingo
benignam	benignam		Duolingo
benigni	benigni		Duolingo
benignum	benignum		Duolingo
benignus	benignus		Duolingo
bibere	bibere		Duolingo
bibimus	bibimus		Duolingo
bibis	bibis		Duolingo
bibit	bibit		Duolingo
bibliotheca	bibliotheca		Duolingo
bibliothecam	bibliothecam		Duolingo
bibo	bibo		Duolingo
bostonia	bostonia		Duolingo
bostoniae	bostoniae		Duolingo
bubo	bubo		Duolingo
bubones	bubones		Duolingo
caelo	caelo	noun	Duolingo
caelum	caelum	noun	Duolingo
caffea	caffea		Duolingo
caffeam	caffeam		Duolingo
calcei	calcei		Duolingo
calceos	calceos		Duolingo
callida	callida		Duolingo
callidam	callidam		Duolingo
callidas	callidas		Duolingo
callidi	callidi		Duolingo
callidum	callidum		Duolingo
callidus	callidus		Duolingo
candida	candida		Duolingo
candidae	candidae		Duolingo
candidam	candidam		Duolingo
candidas	candidas		Duolingo
candidus	candidus		Duolingo
canis	canis		Duolingo
cantamus	cantamus		Duolingo
cantant	cantant		Duolingo
cantare	cantare		Duolingo
cantat	cantat		Duolingo
cantatis	cantatis		Duolingo
captamus	captamus		Duolingo
captat	captat		Duolingo
capto	capto		Duolingo
carmen	carmen		Duolingo
carmina	carmina		Duolingo
carnem	carnem		Duolingo
carnes	carnes		Duolingo
caro	caro		Duolingo
casei	casei		Duolingo
caseo	caseo		Duolingo
caseum	caseum		Duolingo
caseus	caseus		Duolingo
caupona	caupona		Duolingo
cauponae	cauponae		Duolingo
cauponas	cauponas		Duolingo
celamus	celamus		Duolingo
celant	celant		Duolingo
celas	celas		Duolingo
celat	celat		Duolingo
celeriter	celeriter		Duolingo
celo	celo		Duolingo
cena	cena		Duolingo
cenaculo	cenaculo		Duolingo
cenaculum	cenaculum		Duolingo
cenas	cenas		Duolingo
cibi	cibi		Duolingo
cibos	cibos		Duolingo
cibum	cibum		Duolingo
civitas	civitas		Duolingo
civitates	civitates		Duolingo
cliens	cliens		Duolingo
clientes	clientes		Duolingo
colligere	colligere		Duolingo
colligimus	colligimus		Duolingo
colligit	colligit		Duolingo
colligitis	colligitis		Duolingo
colligo	colligo		Duolingo
colligunt	colligunt		Duolingo
colloquium	colloquium		Duolingo
comedere	comedere		Duolingo
comedis	comedis		Duolingo
comes	comes		Duolingo
comitem	comitem		Duolingo
comites	comites		Duolingo
concupiscit	concupiscit		Duolingo
concupisco	concupisco		Duolingo
concupiscunt	concupiscunt		Duolingo
condis	condis		Duolingo
condit	condit		Duolingo
condo	condo		Duolingo
constant	constant		Duolingo
constat	constat	verb	Duolingo
construimus	construimus		Duolingo
construis	construis		Duolingo
construit	construit		Duolingo
construitis	construitis		Duolingo
construunt	construunt		Duolingo
contorquent	contorquent		Duolingo
contorquere	contorquere		Duolingo
contorquet	contorquet		Duolingo
contubernales	contubernales		Duolingo
contubernalis	contubernalis		Duolingo
coquere	coquere		Duolingo
coqui	coqui		Duolingo
coquit	coquit		Duolingo
coquitis	coquitis		Duolingo
coquos	coquos		Duolingo
coquunt	coquunt		Duolingo
coquus	coquus		Duolingo
cotidie	cotidie		Duolingo
crustula	crustula	noun	Duolingo
crustulum	crustulum	noun	Duolingo
cubicula	cubicula		Duolingo
cubiculo	cubiculo		Duolingo
cubiculum	cubiculum		Duolingo
culina	culina		Duolingo
culinas	culinas		Duolingo
cum	cum		Duolingo
currere	currere		Duolingo
currimus	currimus		Duolingo
currit	currit		Duolingo
curro	curro		Duolingo
currunt	currunt		Duolingo
da	da	verb	Duolingo
de	de		Duolingo
deae	deae		Duolingo
deas	deas		Duolingo
debemus	debemus		Duolingo
debent	debent		Duolingo
debeo	debeo		Duolingo
debet	debet		Duolingo
decem	decem	numeral	Duolingo
dei	dei		Duolingo
delemus	delemus		Duolingo
delent	delent		Duolingo
deleo	deleo		Duolingo
deles	deles		Duolingo
delet	delet		Duolingo
deos	deos		Duolingo
descendere	descendere		Duolingo
descendimus	descendimus		Duolingo
descendit	descendit		Duolingo
descenditis	descenditis		Duolingo
descendo	descendo		Duolingo
descendunt	descendunt		Duolingo
deus	deus		Duolingo
discipula	discipula		Duolingo
discipulae	discipulae		Duolingo
discipulas	discipulas		Duolingo
discipuli	discipuli		Duolingo
discipulos	discipulos		Duolingo
discipulus	discipulus		Duolingo
discit	discit	verb	Duolingo
disco	disco	verb	Duolingo
discunt	discunt	verb	Duolingo
docemus	docemus		Duolingo
doceo	doceo		Duolingo
doces	doces		Duolingo
docet	docet		Duolingo
docetis	docetis		Duolingo
domi	domi	noun	Duolingo
domo	domo		Duolingo
domum	domum		Duolingo
donum	donum		Duolingo
dormimus	dormimus		Duolingo
dormio	dormio		Duolingo
dormire	dormire		Duolingo
dormis	dormis		Duolingo
dormit	dormit	verb	Duolingo
dormiunt	dormiunt	verb	Duolingo
duae	duae	numeral	Duolingo
duo	duo	numeral	Duolingo
ea	ea		Duolingo
ebria	ebria		Duolingo
ebrias	ebrias		Duolingo
ebrii	ebrii		Duolingo
ebrium	ebrium		Duolingo
ebrius	ebrius		Duolingo
ego	ego	pronoun	Duolingo
ei	ei	pronoun	Duolingo
eius	eius		Duolingo
emere	emere		Duolingo
emis	emis		Duolingo
emit	emit		Duolingo
emitis	emitis		Duolingo
emitne	emitne		Duolingo
emptor	emptor		Duolingo
emptores	emptores		Duolingo
emunt	emunt		Duolingo
eo	eo		Duolingo
eorum	eorum		Duolingo
epistulae	epistulae		Duolingo
epistulas	epistulas		Duolingo
es	es	verb	Duolingo
est	est	verb	Duolingo
estis	estis		Duolingo
estne	estne		Duolingo
esurimus	esurimus		Duolingo
esuriunt	esuriunt		Duolingo
et	et	conjunction	Duolingo
eunt	eunt		Duolingo
excitamus	excitamus		Duolingo
excitant	excitant		Duolingo
excitat	excitat		Duolingo
excitatis	excitatis		Duolingo
excito	excito		Duolingo
exclamant	exclamant		Duolingo
exclamas	exclamas		Duolingo
exclamatis	exclamatis		Duolingo
exeunt	exeunt		Duolingo
exhaurio	exhaurio		Duolingo
exhaurit	exhaurit		Duolingo
exire	exire		Duolingo
exit	exit		Duolingo
fabulam	fabulam		Duolingo
fabulas	fabulas		Duolingo
facimus	facimus		Duolingo
facio	facio		Duolingo
facis	facis		Duolingo
facit	facit		Duolingo
facitis	facitis		Duolingo
faciunt	faciunt		Duolingo
familia	familia	noun	Duolingo
familiares	familiares		Duolingo
familiaris	familiaris		Duolingo
farta	farta		Duolingo
fartus	fartus		Duolingo
femina	femina	noun	Duolingo
feminae	feminae	noun	Duolingo
fessae	fessae		Duolingo
fessi	fessi		Duolingo
fessum	fessum		Duolingo
fessus	fessus		Duolingo
filiae	filiae	noun	Duolingo
filias	filias		Duolingo
filii	filii	noun	Duolingo
filios	filios		Duolingo
fluere	fluere		Duolingo
fluit	fluit		Duolingo
flumen	flumen		Duolingo
flumina	flumina		Duolingo
fluunt	fluunt		Duolingo
foro	foro	noun	Duolingo
fortasse	fortasse		Duolingo
forte	forte		Duolingo
forum	forum		Duolingo
frater	frater		Duolingo
fratres	fratres	noun	Duolingo
fulmen	fulmen		Duolingo
fulmina	fulmina		Duolingo
fur	fur		Duolingo
furem	furem		Duolingo
fures	fures		Duolingo
garum	garum		Duolingo
gemmae	gemmae		Duolingo
gemmam	gemmam		Duolingo
gemmas	gemmas		Duolingo
gerit	gerit		Duolingo
germanice	germanice		Duolingo
gerunt	gerunt		Duolingo
gladiator	gladiator		Duolingo
gladiatores	gladiatores		Duolingo
gustamus	gustamus		Duolingo
gustas	gustas		Duolingo
gustat	gustat		Duolingo
gustatis	gustatis		Duolingo
gusto	gusto		Duolingo
habemus	habemus		Duolingo
habent	habent		Duolingo
habeo	habeo	verb	Duolingo
habes	habes	verb	Duolingo
habet	habet	verb	Duolingo
habetis	habetis		Duolingo
habitamus	habitamus		Duolingo
habitant	habitant	verb	Duolingo
habitas	habitas	verb	Duolingo
habitasne	habitasne	verb	Duolingo
habitat	habitat	verb	Duolingo
habitatis	habitatis		Duolingo
habito	habito	verb	Duolingo
hae	hae		Duolingo
haec	haec		Duolingo
hastam	hastam		Duolingo
hastas	hastas		Duolingo
hic	hic		Duolingo
hispanice	hispanice		Duolingo
histrio	histrio		Duolingo
histriones	histriones		Duolingo
hoc	hoc		Duolingo
hodie	hodie		Duolingo
hominem	hominem		Duolingo
homines	homines		Duolingo
homo	homo		Duolingo
hora	hora		Duolingo
horam	horam		Duolingo
horologium	horologium		Duolingo
hostem	hostem		Duolingo
hostes	hostes		Duolingo
hostis	hostis		Duolingo
iacimus	iacimus		Duolingo
iacio	iacio		Duolingo
iacis	iacis		Duolingo
iacit	iacit		Duolingo
iaciunt	iaciunt		Duolingo
ientaculum	ientaculum		Duolingo
ignavae	ignavae		Duolingo
ignavi	ignavi		Duolingo
ignavum	ignavum		Duolingo
ignavus	ignavus		Duolingo
igne	igne		Duolingo
ignes	ignes		Duolingo
ignis	ignis		Duolingo
illa	illa		Duolingo
ille	ille		Duolingo
illi	illi		Duolingo
illos	illos		Duolingo
illum	illum		Duolingo
imber	imber		Duolingo
imbres	imbres		Duolingo
impiae	impiae		Duolingo
impii	impii		Duolingo
impios	impios		Duolingo
impius	impius		Duolingo
implemus	implemus		Duolingo
implent	implent		Duolingo
impleo	impleo		Duolingo
implere	implere		Duolingo
imples	imples		Duolingo
implet	implet		Duolingo
impletis	impletis		Duolingo
imus	imus		Duolingo
in	in	preposition	Duolingo
inscriptio	inscriptio		Duolingo
inscriptionem	inscriptionem		Duolingo
inscriptiones	inscriptiones		Duolingo
insula	insula		Duolingo
insulas	insulas		Duolingo
interdiu	interdiu		Duolingo
interdum	interdum		Duolingo
interficimus	interficimus		Duolingo
interficit	interficit		Duolingo
interficitis	interficitis		Duolingo
invenire	invenire		Duolingo
inveniunt	inveniunt		Duolingo
irata	irata		Duolingo
irati	irati		Duolingo
irato	irato		Duolingo
iratos	iratos		Duolingo
iratus	iratus		Duolingo
ire	ire		Duolingo
is	is		Duolingo
it	it		Duolingo
ita	ita	adverb	Duolingo
italia	italia	proper noun	Duolingo
iter	iter		Duolingo
itinera	itinera		Duolingo
itis	itis		Duolingo
iuppiter	iuppiter		Duolingo
iuvenem	iuvenem		Duolingo
iuvenes	iuvenes		Duolingo
iuvenes	iuvenes	noun	Duolingo
iuvenis	iuvenis		Duolingo
iuvenis	iuvenis	noun	Duolingo
labro	labro		Duolingo
labrum	labrum		Duolingo
laeta	laeta		Duolingo
laeti	laeti		Duolingo
laetum	laetum		Duolingo
laetus	laetus		Duolingo
languide	languide		Duolingo
larario	larario		Duolingo
lararium	lararium		Duolingo
latinae	latinae		Duolingo
latinam	latinam		Duolingo
latinas	latinas		Duolingo
latinis	latinis		Duolingo
latrina	latrina		Duolingo
latrinae	latrinae		Duolingo
latrinas	latrinas		Duolingo
laudat	laudat		Duolingo
lavamus	lavamus		Duolingo
lavare	lavare		Duolingo
lavas	lavas		Duolingo
lavatis	lavatis		Duolingo
lavo	lavo		Duolingo
lecti	lecti		Duolingo
lectionem	lectionem		Duolingo
lectiones	lectiones		Duolingo
lecto	lecto		Duolingo
lectos	lectos		Duolingo
lectus	lectus		Duolingo
legere	legere		Duolingo
legis	legis	verb	Duolingo
legit	legit	verb	Duolingo
legitis	legitis	verb	Duolingo
lego	lego	verb	Duolingo
legunt	legunt	verb	Duolingo
lente	lente		Duolingo
liber	liber		Duolingo
libri	libri		Duolingo
libro	libro		Duolingo
libros	libros		Duolingo
librum	librum		Duolingo
linguae	linguae		Duolingo
linguam	linguam		Duolingo
linguas	linguas		Duolingo
litteras	litteras		Duolingo
litteris	litteris		Duolingo
longum	longum		Duolingo
loqueris	loqueris	verb	Duolingo
loquimini	loquimini		Duolingo
loquimur	loquimur		Duolingo
loquitur	loquitur	verb	Duolingo
loquor	loquor	verb	Duolingo
loquuntur	loquuntur		Duolingo
ludi	ludi	noun	Duolingo
ludo	ludo	noun	Duolingo
ludus	ludus	noun	Duolingo
magister	magister		Duolingo
magistra	magistra		Duolingo
magistrum	magistrum		Duolingo
male	male	adverb	Duolingo
mane	mane		Duolingo
maritum	maritum		Duolingo
maritus	maritus		Duolingo
mars	mars		Duolingo
mater	mater		Duolingo
matrem	matrem		Duolingo
matres	matres		Duolingo
me	me	pronoun	Duolingo
mea	mea	adjective	Duolingo
meae	meae	adjective	Duolingo
medica	medica		Duolingo
medicam	medicam		Duolingo
medicas	medicas		Duolingo
medici	medici		Duolingo
medicos	medicos		Duolingo
medicum	medicum		Duolingo
medicus	medicus		Duolingo
mei	mei	adjective	Duolingo
mensa	mensa		Duolingo
mensae	mensae		Duolingo
mensam	mensam		Duolingo
mensas	mensas		Duolingo
meo	meo		Duolingo
mercator	mercator		Duolingo
mercatores	mercatores		Duolingo
mercurius	mercurius		Duolingo
meridiem	meridiem		Duolingo
meridies	meridies		Duolingo
meus	meus	adjective	Duolingo
mihi	mihi	pronoun	Duolingo
miles	miles		Duolingo
milites	milites		Duolingo
minerva	minerva		Duolingo
minime	minime	adverb	Duolingo
miser	miser		Duolingo
misera	misera		Duolingo
miseri	miseri		Duolingo
miserum	miserum		Duolingo
mittimus	mittimus		Duolingo
mittit	mittit		Duolingo
mittitis	mittitis		Duolingo
mittunt	mittunt		Duolingo
monte	monte		Duolingo
montem	montem		Duolingo
montes	montes		Duolingo
mores	mores		Duolingo
mos	mos		Duolingo
multae	multae	adjective	Duolingo
multas	multas		Duolingo
multi	multi	adjective	Duolingo
multos	multos		Duolingo
murem	murem		Duolingo
mures	mures		Duolingo
mus	mus		Duolingo
mustela	mustela		Duolingo
mustelae	mustelae		Duolingo
narrant	narrant		Duolingo
narrare	narrare		Duolingo
narras	narras		Duolingo
narro	narro		Duolingo
nata	nata		Duolingo
natant	natant		Duolingo
natare	natare		Duolingo
natas	natas		Duolingo
natat	natat		Duolingo
nato	nato		Duolingo
natus	natus		Duolingo
negotiosa	negotiosa		Duolingo
negotiosae	negotiosae		Duolingo
negotiosas	negotiosas		Duolingo
negotiosi	negotiosi		Duolingo
negotiosos	negotiosos		Duolingo
negotiosus	negotiosus		Duolingo
nemo	nemo		Duolingo
neptunum	neptunum		Duolingo
neptunus	neptunus		Duolingo
nimis	nimis		Duolingo
nobis	nobis		Duolingo
noctu	noctu		Duolingo
noli	noli		Duolingo
nolite	nolite		Duolingo
nomen	nomen	noun	Duolingo
non	non	adverb	Duolingo
nos	nos		Duolingo
noster	noster		Duolingo
nostra	nostra		Duolingo
nostram	nostram		Duolingo
nostras	nostras		Duolingo
nostros	nostros		Duolingo
nostrum	nostrum		Duolingo
nova	nova		Duolingo
novae	novae		Duolingo
novam	novam		Duolingo
novas	novas		Duolingo
novi eboraci	novi eboraci		Duolingo
novum eboracum	novum eboracum		Duolingo
novus	novus		Duolingo
num	num		Duolingo
numeramus	numeramus		Duolingo
numerant	numerant		Duolingo
numeras	numeras		Duolingo
numerat	numerat		Duolingo
numero	numero		Duolingo
nummis	nummis	noun	Duolingo
nunc	nunc		Duolingo
olet	olet		Duolingo
olivae	olivae	noun	Duolingo
olivas	olivas	noun	Duolingo
optimi	optimi		Duolingo
optimum	optimum		Duolingo
optimus	optimus		Duolingo
orator	orator		Duolingo
oratorem	oratorem		Duolingo
oratores	oratores		Duolingo
ossa	ossa		Duolingo
otiosae	otiosae		Duolingo
otiosas	otiosas		Duolingo
otiosi	otiosi		Duolingo
otiosos	otiosos		Duolingo
otiosus	otiosus		Duolingo
ovum	ovum		Duolingo
paedagogi	paedagogi		Duolingo
paedagogo	paedagogo		Duolingo
paedagogum	paedagogum		Duolingo
paedagogus	paedagogus		Duolingo
pane	pane		Duolingo
panem	panem	noun	Duolingo
panis	panis	noun	Duolingo
patella	patella		Duolingo
patellae	patellae		Duolingo
patellam	patellam		Duolingo
pater	pater		Duolingo
paterfamilias	paterfamilias		Duolingo
patrem	patrem		Duolingo
patres	patres		Duolingo
patroni	patroni		Duolingo
patronos	patronos		Duolingo
patronum	patronum		Duolingo
patronus	patronus		Duolingo
pavimento	pavimento		Duolingo
pavimentum	pavimentum		Duolingo
pavo	pavo		Duolingo
pavonem	pavonem		Duolingo
pavones	pavones		Duolingo
pecuniam	pecuniam		Duolingo
pecuniosa	pecuniosa		Duolingo
pecuniosi	pecuniosi		Duolingo
pecuniosus	pecuniosus		Duolingo
per	per		Duolingo
perfida	perfida		Duolingo
perfidae	perfidae		Duolingo
perfidas	perfidas		Duolingo
perfidi	perfidi		Duolingo
perfidos	perfidos		Duolingo
perfidum	perfidum		Duolingo
perfidus	perfidus		Duolingo
perflant	perflant		Duolingo
perflat	perflat		Duolingo
perita	perita		Duolingo
periti	periti		Duolingo
peritos	peritos		Duolingo
peritum	peritum		Duolingo
peritus	peritus		Duolingo
perna	perna		Duolingo
pernam	pernam		Duolingo
pessima	pessima		Duolingo
pessimus	pessimus		Duolingo
philadelphia	philadelphia		Duolingo
philadelphiae	philadelphiae		Duolingo
pictor	pictor		Duolingo
pictores	pictores		Duolingo
pictura	pictura		Duolingo
picturae	picturae		Duolingo
picturam	picturam		Duolingo
picturas	picturas		Duolingo
pii	pii		Duolingo
pingere	pingere		Duolingo
pingis	pingis		Duolingo
pingit	pingit		Duolingo
pingitis	pingitis		Duolingo
pingo	pingo		Duolingo
pinguem	pinguem		Duolingo
pingues	pingues		Duolingo
pinguis	pinguis		Duolingo
pingunt	pingunt		Duolingo
piscem	piscem		Duolingo
pisces	pisces		Duolingo
piscina	piscina		Duolingo
piscinae	piscinae		Duolingo
piscinam	piscinam		Duolingo
piscis	piscis		Duolingo
pistor	pistor		Duolingo
pistores	pistores		Duolingo
pium	pium		Duolingo
pius	pius		Duolingo
placent	placent		Duolingo
placet	placet		Duolingo
placetne	placetne		Duolingo
placida	placida		Duolingo
placidae	placidae		Duolingo
placidas	placidas		Duolingo
placidos	placidos		Duolingo
placidum	placidum		Duolingo
placidus	placidus		Duolingo
platea	platea		Duolingo
plateae	plateae		Duolingo
plurima	plurima		Duolingo
plurimae	plurimae		Duolingo
plurimi	plurimi		Duolingo
plurimos	plurimos		Duolingo
pocula	pocula		Duolingo
poculo	poculo		Duolingo
poculum	poculum		Duolingo
poeta	poeta		Duolingo
poetae	poetae		Duolingo
pons	pons		Duolingo
ponte	ponte		Duolingo
pontem	pontem		Duolingo
pontes	pontes		Duolingo
portamus	portamus		Duolingo
portant	portant		Duolingo
portas	portas	verb	Duolingo
portat	portat		Duolingo
porto	porto	verb	Duolingo
possum	possum		Duolingo
possumus	possumus		Duolingo
possunt	possunt		Duolingo
post	post		Duolingo
potes	potes		Duolingo
potesne	potesne		Duolingo
potest	potest		Duolingo
potestis	potestis		Duolingo
prandia	prandia		Duolingo
prandium	prandium		Duolingo
pretia	pretia		Duolingo
pretium	pretium		Duolingo
prima	prima		Duolingo
primam	primam		Duolingo
professor	professor		Duolingo
professorem	professorem		Duolingo
professores	professores		Duolingo
proxima	proxima		Duolingo
psittaci	psittaci		Duolingo
psittaco	psittaco		Duolingo
psittacos	psittacos		Duolingo
psittacum	psittacum		Duolingo
psittacus	psittacus		Duolingo
puella	puella	noun	Duolingo
puellae	puellae	noun	Duolingo
puellas	puellas		Duolingo
puer	puer	noun	Duolingo
pueri	pueri	noun	Duolingo
pueros	pueros		Duolingo
pugnamus	pugnamus		Duolingo
pugnant	pugnant		Duolingo
pugnare	pugnare		Duolingo
pugnas	pugnas		Duolingo
pugnatis	pugnatis		Duolingo
pugno	pugno		Duolingo
pulchras	pulchras		Duolingo
pulchro	pulchro		Duolingo
pulchrum	pulchrum		Duolingo
pulsamus	pulsamus		Duolingo
pulsant	pulsant		Duolingo
pulsas	pulsas		Duolingo
pulsat	pulsat		Duolingo
pulsatis	pulsatis		Duolingo
pupa	pupa		Duolingo
pupae	pupae		Duolingo
pupas	pupas		Duolingo
quaeso	quaeso	verb	Duolingo
quanti	quanti		Duolingo
quartam	quartam		Duolingo
quattuor	quattuor	numeral	Duolingo
quid	quid		Duolingo
quid	quid	pronoun	Duolingo
quinque	quinque	numeral	Duolingo
quintam	quintam		Duolingo
quintus	quintus		Duolingo
quis	quis	pronoun	Duolingo
quo	quo		Duolingo
quomodo	quomodo	adverb	Duolingo
quoque	quoque		Duolingo
quot	quot		Duolingo
quot	quot	adjective	Duolingo
rapide	rapide		Duolingo
ratiocinator	ratiocinator		Duolingo
ratiocinatorem	ratiocinatorem		Duolingo
ratiocinatores	ratiocinatores		Duolingo
regis	regis		Duolingo
regit	regit		Duolingo
rego	rego		Duolingo
rogant	rogant		Duolingo
rogare	rogare		Duolingo
rogat	rogat		Duolingo
romae	romae	proper noun	Duolingo
rubrum	rubrum	adjective	Duolingo
sacer	sacer		Duolingo
sacerdos	sacerdos		Duolingo
sacerdotem	sacerdotem		Duolingo
sacerdotes	sacerdotes		Duolingo
sacrae	sacrae		Duolingo
sacram	sacram		Duolingo
sacrificant	sacrificant		Duolingo
sacrificare	sacrificare		Duolingo
sacrificat	sacrificat		Duolingo
sacrificatis	sacrificatis		Duolingo
sacros	sacros		Duolingo
sacrum	sacrum		Duolingo
saepe	saepe		Duolingo
salsa	salsa		Duolingo
salsam	salsam		Duolingo
salsi	salsi		Duolingo
salsos	salsos		Duolingo
salsum	salsum		Duolingo
salsus	salsus		Duolingo
saltant	saltant		Duolingo
saltare	saltare		Duolingo
saltat	saltat		Duolingo
saltatis	saltatis		Duolingo
salutationem	salutationem		Duolingo
salutationes	salutationes		Duolingo
salve	salve	verb	Duolingo
salvete	salvete	verb	Duolingo
sanae	sanae		Duolingo
sanamus	sanamus		Duolingo
sanant	sanant		Duolingo
sanas	sanas	verb	Duolingo
sanat	sanat		Duolingo
sanum	sanum		Duolingo
sanus	sanus		Duolingo
sapiens	sapiens		Duolingo
sapientes	sapientes		Duolingo
scaena	scaena		Duolingo
scaenae	scaenae		Duolingo
scaenam	scaenam		Duolingo
scaenas	scaenas		Duolingo
scio	scio		Duolingo
scitis	scitis		Duolingo
sciunt	sciunt		Duolingo
scribimus	scribimus	verb	Duolingo
scribis	scribis	verb	Duolingo
scribit	scribit	verb	Duolingo
scribitis	scribitis	verb	Duolingo
scribo	scribo	verb	Duolingo
scribunt	scribunt	verb	Duolingo
scutum	scutum		Duolingo
se	se	pronoun	Duolingo
secunda	secunda		Duolingo
secundam	secundam		Duolingo
sed	sed	conjunction	Duolingo
sedent	sedent		Duolingo
sedere	sedere		Duolingo
sedes	sedes		Duolingo
sella	sella		Duolingo
sellae	sellae		Duolingo
sellas	sellas		Duolingo
semisomna	semisomna		Duolingo
semisomnus	semisomnus		Duolingo
semper	semper		Duolingo
senem	senem		Duolingo
senes	senes		Duolingo
senex	senex		Duolingo
senilem	senilem		Duolingo
senilis	senilis		Duolingo
sententiae	sententiae		Duolingo
sententiam	sententiam		Duolingo
sententias	sententias		Duolingo
sepulchra	sepulchra		Duolingo
sepulchrum	sepulchrum		Duolingo
sero	sero		Duolingo
servamus	servamus		Duolingo
servant	servant		Duolingo
servat	servat		Duolingo
servo	servo		Duolingo
severa	severa		Duolingo
severam	severam		Duolingo
severi	severi		Duolingo
severus	severus		Duolingo
silva	silva		Duolingo
silvam	silvam		Duolingo
silvas	silvas		Duolingo
sine dubio	sine dubio		Duolingo
socii	socii		Duolingo
socios	socios		Duolingo
socium	socium		Duolingo
sola	sola		Duolingo
solent	solent		Duolingo
soleo	soleo		Duolingo
solet	solet		Duolingo
sollicita	sollicita		Duolingo
sollicitae	sollicitae		Duolingo
solliciti	solliciti		Duolingo
sollicitus	sollicitus		Duolingo
solus	solus		Duolingo
sordida	sordida		Duolingo
sordidae	sordidae		Duolingo
sordidas	sordidas		Duolingo
sordidi	sordidi		Duolingo
soror	soror		Duolingo
sorores	sorores	noun	Duolingo
stola	stola		Duolingo
stolam	stolam		Duolingo
stolas	stolas		Duolingo
studemus	studemus		Duolingo
student	student	verb	Duolingo
studeo	studeo	verb	Duolingo
studes	studes	verb	Duolingo
studet	studet	verb	Duolingo
studetis	studetis		Duolingo
stultae	stultae		Duolingo
stulti	stulti		Duolingo
stultus	stultus		Duolingo
suaviter	suaviter		Duolingo
sub	sub		Duolingo
sum	sum	verb	Duolingo
sumus	sumus		Duolingo
sunt	sunt	verb	Duolingo
suntne	suntne	verb	Duolingo
tabellarii	tabellarii		Duolingo
tabellarium	tabellarium		Duolingo
tabellarius	tabellarius		Duolingo
taberna	taberna		Duolingo
tabernae	tabernae		Duolingo
tabernam	tabernam		Duolingo
tabernas	tabernas		Duolingo
tablino	tablino		Duolingo
tablinum	tablinum		Duolingo
tacita	tacita		Duolingo
tacitae	tacitae		Duolingo
tacitas	tacitas		Duolingo
tacite	tacite		Duolingo
taciti	taciti		Duolingo
tacitus	tacitus		Duolingo
tam	tam		Duolingo
te	te	pronoun	Duolingo
templa	templa		Duolingo
templo	templo		Duolingo
templum	templum		Duolingo
tempori	tempori		Duolingo
tertia	tertia		Duolingo
tertiam	tertiam		Duolingo
tertius	tertius		Duolingo
theatro	theatro		Duolingo
theatrum	theatrum		Duolingo
tibi	tibi	pronoun	Duolingo
toga	toga		Duolingo
togae	togae		Duolingo
togam	togam		Duolingo
togas	togas		Duolingo
tradere	tradere		Duolingo
tradimus	tradimus		Duolingo
tradit	tradit		Duolingo
trado	trado		Duolingo
tradunt	tradunt		Duolingo
tres	tres	numeral	Duolingo
triclinia	triclinia		Duolingo
triclinio	triclinio		Duolingo
triclinium	triclinium		Duolingo
triginta	triginta	numeral	Duolingo
tu	tu	pronoun	Duolingo
tua	tua	adjective	Duolingo
tuae	tuae	adjective	Duolingo
tuam	tuam		Duolingo
tuas	tuas		Duolingo
tui	tui	adjective	Duolingo
turba	turba		Duolingo
turbae	turbae		Duolingo
tuum	tuum		Duolingo
tuus	tuus	adjective	Duolingo
ubi	ubi	adverb	Duolingo
umbra	umbra		Duolingo
umbrae	umbrae		Duolingo
umbram	umbram		Duolingo
undam	undam		Duolingo
undas	undas		Duolingo
unde	unde		Duolingo
universitas	universitas		Duolingo
universitates	universitates		Duolingo
urbe	urbe	noun	Duolingo
urbem	urbem		Duolingo
urbes	urbes		Duolingo
urbes	urbes	noun	Duolingo
urbs	urbs	noun	Duolingo
uxor	uxor		Duolingo
uxorem	uxorem		Duolingo
uxores	uxores		Duolingo
valde	valde		Duolingo
vatem	vatem		Duolingo
vates	vates		Duolingo
vehementer	vehementer		Duolingo
velim	velim	verb	Duolingo
velimus	velimus		Duolingo
velisne	velisne	verb	Duolingo
velit	velit	verb	Duolingo
velitis	velitis		Duolingo
vendere	vendere		Duolingo
vendit	vendit		Duolingo
vendo	vendo		Duolingo
vendunt	vendunt		Duolingo
venimus	venimus		Duolingo
venio	venio		Duolingo
venis	venis		Duolingo
venit	venit		Duolingo
venitis	venitis		Duolingo
veniunt	veniunt		Duolingo
venti	venti		Duolingo
vento	vento		Duolingo
ventus	ventus		Duolingo
verba	verba		Duolingo
verbum	verbum		Duolingo
vesperi	vesperi		Duolingo
vester	vester		Duolingo
vestimenta	vestimenta		Duolingo
vestimentum	vestimentum		Duolingo
vestri	vestri		Duolingo
vestrum	vestrum		Duolingo
via	via		Duolingo
viae	viae		Duolingo
viam	viam		Duolingo
vias	vias		Duolingo
videmus	videmus		Duolingo
videt	videt		Duolingo
videtis	videtis		Duolingo
viginti	viginti	numeral	Duolingo
villa	villa		Duolingo
villam	villam		Duolingo
vinum	vinum	noun	Duolingo
vir	vir	noun	Duolingo
viri	viri	noun	Duolingo
vis	vis		Duolingo
visitamus	visitamus		Duolingo
visitamus	visitamus	verb	Duolingo
visitant	visitant		Duolingo
visitare	visitare		Duolingo
visitas	visitas		Duolingo
visitas	visitas	verb	Duolingo
visitat	visitat		Duolingo
visitatis	visitatis		Duolingo
visito	visito		Duolingo
vobis	vobis		Duolingo
volo	volo		Duolingo
volumen	volumen		Duolingo
volumina	volumina		Duolingo
volumine	volumine		Duolingo
volumus	volumus		Duolingo
volunt	volunt		Duolingo
vos	vos		Duolingo
vult	vult		Duolingo
vultis	vultis		Duolingo
