learnable	normalized	partOfSpeech	source
a	a	determiner	Duolingo
a	a	preposition	Duolingo
a	a	pronoun	Duolingo
abacaxi	abacaxi	noun	Duolingo
abacaxis	abacaxis	noun	Duolingo
abandonar	abandonar	verb	Duolingo
abelha	abelha	noun	Duolingo
aberta	aberta	adjective	Duolingo
abertas	abertas	adjective	Duolingo
aberto	aberto	adjective	Duolingo
abertura	abertura	noun	Duolingo
abre	abre	verb	Duolingo
abrem	abrem	verb	Duolingo
abri	abri	verb	Duolingo
abril	abril	noun	Duolingo
abrir	abrir	verb	Duolingo
abrirá	abrira	verb	Duolingo
abrirão	abrirao	verb	Duolingo
abriremos	abriremos	verb	Duolingo
abriria	abriria	verb	Duolingo
abririam	abririam	verb	Duolingo
abriu	abriu	verb	Duolingo
abro	abro	verb	Duolingo
absolutamente	absolutamente	adverb	Duolingo
acaba	acaba	verb	Duolingo
acabar	acabar	verb	Duolingo
acabei	acabei	verb	Duolingo
acabou	acabou	verb	Duolingo
academia	academia	noun	Duolingo
acampa	acampa	verb	Duolingo
acampam	acampam	verb	Duolingo
ação	acao	noun	Duolingo
aceita	aceita	verb	Duolingo
aceitam	aceitam	verb	Duolingo
aceitar	aceitar	verb	Duolingo
acende	acende	verb	Duolingo
acesso	acesso	noun	Duolingo
acha	acha	verb	Duolingo
acham	acham	verb	Duolingo
achamos	achamos	verb	Duolingo
achando	achando	verb	Duolingo
achará	achara	verb	Duolingo
acharei	acharei	verb	Duolingo
acharemos	acharemos	verb	Duolingo
acharia	acharia	verb	Duolingo
achasse	achasse	verb	Duolingo
achassem	achassem	verb	Duolingo
achava	achava	verb	Duolingo
ache	ache	verb	Duolingo
achem	achem	verb	Duolingo
acho	acho	verb	Duolingo
acidente	acidente	noun	Duolingo
acima	acima	adverb	Duolingo
ações	acoes	noun	Duolingo
aconteça	aconteca	verb	Duolingo
acontece	acontece	verb	Duolingo
acontecem	acontecem	verb	Duolingo
acontecendo	acontecendo	verb	Duolingo
acontecerá	acontecera	verb	Duolingo
acontecerão	acontecerao	verb	Duolingo
aconteceria	aconteceria	verb	Duolingo
acontecesse	acontecesse	verb	Duolingo
acorda	acorda	verb	Duolingo
acordei	acordei	verb	Duolingo
acordou	acordou	verb	Duolingo
acreditar	acreditar	verb	Duolingo
acrescentar	acrescentar	verb	Duolingo
açúcar	acucar	noun	Duolingo
administração	administracao	noun	Duolingo
adorando	adorando	verb	Duolingo
adorará	adorara	verb	Duolingo
adorarei	adorarei	verb	Duolingo
adoraria	adoraria	verb	Duolingo
adorava	adorava	verb	Duolingo
adultos	adultos	noun	Duolingo
advogada	advogada	noun	Duolingo
advogado	advogado	noun	Duolingo
aeroporto	aeroporto	noun	Duolingo
áfrica	africa	proper noun	Duolingo
agasalho	agasalho	noun	Duolingo
agasalhos	agasalhos	noun	Duolingo
agência	agencia	noun	Duolingo
agente	agente	noun	Duolingo
agora	agora	adverb	Duolingo
agosto	agosto	noun	Duolingo
agradece	agradece	verb	Duolingo
agradecem	agradecem	verb	Duolingo
agradecemos	agradecemos	verb	Duolingo
agradeço	agradeco	verb	Duolingo
agricultura	agricultura	noun	Duolingo
água	agua	noun	Duolingo
aguenta	aguenta	verb	Duolingo
aguentam	aguentam	verb	Duolingo
aguento	aguento	verb	Duolingo
aí	ai	adverb	Duolingo
ai	ai	interjection	Duolingo
ainda	ainda	adverb	Duolingo
ajuda	ajuda	noun	Duolingo
ajuda	ajuda	verb	Duolingo
ajudando	ajudando	verb	Duolingo
ajudar	ajudar	verb	Duolingo
ajudará	ajudara	verb	Duolingo
ajudaria	ajudaria	verb	Duolingo
ajudasse	ajudasse	verb	Duolingo
ajudava	ajudava	verb	Duolingo
ajude	ajude	verb	Duolingo
ajudem	ajudem	verb	Duolingo
álbum	album	noun	Duolingo
álcool	alcool	noun	Duolingo
alegria	alegria	noun	Duolingo
além	alem	adverb	Duolingo
alemã	alema	adjective	Duolingo
alemães	alemaes	adjective	Duolingo
alemanha	alemanha	proper noun	Duolingo
alemão	alemao	adjective	Duolingo
alemão	alemao	noun	Duolingo
algo	algo	pronoun	Duolingo
alguém	alguem	pronoun	Duolingo
algum	algum	determiner	Duolingo
algum	algum	pronoun	Duolingo
alguma	alguma	determiner	Duolingo
alguma	alguma	pronoun	Duolingo
algumas	algumas	determiner	Duolingo
algumas	algumas	pronoun	Duolingo
alguns	alguns	determiner	Duolingo
alguns	alguns	pronoun	Duolingo
ali	ali	adverb	Duolingo
aliança	alianca	noun	Duolingo
alimento	alimento	noun	Duolingo
alma	alma	noun	Duolingo
almas	almas	noun	Duolingo
almoço	almoco	noun	Duolingo
altas	altas	adjective	Duolingo
alto	alto	adjective	Duolingo
altos	altos	adjective	Duolingo
altura	altura	noun	Duolingo
alugar	alugar	verb	Duolingo
aluna	aluna	noun	Duolingo
aluno	aluno	noun	Duolingo
alunos	alunos	noun	Duolingo
ama	ama	verb	Duolingo
amam	amam	verb	Duolingo
amando	amando	verb	Duolingo
amanhã	amanha	adverb	Duolingo
amará	amara	verb	Duolingo
amarei	amarei	verb	Duolingo
amarela	amarela	adjective	Duolingo
amarelas	amarelas	adjective	Duolingo
amarelo	amarelo	adjective	Duolingo
amarelos	amarelos	adjective	Duolingo
amarga	amarga	adjective	Duolingo
amargas	amargas	adjective	Duolingo
amargo	amargo	adjective	Duolingo
amaria	amaria	verb	Duolingo
amasse	amasse	verb	Duolingo
amava	amava	verb	Duolingo
ambiente	ambiente	noun	Duolingo
ambos	ambos	pronoun	Duolingo
ambulância	ambulancia	noun	Duolingo
ame	ame	verb	Duolingo
américa	america	proper noun	Duolingo
americano	americano	adjective	Duolingo
amiga	amiga	noun	Duolingo
amigo	amigo	noun	Duolingo
amigos	amigos	noun	Duolingo
amizade	amizade	noun	Duolingo
amor	amor	noun	Duolingo
ampla	ampla	adjective	Duolingo
ampliação	ampliacao	noun	Duolingo
amplo	amplo	adjective	Duolingo
analisar	analisar	verb	Duolingo
análise	analise	noun	Duolingo
anda	anda	verb	Duolingo
andar	andar	noun	Duolingo
andar	andar	verb	Duolingo
andará	andara	verb	Duolingo
andarás	andaras	verb	Duolingo
andaremos	andaremos	verb	Duolingo
andaria	andaria	verb	Duolingo
animais	animais	noun	Duolingo
animal	animal	noun	Duolingo
aniversário	aniversario	noun	Duolingo
anjo	anjo	noun	Duolingo
anjos	anjos	noun	Duolingo
ano	ano	noun	Duolingo
anos	anos	noun	Duolingo
anotar	anotar	verb	Duolingo
ansiosa	ansiosa	adjective	Duolingo
ansioso	ansioso	adjective	Duolingo
antes	antes	adverb	Duolingo
antidemocrática	antidemocratica	adjective	Duolingo
antiga	antiga	adjective	Duolingo
antigo	antigo	adjective	Duolingo
antigos	antigos	adjective	Duolingo
anuncia	anuncia	verb	Duolingo
anunciam	anunciam	verb	Duolingo
anunciar	anunciar	verb	Duolingo
anúncio	anuncio	noun	Duolingo
anuncio	anuncio	verb	Duolingo
ao	ao	preposition	Duolingo
aonde	aonde	adverb	Duolingo
aos	aos	preposition	Duolingo
aparece	aparece	verb	Duolingo
aparecem	aparecem	verb	Duolingo
aparecer	aparecer	verb	Duolingo
apareceu	apareceu	verb	Duolingo
aparelho	aparelho	noun	Duolingo
apartamento	apartamento	noun	Duolingo
apelo	apelo	noun	Duolingo
apertada	apertada	verb	Duolingo
apertado	apertado	verb	Duolingo
apertados	apertados	verb	Duolingo
apesar	apesar	conjunction	Duolingo
aplicação	aplicacao	noun	Duolingo
aplicar	aplicar	verb	Duolingo
aponta	aponta	verb	Duolingo
aprende	aprende	verb	Duolingo
aprendem	aprendem	verb	Duolingo
aprendemos	aprendemos	verb	Duolingo
aprender	aprender	verb	Duolingo
apresenta	apresenta	verb	Duolingo
apresentação	apresentacao	noun	Duolingo
apresentam	apresentam	verb	Duolingo
apresentamos	apresentamos	verb	Duolingo
apresentaram	apresentaram	verb	Duolingo
apresento	apresento	verb	Duolingo
apresentou	apresentou	verb	Duolingo
aprovação	aprovacao	noun	Duolingo
aquecimento	aquecimento	noun	Duolingo
aquela	aquela	determiner	Duolingo
àquela	aquela	preposition	Duolingo
aquela	aquela	pronoun	Duolingo
aquelas	aquelas	determiner	Duolingo
aquelas	aquelas	pronoun	Duolingo
aquele	aquele	determiner	Duolingo
àquele	aquele	preposition	Duolingo
aquele	aquele	pronoun	Duolingo
aqueles	aqueles	determiner	Duolingo
aqueles	aqueles	pronoun	Duolingo
aqui	aqui	adverb	Duolingo
aquilo	aquilo	pronoun	Duolingo
ar	ar	noun	Duolingo
aranha	aranha	noun	Duolingo
área	area	noun	Duolingo
áreas	areas	noun	Duolingo
areia	areia	noun	Duolingo
argentina	argentina	adjective	Duolingo
argentino	argentino	adjective	Duolingo
argumento	argumento	noun	Duolingo
argumentos	argumentos	noun	Duolingo
arma	arma	noun	Duolingo
armas	armas	noun	Duolingo
arquiteto	arquiteto	noun	Duolingo
arroz	arroz	noun	Duolingo
arruma	arruma	verb	Duolingo
arrumam	arrumam	verb	Duolingo
arte	arte	noun	Duolingo
artes	artes	noun	Duolingo
artigo	artigo	noun	Duolingo
artista	artista	noun	Duolingo
artistas	artistas	noun	Duolingo
árvore	arvore	noun	Duolingo
árvores	arvores	noun	Duolingo
as	as	determiner	Duolingo
às	as	preposition	Duolingo
as	as	pronoun	Duolingo
ásia	asia	proper noun	Duolingo
aspecto	aspecto	noun	Duolingo
aspectos	aspectos	noun	Duolingo
assa	assa	verb	Duolingo
assamos	assamos	verb	Duolingo
assembleia	assembleia	noun	Duolingo
assento	assento	noun	Duolingo
assim	assim	adverb	Duolingo
assina	assina	verb	Duolingo
assinam	assinam	verb	Duolingo
assino	assino	verb	Duolingo
asso	asso	verb	Duolingo
associação	associacao	noun	Duolingo
assumir	assumir	verb	Duolingo
assunto	assunto	noun	Duolingo
assuntos	assuntos	noun	Duolingo
assustada	assustada	verb	Duolingo
assustado	assustado	verb	Duolingo
ataque	ataque	noun	Duolingo
ataques	ataques	noun	Duolingo
até	ate	preposition	Duolingo
atender	atender	verb	Duolingo
atinge	atinge	verb	Duolingo
atingimos	atingimos	verb	Duolingo
atingir	atingir	verb	Duolingo
atitude	atitude	noun	Duolingo
atividade	atividade	noun	Duolingo
atividades	atividades	noun	Duolingo
atleta	atleta	noun	Duolingo
atletas	atletas	noun	Duolingo
ato	ato	noun	Duolingo
ator	ator	noun	Duolingo
atores	atores	noun	Duolingo
atos	atos	noun	Duolingo
atrás	atras	adverb	Duolingo
atrasa	atrasa	verb	Duolingo
atrasam	atrasam	verb	Duolingo
atrasamos	atrasamos	verb	Duolingo
atraso	atraso	noun	Duolingo
através	atraves	adverb	Duolingo
atriz	atriz	noun	Duolingo
atua	atua	verb	Duolingo
atuação	atuacao	noun	Duolingo
atualmente	atualmente	adverb	Duolingo
atuar	atuar	verb	Duolingo
atuo	atuo	verb	Duolingo
audiência	audiencia	noun	Duolingo
aumenta	aumenta	verb	Duolingo
aumentar	aumentar	verb	Duolingo
aumento	aumento	verb	Duolingo
ausência	ausencia	noun	Duolingo
ausências	ausencias	noun	Duolingo
automóvel	automovel	noun	Duolingo
autor	autor	noun	Duolingo
autora	autora	noun	Duolingo
autoras	autoras	noun	Duolingo
autores	autores	noun	Duolingo
autoridade	autoridade	noun	Duolingo
autoridades	autoridades	noun	Duolingo
avaliação	avaliacao	noun	Duolingo
avenida	avenida	noun	Duolingo
aventura	aventura	noun	Duolingo
aventuras	aventuras	noun	Duolingo
avião	aviao	noun	Duolingo
avó	avo	noun	Duolingo
avôs	avos	noun	Duolingo
azeda	azeda	adjective	Duolingo
azedas	azedas	adjective	Duolingo
azedo	azedo	adjective	Duolingo
azeite	azeite	noun	Duolingo
azuis	azuis	adjective	Duolingo
azul	azul	adjective	Duolingo
bairro	bairro	noun	Duolingo
baixa	baixa	adjective	Duolingo
baixo	baixo	adjective	Duolingo
baixos	baixos	adjective	Duolingo
banana	banana	noun	Duolingo
bananas	bananas	noun	Duolingo
banco	banco	noun	Duolingo
bancos	bancos	noun	Duolingo
banda	banda	noun	Duolingo
bandeira	bandeira	noun	Duolingo
banheiro	banheiro	noun	Duolingo
banho	banho	noun	Duolingo
bar	bar	noun	Duolingo
barata	barata	adjective	Duolingo
baratas	baratas	adjective	Duolingo
barbeador	barbeador	noun	Duolingo
barco	barco	noun	Duolingo
barcos	barcos	noun	Duolingo
barriga	barriga	noun	Duolingo
barulhenta	barulhenta	adjective	Duolingo
barulhento	barulhento	adjective	Duolingo
barulho	barulho	noun	Duolingo
base	base	noun	Duolingo
básica	basica	adjective	Duolingo
básico	basico	adjective	Duolingo
básicos	basicos	adjective	Duolingo
basquete	basquete	noun	Duolingo
bastante	bastante	adverb	Duolingo
batalha	batalha	noun	Duolingo
batata	batata	noun	Duolingo
batatas	batatas	noun	Duolingo
bateria	bateria	noun	Duolingo
baterias	baterias	noun	Duolingo
bebê	bebe	noun	Duolingo
bebe	bebe	verb	Duolingo
bebem	bebem	verb	Duolingo
bebemos	bebemos	verb	Duolingo
bebendo	bebendo	verb	Duolingo
beber	beber	verb	Duolingo
beberá	bebera	verb	Duolingo
beberam	beberam	verb	Duolingo
beberão	beberao	verb	Duolingo
beberei	beberei	verb	Duolingo
beberia	beberia	verb	Duolingo
beberiam	beberiam	verb	Duolingo
bebês	bebes	noun	Duolingo
bebes	bebes	verb	Duolingo
bebeu	bebeu	verb	Duolingo
bebi	bebi	verb	Duolingo
bebia	bebia	verb	Duolingo
bebida	bebida	noun	Duolingo
bebo	bebo	verb	Duolingo
bege	bege	adjective	Duolingo
beija	beija	verb	Duolingo
beijo	beijo	noun	Duolingo
beleza	beleza	noun	Duolingo
bem	bem		Duolingo
bem	bem	adverb	Duolingo
benefício	beneficio	noun	Duolingo
benefícios	beneficios	noun	Duolingo
berço	berco	noun	Duolingo
biblioteca	biblioteca	noun	Duolingo
bicampeão	bicampeao	noun	Duolingo
bicicleta	bicicleta	noun	Duolingo
bicicletas	bicicletas	noun	Duolingo
bife	bife	noun	Duolingo
bilhete	bilhete	noun	Duolingo
biologia	biologia	noun	Duolingo
biscoito	biscoito	noun	Duolingo
bispo	bispo	noun	Duolingo
blusa	blusa	noun	Duolingo
blusas	blusas	noun	Duolingo
boa	boa	adjective	Duolingo
boa noite	boa noite		Duolingo
boa tarde	boa tarde		Duolingo
boas	boas	adjective	Duolingo
boca	boca	noun	Duolingo
boi	boi	noun	Duolingo
bola	bola	noun	Duolingo
bolo	bolo	noun	Duolingo
bolsa	bolsa	noun	Duolingo
bolso	bolso	noun	Duolingo
bolsos	bolsos	noun	Duolingo
bom	bom	adjective	Duolingo
bom dia	bom dia		Duolingo
bonita	bonita	adjective	Duolingo
bonito	bonito	adjective	Duolingo
bons	bons	adjective	Duolingo
borboleta	borboleta	noun	Duolingo
bota	bota	noun	Duolingo
bota	bota	verb	Duolingo
botam	botam	verb	Duolingo
botas	botas	noun	Duolingo
braço	braco	noun	Duolingo
braços	bracos	noun	Duolingo
branca	branca	adjective	Duolingo
brancas	brancas	adjective	Duolingo
branco	branco	adjective	Duolingo
brancos	brancos	adjective	Duolingo
brasil	brasil	proper noun	Duolingo
brasileira	brasileira	adjective	Duolingo
brasileiras	brasileiras	adjective	Duolingo
brasileiro	brasileiro	adjective	Duolingo
brinquedo	brinquedo	noun	Duolingo
brinquedos	brinquedos	noun	Duolingo
britânica	britanica	adjective	Duolingo
britânico	britanico	adjective	Duolingo
bronze	bronze	noun	Duolingo
busca	busca	noun	Duolingo
cabe	cabe	verb	Duolingo
cabeça	cabeca	noun	Duolingo
cabeças	cabecas	noun	Duolingo
cabelo	cabelo	noun	Duolingo
cabem	cabem	verb	Duolingo
cabo	cabo	noun	Duolingo
cachoeira	cachoeira	noun	Duolingo
cachorro	cachorro	noun	Duolingo
cada	cada	determiner	Duolingo
cadáver	cadaver	noun	Duolingo
cadeira	cadeira	noun	Duolingo
cadeiras	cadeiras	noun	Duolingo
café	cafe	noun	Duolingo
cai	cai	verb	Duolingo
cair	cair	verb	Duolingo
caiu	caiu	verb	Duolingo
caixa	caixa	noun	Duolingo
caixas	caixas	noun	Duolingo
calça	calca	noun	Duolingo
calça	calca	verb	Duolingo
calçamos	calcamos	verb	Duolingo
calças	calcas	noun	Duolingo
calço	calco	verb	Duolingo
calendário	calendario	noun	Duolingo
calma	calma	adjective	Duolingo
calmo	calmo	adjective	Duolingo
calor	calor	noun	Duolingo
cama	cama	noun	Duolingo
câmera	camera	noun	Duolingo
câmeras	cameras	noun	Duolingo
caminha	caminha	verb	Duolingo
caminham	caminham	verb	Duolingo
caminhamos	caminhamos	verb	Duolingo
caminhando	caminhando	verb	Duolingo
caminhar	caminhar	verb	Duolingo
caminharei	caminharei	verb	Duolingo
caminharemos	caminharemos	verb	Duolingo
caminharia	caminharia	verb	Duolingo
caminhava	caminhava	verb	Duolingo
caminho	caminho	noun	Duolingo
caminho	caminho	verb	Duolingo
camisa	camisa	noun	Duolingo
camisas	camisas	noun	Duolingo
campanha	campanha	noun	Duolingo
campanhas	campanhas	noun	Duolingo
campeã	campea	noun	Duolingo
campeão	campeao	noun	Duolingo
campeões	campeoes	noun	Duolingo
campeonato	campeonato	noun	Duolingo
campo	campo	noun	Duolingo
canal	canal	noun	Duolingo
candidata	candidata	noun	Duolingo
candidato	candidato	noun	Duolingo
candidatos	candidatos	noun	Duolingo
caneta	caneta	noun	Duolingo
canetas	canetas	noun	Duolingo
canta	canta	verb	Duolingo
cantam	cantam	verb	Duolingo
canto	canto	verb	Duolingo
cantor	cantor	noun	Duolingo
cantora	cantora	noun	Duolingo
capa	capa	noun	Duolingo
capacidade	capacidade	noun	Duolingo
capacidades	capacidades	noun	Duolingo
capas	capas	noun	Duolingo
capitã	capita	noun	Duolingo
capital	capital	noun	Duolingo
capitão	capitao	noun	Duolingo
capítulo	capitulo	noun	Duolingo
capítulos	capitulos	noun	Duolingo
cara	cara	noun	Duolingo
caráter	carater	noun	Duolingo
cargo	cargo	noun	Duolingo
carne	carne	noun	Duolingo
caro	caro	adjective	Duolingo
caros	caros	adjective	Duolingo
carrega	carrega	verb	Duolingo
carregam	carregam	verb	Duolingo
carreira	carreira	noun	Duolingo
carro	carro	noun	Duolingo
carros	carros	noun	Duolingo
carta	carta	noun	Duolingo
cartão	cartao	noun	Duolingo
cartas	cartas	noun	Duolingo
carteira	carteira	noun	Duolingo
carteiras	carteiras	noun	Duolingo
carteiro	carteiro	noun	Duolingo
cartões	cartoes	noun	Duolingo
casa	casa	noun	Duolingo
casaco	casaco	noun	Duolingo
casacos	casacos	noun	Duolingo
casal	casal	noun	Duolingo
casamento	casamento	noun	Duolingo
casas	casas	noun	Duolingo
caso	caso	conjunction	Duolingo
caso	caso	noun	Duolingo
castanho	castanho	adjective	Duolingo
castelo	castelo	noun	Duolingo
castelos	castelos	noun	Duolingo
catedral	catedral	noun	Duolingo
categoria	categoria	noun	Duolingo
categorias	categorias	noun	Duolingo
católica	catolica	adjective	Duolingo
católico	catolico	adjective	Duolingo
causa	causa	noun	Duolingo
cavalo	cavalo	noun	Duolingo
cavalos	cavalos	noun	Duolingo
cebola	cebola	noun	Duolingo
cedo	cedo	adverb	Duolingo
célula	celula	noun	Duolingo
celular	celular	noun	Duolingo
celulares	celulares	noun	Duolingo
células	celulas	noun	Duolingo
cem	cem	numeral	Duolingo
cena	cena	noun	Duolingo
cenas	cenas	noun	Duolingo
cenoura	cenoura	noun	Duolingo
centímetro	centimetro	noun	Duolingo
centímetros	centimetros	noun	Duolingo
centro	centro	noun	Duolingo
cérebro	cerebro	noun	Duolingo
certeza	certeza	noun	Duolingo
certo	certo	adjective	Duolingo
cerveja	cerveja	noun	Duolingo
céu	ceu	noun	Duolingo
chá	cha	noun	Duolingo
chama	chama	verb	Duolingo
chamam	chamam	verb	Duolingo
chamar	chamar	verb	Duolingo
chamaram	chamaram	verb	Duolingo
chame	chame	verb	Duolingo
chamei	chamei	verb	Duolingo
chamem	chamem	verb	Duolingo
chamemos	chamemos	verb	Duolingo
chamou	chamou	verb	Duolingo
chance	chance	noun	Duolingo
chão	chao	noun	Duolingo
chapéu	chapeu	noun	Duolingo
chapéus	chapeus	noun	Duolingo
chata	chata	adjective	Duolingo
chato	chato	adjective	Duolingo
chave	chave	noun	Duolingo
chaves	chaves	noun	Duolingo
chefe	chefe	noun	Duolingo
chefes	chefes	noun	Duolingo
chega	chega	verb	Duolingo
chegada	chegada	noun	Duolingo
chegada	chegada	verb	Duolingo
chegados	chegados	verb	Duolingo
chegamos	chegamos	verb	Duolingo
chegando	chegando	verb	Duolingo
chegar	chegar	verb	Duolingo
chegaram	chegaram	verb	Duolingo
chegarei	chegarei	verb	Duolingo
chegaremos	chegaremos	verb	Duolingo
chegaria	chegaria	verb	Duolingo
chegasse	chegasse	verb	Duolingo
chegassem	chegassem	verb	Duolingo
chegava	chegava	verb	Duolingo
chegavam	chegavam	verb	Duolingo
chegou	chegou	verb	Duolingo
chegue	chegue	verb	Duolingo
cheguei	cheguei	verb	Duolingo
cheguemos	cheguemos	verb	Duolingo
cheia	cheia	adjective	Duolingo
cheiro	cheiro	noun	Duolingo
china	china	proper noun	Duolingo
chinês	chines	adjective	Duolingo
chinês	chines	noun	Duolingo
chinesa	chinesa	adjective	Duolingo
chineses	chineses	adjective	Duolingo
chineses	chineses	noun	Duolingo
chocolate	chocolate	noun	Duolingo
chora	chora	verb	Duolingo
choramos	choramos	verb	Duolingo
chove	chove	verb	Duolingo
chovendo	chovendo	verb	Duolingo
chover	chover	verb	Duolingo
choveu	choveu	verb	Duolingo
chuva	chuva	noun	Duolingo
chuveiro	chuveiro	noun	Duolingo
chuveiros	chuveiros	noun	Duolingo
ciclo	ciclo	noun	Duolingo
cidadã	cidada	noun	Duolingo
cidadão	cidadao	noun	Duolingo
cidadãos	cidadaos	noun	Duolingo
cidade	cidade	noun	Duolingo
cidades	cidades	noun	Duolingo
ciência	ciencia	noun	Duolingo
ciências	ciencias	noun	Duolingo
cientista	cientista	noun	Duolingo
cientistas	cientistas	noun	Duolingo
cima	cima	adverb	Duolingo
cinco	cinco	numeral	Duolingo
cinema	cinema	noun	Duolingo
cinquenta	cinquenta	numeral	Duolingo
cinto	cinto	noun	Duolingo
cinza	cinza		Duolingo
cinza	cinza	adjective	Duolingo
circulação	circulacao	noun	Duolingo
círculo	circulo	noun	Duolingo
circunstância	circunstancia	noun	Duolingo
circunstâncias	circunstancias	noun	Duolingo
civil	civil	adjective	Duolingo
classe	classe	noun	Duolingo
clássico	classico	adjective	Duolingo
classificação	classificacao	noun	Duolingo
cliente	cliente	noun	Duolingo
clima	clima	noun	Duolingo
clínica	clinica	noun	Duolingo
clínicas	clinicas	noun	Duolingo
clube	clube	noun	Duolingo
cobertor	cobertor	noun	Duolingo
cobra	cobra	noun	Duolingo
cobrir	cobrir	verb	Duolingo
código	codigo	noun	Duolingo
coisa	coisa	noun	Duolingo
coisas	coisas	noun	Duolingo
coleção	colecao	noun	Duolingo
colega	colega	noun	Duolingo
colegas	colegas	noun	Duolingo
colégio	colegio	noun	Duolingo
colher	colher	noun	Duolingo
colheres	colheres	noun	Duolingo
coloca	coloca	verb	Duolingo
colocar	colocar	verb	Duolingo
colocará	colocara	verb	Duolingo
colocarei	colocarei	verb	Duolingo
colocaria	colocaria	verb	Duolingo
colocava	colocava	verb	Duolingo
colocavam	colocavam	verb	Duolingo
colorido	colorido	adjective	Duolingo
colorimos	colorimos	verb	Duolingo
coluna	coluna	noun	Duolingo
com	com	preposition	Duolingo
com licença	com licenca		Duolingo
comandante	comandante	noun	Duolingo
come	come	verb	Duolingo
começa	comeca	verb	Duolingo
começar	comecar	verb	Duolingo
começaram	comecaram	verb	Duolingo
começarmos	comecarmos	verb	Duolingo
começo	comeco	noun	Duolingo
começo	comeco	verb	Duolingo
começou	comecou	verb	Duolingo
comem	comem	verb	Duolingo
comemoração	comemoracao	noun	Duolingo
comemos	comemos	verb	Duolingo
comendo	comendo	verb	Duolingo
comentário	comentario	noun	Duolingo
comentários	comentarios	noun	Duolingo
comentou	comentou	verb	Duolingo
comer	comer	verb	Duolingo
comeram	comeram	verb	Duolingo
comerão	comerao	verb	Duolingo
comercial	comercial	adjective	Duolingo
comércio	comercio	noun	Duolingo
comerei	comerei	verb	Duolingo
comeremos	comeremos	verb	Duolingo
comeria	comeria	verb	Duolingo
comeriam	comeriam	verb	Duolingo
comes	comes	verb	Duolingo
comeu	comeu	verb	Duolingo
comi	comi	verb	Duolingo
comia	comia	verb	Duolingo
comiam	comiam	verb	Duolingo
comíamos	comiamos	verb	Duolingo
comida	comida	noun	Duolingo
comidas	comidas	noun	Duolingo
comigo	comigo	pronoun	Duolingo
comissão	comissao	noun	Duolingo
como	como		Duolingo
como	como	adverb	Duolingo
como	como	conjunction	Duolingo
como	como	verb	Duolingo
competição	competicao	noun	Duolingo
competições	competicoes	noun	Duolingo
completamente	completamente	adverb	Duolingo
componente	componente	noun	Duolingo
componentes	componentes	noun	Duolingo
comportamento	comportamento	noun	Duolingo
comportamentos	comportamentos	noun	Duolingo
composição	composicao	noun	Duolingo
compra	compra	verb	Duolingo
compram	compram	verb	Duolingo
comprar	comprar	verb	Duolingo
comprida	comprida	adjective	Duolingo
compridas	compridas	adjective	Duolingo
comprido	comprido	adjective	Duolingo
compro	compro	verb	Duolingo
compromisso	compromisso	noun	Duolingo
compromissos	compromissos	noun	Duolingo
comprovar	comprovar	verb	Duolingo
computador	computador	noun	Duolingo
comunicação	comunicacao	noun	Duolingo
comunicações	comunicacoes	noun	Duolingo
comunicado	comunicado	noun	Duolingo
comunidade	comunidade	noun	Duolingo
comunista	comunista	adjective	Duolingo
comunistas	comunistas	adjective	Duolingo
conceito	conceito	noun	Duolingo
conceitos	conceitos	noun	Duolingo
concentração	concentracao	noun	Duolingo
concerto	concerto	noun	Duolingo
conclusão	conclusao	noun	Duolingo
concordamos	concordamos	verb	Duolingo
concordo	concordo	verb	Duolingo
concorrência	concorrencia	noun	Duolingo
concurso	concurso	noun	Duolingo
conde	conde	noun	Duolingo
condessa	condessa	noun	Duolingo
condição	condicao	noun	Duolingo
condições	condicoes	noun	Duolingo
confere	confere	verb	Duolingo
conferem	conferem	verb	Duolingo
conferência	conferencia	noun	Duolingo
confortáveis	confortaveis	adjective	Duolingo
confortável	confortavel	adjective	Duolingo
confundida	confundida	verb	Duolingo
confundido	confundido	verb	Duolingo
confusão	confusao	noun	Duolingo
congresso	congresso	noun	Duolingo
conheça	conheca	verb	Duolingo
conheçam	conhecam	verb	Duolingo
conhece	conhece	verb	Duolingo
conhecem	conhecem	verb	Duolingo
conhecer	conhecer	verb	Duolingo
conhecerei	conhecerei	verb	Duolingo
conheceremos	conheceremos	verb	Duolingo
conheceria	conheceria	verb	Duolingo
conhecesse	conhecesse	verb	Duolingo
conhecessem	conhecessem	verb	Duolingo
conhecia	conhecia	verb	Duolingo
conhecida	conhecida	verb	Duolingo
conhecido	conhecido	verb	Duolingo
conhecidos	conhecidos	verb	Duolingo
conhecimento	conhecimento	noun	Duolingo
conhecimentos	conhecimentos	noun	Duolingo
conheço	conheco	verb	Duolingo
conjunto	conjunto	noun	Duolingo
conjuntos	conjuntos	noun	Duolingo
conosco	conosco	pronoun	Duolingo
consciência	consciencia	noun	Duolingo
consegue	consegue	verb	Duolingo
conseguem	conseguem	verb	Duolingo
consegui	consegui	verb	Duolingo
conseguimos	conseguimos	verb	Duolingo
conseguir	conseguir	verb	Duolingo
conseguiu	conseguiu	verb	Duolingo
conselheira	conselheira	noun	Duolingo
conselheiro	conselheiro	noun	Duolingo
conselho	conselho	noun	Duolingo
consequência	consequencia	noun	Duolingo
consequências	consequencias	noun	Duolingo
conserta	conserta	verb	Duolingo
consertam	consertam	verb	Duolingo
conservação	conservacao	noun	Duolingo
consideração	consideracao	noun	Duolingo
considerações	consideracoes	noun	Duolingo
considerar	considerar	verb	Duolingo
consigo	consigo	verb	Duolingo
constituição	constituicao	noun	Duolingo
constrói	constroi	verb	Duolingo
construção	construcao	noun	Duolingo
construímos	construimos	verb	Duolingo
construir	construir	verb	Duolingo
consulta	consulta	noun	Duolingo
consultas	consultas	noun	Duolingo
conta	conta	noun	Duolingo
conta	conta	verb	Duolingo
contam	contam	verb	Duolingo
contamos	contamos	verb	Duolingo
contar	contar	verb	Duolingo
contará	contara	verb	Duolingo
contaram	contaram	verb	Duolingo
contas	contas	noun	Duolingo
contato	contato	noun	Duolingo
conteúdo	conteudo	noun	Duolingo
contexto	contexto	noun	Duolingo
contigo	contigo	pronoun	Duolingo
continente	continente	noun	Duolingo
continua	continua	verb	Duolingo
continuação	continuacao	noun	Duolingo
continuações	continuacoes	noun	Duolingo
continuamos	continuamos	verb	Duolingo
continuar	continuar	verb	Duolingo
continuidade	continuidade	noun	Duolingo
continuo	continuo	verb	Duolingo
contou	contou	verb	Duolingo
contra	contra	preposition	Duolingo
contrato	contrato	noun	Duolingo
contratos	contratos	noun	Duolingo
controlar	controlar	verb	Duolingo
controle	controle	noun	Duolingo
convênio	convenio	noun	Duolingo
convênios	convenios	noun	Duolingo
conversa	conversa	noun	Duolingo
conversa	conversa	verb	Duolingo
conversação	conversacao	noun	Duolingo
conversam	conversam	verb	Duolingo
conversamos	conversamos	verb	Duolingo
conversando	conversando	verb	Duolingo
conversarei	conversarei	verb	Duolingo
conversaremos	conversaremos	verb	Duolingo
conversaria	conversaria	verb	Duolingo
conversariam	conversariam	verb	Duolingo
conversava	conversava	verb	Duolingo
conversavam	conversavam	verb	Duolingo
converse	converse	verb	Duolingo
conversem	conversem	verb	Duolingo
converso	converso	verb	Duolingo
convida	convida	verb	Duolingo
convidamos	convidamos	verb	Duolingo
convite	convite	noun	Duolingo
convocação	convocacao	noun	Duolingo
cooperação	cooperacao	noun	Duolingo
copo	copo	noun	Duolingo
copos	copos	noun	Duolingo
cor	cor	noun	Duolingo
coração	coracao	noun	Duolingo
cores	cores	noun	Duolingo
coronel	coronel	noun	Duolingo
corpo	corpo	noun	Duolingo
corpos	corpos	noun	Duolingo
corra	corra	verb	Duolingo
corram	corram	verb	Duolingo
corramos	corramos	verb	Duolingo
corre	corre	verb	Duolingo
correio	correio	noun	Duolingo
correm	correm	verb	Duolingo
correndo	correndo	verb	Duolingo
corrente	corrente	noun	Duolingo
correntes	correntes	noun	Duolingo
correr	correr	verb	Duolingo
corres	corres	verb	Duolingo
corro	corro	verb	Duolingo
corrupção	corrupcao	noun	Duolingo
corta	corta	verb	Duolingo
corte	corte	noun	Duolingo
corte	corte	verb	Duolingo
cortina	cortina	noun	Duolingo
cortinas	cortinas	noun	Duolingo
corto	corto	verb	Duolingo
costas	costas	noun	Duolingo
costuma	costuma	verb	Duolingo
costumam	costumam	verb	Duolingo
costumamos	costumamos	verb	Duolingo
costume	costume	noun	Duolingo
costumes	costumes	noun	Duolingo
costumo	costumo	verb	Duolingo
cotovelo	cotovelo	noun	Duolingo
cotovelos	cotovelos	noun	Duolingo
cozinha	cozinha	noun	Duolingo
cozinha	cozinha	verb	Duolingo
cozinham	cozinham	verb	Duolingo
cozinhando	cozinhando	verb	Duolingo
cozinharam	cozinharam	verb	Duolingo
cozinhaste	cozinhaste	verb	Duolingo
cozinhei	cozinhei	verb	Duolingo
cozinheiro	cozinheiro	noun	Duolingo
cozinho	cozinho	verb	Duolingo
cozinhou	cozinhou	verb	Duolingo
crê	cre	verb	Duolingo
crédito	credito	noun	Duolingo
créditos	creditos	noun	Duolingo
cremos	cremos	verb	Duolingo
crença	crenca	noun	Duolingo
crenças	crencas	noun	Duolingo
crês	cres	verb	Duolingo
cresce	cresce	verb	Duolingo
crescem	crescem	verb	Duolingo
crescimento	crescimento	noun	Duolingo
criação	criacao	noun	Duolingo
criança	crianca	noun	Duolingo
crianças	criancas	noun	Duolingo
criancice	criancice	noun	Duolingo
criar	criar	verb	Duolingo
crise	crise	noun	Duolingo
critério	criterio	noun	Duolingo
critérios	criterios	noun	Duolingo
crítica	critica	noun	Duolingo
críticas	criticas	noun	Duolingo
crítico	critico	noun	Duolingo
cruzam	cruzam	verb	Duolingo
cruzamos	cruzamos	verb	Duolingo
cruzo	cruzo	verb	Duolingo
cubana	cubana	adjective	Duolingo
cubano	cubano	adjective	Duolingo
cuida	cuida	verb	Duolingo
cuidado	cuidado	noun	Duolingo
cuidados	cuidados	noun	Duolingo
cuidando	cuidando	verb	Duolingo
cuidaram	cuidaram	verb	Duolingo
cuidava	cuidava	verb	Duolingo
cuidei	cuidei	verb	Duolingo
cuido	cuido	verb	Duolingo
cuidou	cuidou	verb	Duolingo
cujo	cujo		Duolingo
culpa	culpa	noun	Duolingo
cultura	cultura	noun	Duolingo
culturais	culturais	adjective	Duolingo
cultural	cultural	adjective	Duolingo
culturas	culturas	noun	Duolingo
curativo	curativo	noun	Duolingo
curativos	curativos	noun	Duolingo
curiosidade	curiosidade	noun	Duolingo
curso	curso	noun	Duolingo
cursos	cursos	noun	Duolingo
curta	curta	adjective	Duolingo
curtas	curtas	adjective	Duolingo
curto	curto	adjective	Duolingo
custa	custa	verb	Duolingo
custo	custo	noun	Duolingo
custos	custos	noun	Duolingo
da	da	preposition	Duolingo
dá	da	verb	Duolingo
daí	dai	adverb	Duolingo
daí	dai	conjunction	Duolingo
dança	danca	noun	Duolingo
dançar	dancar	verb	Duolingo
danças	dancas	noun	Duolingo
dando	dando	verb	Duolingo
dano	dano	noun	Duolingo
danos	danos	noun	Duolingo
dão	dao	verb	Duolingo
daquela	daquela	preposition	Duolingo
daquelas	daquelas	preposition	Duolingo
daquele	daquele	preposition	Duolingo
daqueles	daqueles	preposition	Duolingo
daqui	daqui	preposition	Duolingo
daquilo	daquilo	preposition	Duolingo
dar	dar	verb	Duolingo
darão	darao	verb	Duolingo
darei	darei	verb	Duolingo
daria	daria	verb	Duolingo
daríamos	dariamos	verb	Duolingo
das	das	preposition	Duolingo
data	data	noun	Duolingo
datas	datas	noun	Duolingo
dava	dava	verb	Duolingo
de	de	preposition	Duolingo
dê	de	verb	Duolingo
de nada	de nada		Duolingo
de novo	de novo		Duolingo
década	decada	noun	Duolingo
décadas	decadas	noun	Duolingo
decide	decide	verb	Duolingo
decidem	decidem	verb	Duolingo
decides	decides	verb	Duolingo
decidirmos	decidirmos	verb	Duolingo
decidiu	decidiu	verb	Duolingo
decido	decido	verb	Duolingo
decisão	decisao	noun	Duolingo
decisões	decisoes	noun	Duolingo
declaração	declaracao	noun	Duolingo
declarações	declaracoes	noun	Duolingo
dedicada	dedicada	verb	Duolingo
dedicado	dedicado	verb	Duolingo
dedo	dedo	noun	Duolingo
dedos	dedos	noun	Duolingo
defender	defender	verb	Duolingo
defesa	defesa	noun	Duolingo
déficit	deficit	noun	Duolingo
definição	definicao	noun	Duolingo
definir	definir	verb	Duolingo
definitiva	definitiva	adjective	Duolingo
definitivamente	definitivamente	adverb	Duolingo
definitivas	definitivas	adjective	Duolingo
definitivo	definitivo	adjective	Duolingo
dei	dei	verb	Duolingo
deixa	deixa	verb	Duolingo
deixando	deixando	verb	Duolingo
deixar	deixar	verb	Duolingo
deixaram	deixaram	verb	Duolingo
deixarei	deixarei	verb	Duolingo
deixaria	deixaria	verb	Duolingo
deixasse	deixasse	verb	Duolingo
deixava	deixava	verb	Duolingo
deixe	deixe	verb	Duolingo
deixem	deixem	verb	Duolingo
deixo	deixo	verb	Duolingo
deixou	deixou	verb	Duolingo
dela	dela	preposition	Duolingo
delas	delas	preposition	Duolingo
dele	dele	preposition	Duolingo
delegação	delegacao	noun	Duolingo
deles	deles	preposition	Duolingo
demais	demais	adverb	Duolingo
democracia	democracia	noun	Duolingo
democrática	democratica	adjective	Duolingo
democrático	democratico	adjective	Duolingo
demonstrar	demonstrar	verb	Duolingo
dêmos	demos	verb	Duolingo
dente	dente	noun	Duolingo
dentes	dentes	noun	Duolingo
dentista	dentista	noun	Duolingo
dentro	dentro	adverb	Duolingo
departamento	departamento	noun	Duolingo
depende	depende	verb	Duolingo
dependência	dependencia	noun	Duolingo
dependo	dependo	verb	Duolingo
depois	depois	adverb	Duolingo
deram	deram	verb	Duolingo
derrota	derrota	verb	Duolingo
derrotam	derrotam	verb	Duolingo
desaparecimento	desaparecimento	noun	Duolingo
descanso	descanso	verb	Duolingo
descobertas	descobertas	noun	Duolingo
descobrir	descobrir	verb	Duolingo
descolore	descolore	verb	Duolingo
desconto	desconto	noun	Duolingo
descreve	descreve	verb	Duolingo
descrevo	descrevo	verb	Duolingo
descrição	descricao	noun	Duolingo
desculpa	desculpa	verb	Duolingo
desculpamos	desculpamos	verb	Duolingo
desculpando	desculpando	verb	Duolingo
desculparei	desculparei	verb	Duolingo
desculparia	desculparia	verb	Duolingo
desculpasse	desculpasse	verb	Duolingo
desculpe	desculpe	verb	Duolingo
desculpo	desculpo	verb	Duolingo
desde	desde	preposition	Duolingo
desejo	desejo	noun	Duolingo
desejos	desejos	noun	Duolingo
desenha	desenha	verb	Duolingo
desenho	desenho	noun	Duolingo
desenho	desenho	verb	Duolingo
desenhos	desenhos	noun	Duolingo
desenvolver	desenvolver	verb	Duolingo
desenvolveu	desenvolveu	verb	Duolingo
desliga	desliga	verb	Duolingo
dessa	dessa	preposition	Duolingo
dessas	dessas	preposition	Duolingo
desse	desse	preposition	Duolingo
dessem	dessem	verb	Duolingo
déssemos	dessemos	verb	Duolingo
desses	desses	preposition	Duolingo
desta	desta	preposition	Duolingo
destas	destas	preposition	Duolingo
deste	deste	preposition	Duolingo
destes	destes	preposition	Duolingo
destino	destino	noun	Duolingo
destruição	destruicao	noun	Duolingo
detalhes	detalhes	noun	Duolingo
detida	detida	verb	Duolingo
detido	detido	verb	Duolingo
detidos	detidos	verb	Duolingo
deu	deu	verb	Duolingo
deus	deus	noun	Duolingo
devagar	devagar	adverb	Duolingo
deve	deve	verb	Duolingo
devem	devem	verb	Duolingo
devemos	devemos	verb	Duolingo
dever	dever	noun	Duolingo
deverá	devera	verb	Duolingo
deveram	deveram	verb	Duolingo
deveremos	deveremos	verb	Duolingo
deveria	deveria	verb	Duolingo
deveu	deveu	verb	Duolingo
devi	devi	verb	Duolingo
devia	devia	verb	Duolingo
devíamos	deviamos	verb	Duolingo
devo	devo	verb	Duolingo
dez	dez	numeral	Duolingo
dezembro	dezembro	noun	Duolingo
dezenove	dezenove	numeral	Duolingo
dezesseis	dezesseis	numeral	Duolingo
dezessete	dezessete	numeral	Duolingo
dezoito	dezoito	numeral	Duolingo
dia	dia	noun	Duolingo
diagnóstico	diagnostico	noun	Duolingo
diálogo	dialogo	noun	Duolingo
diário	diario	noun	Duolingo
dias	dias	noun	Duolingo
dicionário	dicionario	noun	Duolingo
diferença	diferenca	noun	Duolingo
diferenças	diferencas	noun	Duolingo
diferente	diferente	adjective	Duolingo
diferentes	diferentes	adjective	Duolingo
difíceis	dificeis	adjective	Duolingo
dificuldade	dificuldade	noun	Duolingo
dificuldades	dificuldades	noun	Duolingo
difusão	difusao	noun	Duolingo
diga	diga	verb	Duolingo
digam	digam	verb	Duolingo
dignidade	dignidade	noun	Duolingo
digo	digo	verb	Duolingo
diminuição	diminuicao	noun	Duolingo
diminuir	diminuir	verb	Duolingo
dinheiro	dinheiro	noun	Duolingo
diploma	diploma	noun	Duolingo
diplomacia	diplomacia	noun	Duolingo
dirá	dira	verb	Duolingo
direção	direcao	noun	Duolingo
direções	direcoes	noun	Duolingo
direi	direi	verb	Duolingo
direita	direita	adjective	Duolingo
direita	direita	noun	Duolingo
direito	direito	adjective	Duolingo
direito	direito	noun	Duolingo
direitos	direitos	adjective	Duolingo
direitos	direitos	noun	Duolingo
diremos	diremos	verb	Duolingo
direta	direta	adjective	Duolingo
direto	direto	adjective	Duolingo
diretor	diretor	noun	Duolingo
diria	diria	verb	Duolingo
dirige	dirige	verb	Duolingo
dirigente	dirigente	noun	Duolingo
dirigentes	dirigentes	noun	Duolingo
dirijo	dirijo	verb	Duolingo
disciplina	disciplina	noun	Duolingo
disciplinas	disciplinas	noun	Duolingo
disco	disco	noun	Duolingo
discos	discos	noun	Duolingo
discurso	discurso	noun	Duolingo
discussão	discussao	noun	Duolingo
disse	disse	verb	Duolingo
disseram	disseram	verb	Duolingo
dissesse	dissesse	verb	Duolingo
dissesses	dissesses	verb	Duolingo
disso	disso	preposition	Duolingo
distância	distancia	noun	Duolingo
disto	disto		Duolingo
distribuição	distribuicao	noun	Duolingo
distribuições	distribuicoes	noun	Duolingo
distrito	distrito	noun	Duolingo
divertimento	divertimento	noun	Duolingo
dívida	divida	noun	Duolingo
dívidas	dividas	noun	Duolingo
divisão	divisao	noun	Duolingo
divisões	divisoes	noun	Duolingo
diz	diz	verb	Duolingo
dizem	dizem	verb	Duolingo
dizendo	dizendo	verb	Duolingo
dizia	dizia	verb	Duolingo
do	do	preposition	Duolingo
dobro	dobro	noun	Duolingo
doce	doce	adjective	Duolingo
documento	documento	noun	Duolingo
documentos	documentos	noun	Duolingo
doem	doem	verb	Duolingo
doença	doenca	noun	Duolingo
doente	doente	adjective	Duolingo
doentes	doentes	adjective	Duolingo
dói	doi	verb	Duolingo
dois	dois	numeral	Duolingo
dólar	dolar	noun	Duolingo
dólares	dolares	noun	Duolingo
domingo	domingo	noun	Duolingo
domingos	domingos	noun	Duolingo
domínio	dominio	noun	Duolingo
domínios	dominios	noun	Duolingo
dona	dona	noun	Duolingo
dono	dono	noun	Duolingo
dor	dor	noun	Duolingo
dorme	dorme	verb	Duolingo
dormia	dormia	verb	Duolingo
dormiam	dormiam	verb	Duolingo
dormimos	dormimos	verb	Duolingo
dormindo	dormindo	verb	Duolingo
dormir	dormir	verb	Duolingo
dormirá	dormira	verb	Duolingo
dormirão	dormirao	verb	Duolingo
dormirei	dormirei	verb	Duolingo
dormiria	dormiria	verb	Duolingo
dos	dos	preposition	Duolingo
dose	dose	noun	Duolingo
doses	doses	noun	Duolingo
dou	dou	verb	Duolingo
dourado	dourado	verb	Duolingo
doutor	doutor	noun	Duolingo
doutores	doutores	noun	Duolingo
doze	doze	numeral	Duolingo
duas	duas	numeral	Duolingo
dura	dura	adjective	Duolingo
duração	duracao	noun	Duolingo
durante	durante	preposition	Duolingo
durmo	durmo	verb	Duolingo
duro	duro	adjective	Duolingo
duvida	duvida	verb	Duolingo
e	e	conjunction	Duolingo
é	e	verb	Duolingo
economia	economia	noun	Duolingo
econômica	economica	adjective	Duolingo
econômico	economico	adjective	Duolingo
edição	edicao	noun	Duolingo
edições	edicoes	noun	Duolingo
edifício	edificio	noun	Duolingo
edifícios	edificios	noun	Duolingo
educação	educacao	noun	Duolingo
efeito	efeito	noun	Duolingo
ela	ela	pronoun	Duolingo
elas	elas	pronoun	Duolingo
ele	ele	pronoun	Duolingo
elefante	elefante	noun	Duolingo
eleitorais	eleitorais	adjective	Duolingo
eleitoral	eleitoral	adjective	Duolingo
elemento	elemento	noun	Duolingo
elementos	elementos	noun	Duolingo
eles	eles	pronoun	Duolingo
eletricidade	eletricidade	noun	Duolingo
eliminar	eliminar	verb	Duolingo
em	em	preposition	Duolingo
embaixador	embaixador	noun	Duolingo
embaixadores	embaixadores	noun	Duolingo
embaixo	embaixo	adverb	Duolingo
embora	embora	adverb	Duolingo
embora	embora	conjunction	Duolingo
emergência	emergencia	noun	Duolingo
emoção	emocao	noun	Duolingo
emoções	emocoes	noun	Duolingo
emprego	emprego	noun	Duolingo
empresa	empresa	noun	Duolingo
empresária	empresaria	noun	Duolingo
empresário	empresario	noun	Duolingo
empresas	empresas	noun	Duolingo
empurram	empurram	verb	Duolingo
empurramos	empurramos	verb	Duolingo
empurro	empurro	verb	Duolingo
enche	enche	verb	Duolingo
enchem	enchem	verb	Duolingo
encho	encho	verb	Duolingo
encontra	encontra	verb	Duolingo
encontram	encontram	verb	Duolingo
encontramos	encontramos	verb	Duolingo
encontrando	encontrando	verb	Duolingo
encontrar	encontrar	verb	Duolingo
encontrarei	encontrarei	verb	Duolingo
encontraremos	encontraremos	verb	Duolingo
encontraria	encontraria	verb	Duolingo
encontrarmos	encontrarmos	verb	Duolingo
encontrassem	encontrassem	verb	Duolingo
encontrássemos	encontrassemos	verb	Duolingo
encontrava	encontrava	verb	Duolingo
encontre	encontre	verb	Duolingo
encontrei	encontrei	verb	Duolingo
encontro	encontro	noun	Duolingo
encontro	encontro	verb	Duolingo
encontrou	encontrou	verb	Duolingo
endereço	endereco	noun	Duolingo
energia	energia	noun	Duolingo
enfermeira	enfermeira	noun	Duolingo
enfermeiro	enfermeiro	noun	Duolingo
engenheiro	engenheiro	noun	Duolingo
enjoo	enjoo	noun	Duolingo
enorme	enorme	adjective	Duolingo
enormes	enormes	adjective	Duolingo
enquanto	enquanto	adverb	Duolingo
enquanto	enquanto	conjunction	Duolingo
ensaio	ensaio	noun	Duolingo
ensaios	ensaios	noun	Duolingo
ensina	ensina	verb	Duolingo
ensolarado	ensolarado	adjective	Duolingo
entanto	entanto	adverb	Duolingo
então	entao	adverb	Duolingo
entenda	entenda	verb	Duolingo
entende	entende	verb	Duolingo
entendendo	entendendo	verb	Duolingo
entender	entender	verb	Duolingo
entenderá	entendera	verb	Duolingo
entenderão	entenderao	verb	Duolingo
entenderei	entenderei	verb	Duolingo
entenderia	entenderia	verb	Duolingo
entendesse	entendesse	verb	Duolingo
entendia	entendia	verb	Duolingo
entendimento	entendimento	noun	Duolingo
entendo	entendo	verb	Duolingo
entra	entra	verb	Duolingo
entrada	entrada	noun	Duolingo
entram	entram	verb	Duolingo
entrar	entrar	verb	Duolingo
entre	entre	preposition	Duolingo
entre	entre	verb	Duolingo
entrega	entrega	verb	Duolingo
entregam	entregam	verb	Duolingo
entrego	entrego	verb	Duolingo
entrem	entrem	verb	Duolingo
entrevista	entrevista	noun	Duolingo
entrou	entrou	verb	Duolingo
envelope	envelope	noun	Duolingo
envia	envia	verb	Duolingo
enviam	enviam	verb	Duolingo
envio	envio	verb	Duolingo
envolve	envolve	verb	Duolingo
envolvemos	envolvemos	verb	Duolingo
época	epoca	noun	Duolingo
equilíbrio	equilibrio	noun	Duolingo
equipe	equipe	noun	Duolingo
era	era	verb	Duolingo
erra	erra	verb	Duolingo
erram	erram	verb	Duolingo
erramos	erramos	verb	Duolingo
errando	errando	verb	Duolingo
errará	errara	verb	Duolingo
errarei	errarei	verb	Duolingo
errasse	errasse	verb	Duolingo
errássemos	errassemos	verb	Duolingo
errava	errava	verb	Duolingo
erro	erro	noun	Duolingo
erros	erros	noun	Duolingo
és	es	verb	Duolingo
escada	escada	noun	Duolingo
escadas	escadas	noun	Duolingo
escândalo	escandalo	noun	Duolingo
escola	escola	noun	Duolingo
escolhe	escolhe	verb	Duolingo
escolhemos	escolhemos	verb	Duolingo
escolher	escolher	verb	Duolingo
escolho	escolho	verb	Duolingo
escova	escova	noun	Duolingo
escrevam	escrevam	verb	Duolingo
escreve	escreve	verb	Duolingo
escrevem	escrevem	verb	Duolingo
escrevemos	escrevemos	verb	Duolingo
escrevendo	escrevendo	verb	Duolingo
escrever	escrever	verb	Duolingo
escreveram	escreveram	verb	Duolingo
escreves	escreves	verb	Duolingo
escreveu	escreveu	verb	Duolingo
escrevi	escrevi	verb	Duolingo
escrevo	escrevo	verb	Duolingo
escritor	escritor	noun	Duolingo
escritório	escritorio	noun	Duolingo
escritórios	escritorios	noun	Duolingo
escuta	escuta	verb	Duolingo
escutam	escutam	verb	Duolingo
escutar	escutar	verb	Duolingo
escuto	escuto	verb	Duolingo
esforço	esforco	noun	Duolingo
espaço	espaco	noun	Duolingo
espaços	espacos	noun	Duolingo
espanha	espanha	proper noun	Duolingo
espanhóis	espanhois	adjective	Duolingo
espanhol	espanhol	adjective	Duolingo
espanhol	espanhol	noun	Duolingo
espanholas	espanholas	adjective	Duolingo
especiais	especiais	adjective	Duolingo
especial	especial	adjective	Duolingo
especialidade	especialidade	noun	Duolingo
especialista	especialista	noun	Duolingo
especialistas	especialistas	noun	Duolingo
especialmente	especialmente	adverb	Duolingo
espécie	especie	noun	Duolingo
espécies	especies	noun	Duolingo
espectador	espectador	noun	Duolingo
espectadora	espectadora	noun	Duolingo
espelho	espelho	noun	Duolingo
espera	espera	noun	Duolingo
espera	espera	verb	Duolingo
esperamos	esperamos	verb	Duolingo
esperança	esperanca	noun	Duolingo
esperando	esperando	verb	Duolingo
esperar	esperar	verb	Duolingo
esperará	esperara	verb	Duolingo
esperarei	esperarei	verb	Duolingo
esperaria	esperaria	verb	Duolingo
esperariam	esperariam	verb	Duolingo
esperasse	esperasse	verb	Duolingo
esperava	esperava	verb	Duolingo
espere	espere	verb	Duolingo
esperemos	esperemos	verb	Duolingo
espírito	espirito	noun	Duolingo
esporte	esporte	noun	Duolingo
esportes	esportes	noun	Duolingo
esposa	esposa	noun	Duolingo
esposas	esposas	noun	Duolingo
esposo	esposo	noun	Duolingo
esquece	esquece	verb	Duolingo
esquecem	esquecem	verb	Duolingo
esquecer	esquecer	verb	Duolingo
esquecerei	esquecerei	verb	Duolingo
esqueceria	esqueceria	verb	Duolingo
esqueceriam	esqueceriam	verb	Duolingo
esquecia	esquecia	verb	Duolingo
esquema	esquema	noun	Duolingo
esquerda	esquerda	adjective	Duolingo
esquerda	esquerda	noun	Duolingo
esquina	esquina	noun	Duolingo
essa	essa	determiner	Duolingo
essa	essa	pronoun	Duolingo
essas	essas	determiner	Duolingo
essas	essas	pronoun	Duolingo
esse	esse	determiner	Duolingo
esse	esse	pronoun	Duolingo
esses	esses	determiner	Duolingo
esses	esses	pronoun	Duolingo
esta	esta	determiner	Duolingo
esta	esta	pronoun	Duolingo
está	esta	verb	Duolingo
estabilidade	estabilidade	noun	Duolingo
estação	estacao	noun	Duolingo
estaciona	estaciona	verb	Duolingo
estacionamos	estacionamos	verb	Duolingo
estações	estacoes	noun	Duolingo
estádio	estadio	noun	Duolingo
estado	estado	noun	Duolingo
estadunidense	estadunidense	adjective	Duolingo
estamos	estamos	verb	Duolingo
estão	estao	verb	Duolingo
estar	estar	verb	Duolingo
estará	estara	verb	Duolingo
estarão	estarao	verb	Duolingo
estarei	estarei	verb	Duolingo
estaremos	estaremos	verb	Duolingo
estaria	estaria	verb	Duolingo
estas	estas	determiner	Duolingo
estas	estas	pronoun	Duolingo
estás	estas	verb	Duolingo
estatais	estatais	adjective	Duolingo
estatal	estatal	adjective	Duolingo
estatísticas	estatisticas	noun	Duolingo
estava	estava	verb	Duolingo
estavam	estavam	verb	Duolingo
estávamos	estavamos	verb	Duolingo
este	este	determiner	Duolingo
este	este	pronoun	Duolingo
estes	estes	determiner	Duolingo
estes	estes	pronoun	Duolingo
esteve	esteve	verb	Duolingo
estilo	estilo	noun	Duolingo
estilos	estilos	noun	Duolingo
estive	estive	verb	Duolingo
estivemos	estivemos	verb	Duolingo
estiver	estiver	verb	Duolingo
estiveram	estiveram	verb	Duolingo
estômago	estomago	noun	Duolingo
estou	estou	verb	Duolingo
estrada	estrada	noun	Duolingo
estrangeira	estrangeira	adjective	Duolingo
estranho	estranho	adjective	Duolingo
estratégia	estrategia	noun	Duolingo
estrela	estrela	noun	Duolingo
estrelar	estrelar	verb	Duolingo
estrelas	estrelas	noun	Duolingo
estrutura	estrutura	noun	Duolingo
estudam	estudam	verb	Duolingo
estudamos	estudamos	verb	Duolingo
estudante	estudante	noun	Duolingo
estudantes	estudantes	noun	Duolingo
estudar	estudar	verb	Duolingo
estúdio	estudio	noun	Duolingo
estudo	estudo	noun	Duolingo
estudo	estudo	verb	Duolingo
estudos	estudos	noun	Duolingo
etapa	etapa	noun	Duolingo
etapas	etapas	noun	Duolingo
ético	etico	adjective	Duolingo
éticos	eticos	adjective	Duolingo
eu	eu	pronoun	Duolingo
europa	europa	proper noun	Duolingo
europeu	europeu	adjective	Duolingo
europeus	europeus	adjective	Duolingo
euros	euros	noun	Duolingo
evento	evento	noun	Duolingo
evitar	evitar	verb	Duolingo
evolução	evolucao	noun	Duolingo
exame	exame	noun	Duolingo
exatamente	exatamente	adverb	Duolingo
exceção	excecao	noun	Duolingo
exceções	excecoes	noun	Duolingo
excelente	excelente	adjective	Duolingo
excesso	excesso	noun	Duolingo
execução	execucao	noun	Duolingo
exemplo	exemplo	noun	Duolingo
exemplos	exemplos	noun	Duolingo
exercício	exercicio	noun	Duolingo
exercícios	exercicios	noun	Duolingo
exército	exercito	noun	Duolingo
exige	exige	verb	Duolingo
existe	existe	verb	Duolingo
existem	existem	verb	Duolingo
existência	existencia	noun	Duolingo
existir	existir	verb	Duolingo
expansão	expansao	noun	Duolingo
experiência	experiencia	noun	Duolingo
explica	explica	verb	Duolingo
explicação	explicacao	noun	Duolingo
explicar	explicar	verb	Duolingo
explico	explico	verb	Duolingo
explicou	explicou	verb	Duolingo
explora	explora	verb	Duolingo
exploração	exploracao	noun	Duolingo
exploramos	exploramos	verb	Duolingo
exploro	exploro	verb	Duolingo
exposição	exposicao	noun	Duolingo
expressão	expressao	noun	Duolingo
expressei	expressei	verb	Duolingo
expressou	expressou	verb	Duolingo
extensão	extensao	noun	Duolingo
exterior	exterior	noun	Duolingo
fábrica	fabrica	noun	Duolingo
faca	faca	noun	Duolingo
faça	faca	verb	Duolingo
façam	facam	verb	Duolingo
facas	facas	noun	Duolingo
fácil	facil	adjective	Duolingo
facilidade	facilidade	noun	Duolingo
facilmente	facilmente	adverb	Duolingo
faço	faco	verb	Duolingo
faculdade	faculdade	noun	Duolingo
fala	fala	noun	Duolingo
fala	fala	verb	Duolingo
falam	falam	verb	Duolingo
falamos	falamos	verb	Duolingo
falando	falando	verb	Duolingo
falar	falar	verb	Duolingo
falaram	falaram	verb	Duolingo
falarei	falarei	verb	Duolingo
falaremos	falaremos	verb	Duolingo
falaria	falaria	verb	Duolingo
falas	falas	verb	Duolingo
falasse	falasse	verb	Duolingo
falassem	falassem	verb	Duolingo
falava	falava	verb	Duolingo
falavam	falavam	verb	Duolingo
fale	fale	verb	Duolingo
falei	falei	verb	Duolingo
falham	falham	verb	Duolingo
falhamos	falhamos	verb	Duolingo
falho	falho	verb	Duolingo
falo	falo	verb	Duolingo
falou	falou	verb	Duolingo
falta	falta	noun	Duolingo
fama	fama	noun	Duolingo
família	familia	noun	Duolingo
familiar	familiar	adjective	Duolingo
famoso	famoso	adjective	Duolingo
fantasia	fantasia	noun	Duolingo
fantasma	fantasma	noun	Duolingo
fantasmas	fantasmas	noun	Duolingo
farei	farei	verb	Duolingo
faria	faria	verb	Duolingo
fariam	fariam	verb	Duolingo
farmácia	farmacia	noun	Duolingo
fase	fase	noun	Duolingo
fases	fases	noun	Duolingo
fatores	fatores	noun	Duolingo
faz	faz	verb	Duolingo
fazem	fazem	verb	Duolingo
fazenda	fazenda	noun	Duolingo
fazendeira	fazendeira	noun	Duolingo
fazendeiro	fazendeiro	noun	Duolingo
fazendo	fazendo	verb	Duolingo
fazer	fazer	verb	Duolingo
fazia	fazia	verb	Duolingo
fé	fe	noun	Duolingo
fecha	fecha	verb	Duolingo
fechada	fechada	adjective	Duolingo
fechadas	fechadas	adjective	Duolingo
fechados	fechados	adjective	Duolingo
fecham	fecham	verb	Duolingo
fechamos	fechamos	verb	Duolingo
fechar	fechar	verb	Duolingo
fecho	fecho	verb	Duolingo
federais	federais	adjective	Duolingo
federal	federal	adjective	Duolingo
feira	feira	noun	Duolingo
feita	feita	verb	Duolingo
feito	feito	verb	Duolingo
feitos	feitos	verb	Duolingo
felicidade	felicidade	noun	Duolingo
felicidades	felicidades	noun	Duolingo
feliz	feliz	adjective	Duolingo
felizmente	felizmente	adverb	Duolingo
feminina	feminina	adjective	Duolingo
feminino	feminino	adjective	Duolingo
fenômeno	fenomeno	noun	Duolingo
férias	ferias	noun	Duolingo
ferido	ferido	verb	Duolingo
feridos	feridos	verb	Duolingo
ferramentas	ferramentas	noun	Duolingo
ferve	ferve	verb	Duolingo
fervo	fervo	verb	Duolingo
festa	festa	noun	Duolingo
festas	festas	noun	Duolingo
festivais	festivais	noun	Duolingo
festival	festival	noun	Duolingo
fevereiro	fevereiro	noun	Duolingo
fez	fez	verb	Duolingo
fica	fica	verb	Duolingo
ficam	ficam	verb	Duolingo
ficamos	ficamos	verb	Duolingo
ficando	ficando	verb	Duolingo
ficar	ficar	verb	Duolingo
ficaram	ficaram	verb	Duolingo
ficarão	ficarao	verb	Duolingo
ficarei	ficarei	verb	Duolingo
ficaria	ficaria	verb	Duolingo
ficas	ficas	verb	Duolingo
ficasse	ficasse	verb	Duolingo
ficava	ficava	verb	Duolingo
fico	fico	verb	Duolingo
ficou	ficou	verb	Duolingo
figura	figura	noun	Duolingo
filha	filha	noun	Duolingo
filhas	filhas	noun	Duolingo
filho	filho	noun	Duolingo
filhos	filhos	noun	Duolingo
filmar	filmar	verb	Duolingo
filme	filme	noun	Duolingo
filosofia	filosofia	noun	Duolingo
filosofias	filosofias	noun	Duolingo
fim	fim	noun	Duolingo
fina	fina	adjective	Duolingo
finais	finais	noun	Duolingo
final	final	noun	Duolingo
finalmente	finalmente	adverb	Duolingo
finanças	financas	noun	Duolingo
financiamento	financiamento	noun	Duolingo
finas	finas	adjective	Duolingo
fino	fino	adjective	Duolingo
fique	fique	verb	Duolingo
fiquem	fiquem	verb	Duolingo
fiquemos	fiquemos	verb	Duolingo
física	fisica	noun	Duolingo
fiz	fiz	verb	Duolingo
fizemos	fizemos	verb	Duolingo
fizeram	fizeram	verb	Duolingo
fizesse	fizesse	verb	Duolingo
flor	flor	noun	Duolingo
flores	flores	noun	Duolingo
floresta	floresta	noun	Duolingo
fogo	fogo	noun	Duolingo
foi	foi	verb	Duolingo
folha	folha	noun	Duolingo
folhas	folhas	noun	Duolingo
fome	fome	noun	Duolingo
fomos	fomos	verb	Duolingo
fonte	fonte	noun	Duolingo
fontes	fontes	noun	Duolingo
for	for	verb	Duolingo
fora	fora	adverb	Duolingo
foram	foram	verb	Duolingo
força	forca	noun	Duolingo
formação	formacao	noun	Duolingo
formal	formal	adjective	Duolingo
formar	formar	verb	Duolingo
formiga	formiga	noun	Duolingo
fórmula	formula	noun	Duolingo
forno	forno	noun	Duolingo
forte	forte	adjective	Duolingo
fortes	fortes	adjective	Duolingo
fortuna	fortuna	noun	Duolingo
fosse	fosse	verb	Duolingo
fossem	fossem	verb	Duolingo
foto	foto	noun	Duolingo
fotografar	fotografar	verb	Duolingo
fotografia	fotografia	noun	Duolingo
fotos	fotos	noun	Duolingo
fracasso	fracasso	noun	Duolingo
franca	franca	adjective	Duolingo
frança	franca	proper noun	Duolingo
francês	frances	adjective	Duolingo
francês	frances	noun	Duolingo
francesa	francesa	adjective	Duolingo
francesa	francesa	noun	Duolingo
franceses	franceses	adjective	Duolingo
franceses	franceses	noun	Duolingo
franco	franco	adjective	Duolingo
frango	frango	noun	Duolingo
frase	frase	noun	Duolingo
freia	freia	verb	Duolingo
freie	freie	verb	Duolingo
freio	freio	verb	Duolingo
frente	frente	noun	Duolingo
frequência	frequencia	noun	Duolingo
frequentemente	frequentemente	adverb	Duolingo
fria	fria	adjective	Duolingo
frio	frio	adjective	Duolingo
frios	frios	adjective	Duolingo
frita	frita	verb	Duolingo
fritam	fritam	verb	Duolingo
fritas	fritas	adjective	Duolingo
frito	frito	adjective	Duolingo
frito	frito	verb	Duolingo
fritos	fritos	adjective	Duolingo
fronteira	fronteira	noun	Duolingo
fruta	fruta	noun	Duolingo
fruto	fruto	noun	Duolingo
frutos	frutos	noun	Duolingo
fui	fui	verb	Duolingo
fuma	fuma	verb	Duolingo
fumo	fumo	noun	Duolingo
função	funcao	noun	Duolingo
fundação	fundacao	noun	Duolingo
fundamental	fundamental	adjective	Duolingo
fundo	fundo	noun	Duolingo
fundos	fundos	noun	Duolingo
futebol	futebol	noun	Duolingo
futuro	futuro	noun	Duolingo
galeria	galeria	noun	Duolingo
ganha	ganha	verb	Duolingo
ganhar	ganhar	verb	Duolingo
ganharam	ganharam	verb	Duolingo
ganharei	ganharei	verb	Duolingo
ganharia	ganharia	verb	Duolingo
ganhava	ganhava	verb	Duolingo
ganhávamos	ganhavamos	verb	Duolingo
ganhei	ganhei	verb	Duolingo
ganhou	ganhou	verb	Duolingo
garantir	garantir	verb	Duolingo
garfo	garfo	noun	Duolingo
garganta	garganta	noun	Duolingo
garota	garota	noun	Duolingo
garoto	garoto	noun	Duolingo
garotos	garotos	noun	Duolingo
garrafa	garrafa	noun	Duolingo
garrafas	garrafas	noun	Duolingo
gás	gas	noun	Duolingo
gases	gases	noun	Duolingo
gasta	gasta	verb	Duolingo
gasto	gasto	verb	Duolingo
gata	gata	noun	Duolingo
gatas	gatas	noun	Duolingo
gato	gato	noun	Duolingo
gatos	gatos	noun	Duolingo
geladeira	geladeira	noun	Duolingo
generais	generais	noun	Duolingo
general	general	noun	Duolingo
gênero	genero	noun	Duolingo
gêneros	generos	noun	Duolingo
gente	gente	noun	Duolingo
gente	gente	pronoun	Duolingo
geografia	geografia	noun	Duolingo
geração	geracao	noun	Duolingo
geralmente	geralmente	adverb	Duolingo
gerente	gerente	noun	Duolingo
gesto	gesto	noun	Duolingo
gestos	gestos	noun	Duolingo
ginásio	ginasio	noun	Duolingo
ginásios	ginasios	noun	Duolingo
gira	gira	verb	Duolingo
global	global	adjective	Duolingo
glória	gloria	noun	Duolingo
gol	gol	noun	Duolingo
gols	gols	noun	Duolingo
gosta	gosta	verb	Duolingo
gostam	gostam	verb	Duolingo
gostamos	gostamos	verb	Duolingo
gostando	gostando	verb	Duolingo
gostará	gostara	verb	Duolingo
gostaram	gostaram	verb	Duolingo
gostarei	gostarei	verb	Duolingo
gostaria	gostaria	verb	Duolingo
gostasse	gostasse	verb	Duolingo
gostava	gostava	verb	Duolingo
goste	goste	verb	Duolingo
gostei	gostei	verb	Duolingo
gosto	gosto	noun	Duolingo
gosto	gosto	verb	Duolingo
gostosa	gostosa	adjective	Duolingo
gostosas	gostosas	adjective	Duolingo
gostoso	gostoso	adjective	Duolingo
gostou	gostou	verb	Duolingo
governador	governador	noun	Duolingo
governo	governo	noun	Duolingo
graça	graca	noun	Duolingo
graças	gracas	noun	Duolingo
grama	grama	noun	Duolingo
gramas	gramas	noun	Duolingo
grande	grande	adjective	Duolingo
grandes	grandes	adjective	Duolingo
grátis	gratis	adjective	Duolingo
grátis	gratis	adverb	Duolingo
gratuita	gratuita	adjective	Duolingo
gratuito	gratuito	adjective	Duolingo
grau	grau	noun	Duolingo
graus	graus	noun	Duolingo
grave	grave	adjective	Duolingo
gravidade	gravidade	noun	Duolingo
greve	greve	noun	Duolingo
grita	grita	verb	Duolingo
gritam	gritam	verb	Duolingo
grito	grito	noun	Duolingo
gritos	gritos	noun	Duolingo
grupo	grupo	noun	Duolingo
guarda	guarda	noun	Duolingo
guarda	guarda	verb	Duolingo
guarda-chuva	guarda-chuva	noun	Duolingo
guarda-chuvas	guarda-chuvas	noun	Duolingo
guardam	guardam	verb	Duolingo
guerra	guerra	noun	Duolingo
guerras	guerras	noun	Duolingo
guia	guia	noun	Duolingo
há	ha	verb	Duolingo
haja	haja	verb	Duolingo
havendo	havendo	verb	Duolingo
haverá	havera	verb	Duolingo
haveria	haveria	verb	Duolingo
havia	havia	verb	Duolingo
hipótese	hipotese	noun	Duolingo
história	historia	noun	Duolingo
histórias	historias	noun	Duolingo
histórica	historica	adjective	Duolingo
histórico	historico	adjective	Duolingo
hoje	hoje	adverb	Duolingo
homem	homem	noun	Duolingo
homenagem	homenagem	noun	Duolingo
homens	homens	noun	Duolingo
honra	honra	noun	Duolingo
hora	hora	noun	Duolingo
horas	horas	noun	Duolingo
hóspedes	hospedes	noun	Duolingo
hospital	hospital	noun	Duolingo
hotéis	hoteis	noun	Duolingo
hotel	hotel	noun	Duolingo
houvesse	houvesse	verb	Duolingo
humanidade	humanidade	noun	Duolingo
humano	humano	adjective	Duolingo
humanos	humanos	adjective	Duolingo
humor	humor	noun	Duolingo
ia	ia	verb	Duolingo
idade	idade	noun	Duolingo
ideais	ideais	adjective	Duolingo
ideal	ideal	adjective	Duolingo
ideia	ideia	noun	Duolingo
ideias	ideias	noun	Duolingo
identidade	identidade	noun	Duolingo
identidades	identidades	noun	Duolingo
idioma	idioma	noun	Duolingo
idiomas	idiomas	noun	Duolingo
igreja	igreja	noun	Duolingo
igrejas	igrejas	noun	Duolingo
iguais	iguais	adjective	Duolingo
igualdade	igualdade	noun	Duolingo
igualmente	igualmente	adverb	Duolingo
ilha	ilha	noun	Duolingo
ilusão	ilusao	noun	Duolingo
ilusões	ilusoes	noun	Duolingo
imagem	imagem	noun	Duolingo
imagens	imagens	noun	Duolingo
imediata	imediata	adjective	Duolingo
imediatamente	imediatamente	adverb	Duolingo
impacto	impacto	noun	Duolingo
impedir	impedir	verb	Duolingo
importa	importa	verb	Duolingo
importam	importam	verb	Duolingo
importamos	importamos	verb	Duolingo
importância	importancia	noun	Duolingo
importante	importante	adjective	Duolingo
importantes	importantes	adjective	Duolingo
impossível	impossivel	adjective	Duolingo
imposto	imposto	noun	Duolingo
impostos	impostos	noun	Duolingo
imprensa	imprensa	noun	Duolingo
imprimir	imprimir	verb	Duolingo
incluindo	incluindo	verb	Duolingo
incríveis	incriveis	adjective	Duolingo
incrível	incrivel	adjective	Duolingo
independência	independencia	noun	Duolingo
independente	independente	adjective	Duolingo
independentes	independentes	adjective	Duolingo
índice	indice	noun	Duolingo
indivíduo	individuo	noun	Duolingo
indivíduos	individuos	noun	Duolingo
indo	indo	verb	Duolingo
indústria	industria	noun	Duolingo
industrial	industrial	adjective	Duolingo
infância	infancia	noun	Duolingo
infantil	infantil	adjective	Duolingo
infantis	infantis	adjective	Duolingo
inflação	inflacao	noun	Duolingo
influência	influencia	noun	Duolingo
informação	informacao	noun	Duolingo
informações	informacoes	noun	Duolingo
inglaterra	inglaterra	proper noun	Duolingo
inglês	ingles	adjective	Duolingo
inglês	ingles	noun	Duolingo
inglesa	inglesa	adjective	Duolingo
inicia	inicia	verb	Duolingo
iniciar	iniciar	verb	Duolingo
iniciativa	iniciativa	noun	Duolingo
início	inicio	noun	Duolingo
inimigo	inimigo	noun	Duolingo
inimigos	inimigos	noun	Duolingo
inseto	inseto	noun	Duolingo
insetos	insetos	noun	Duolingo
instalação	instalacao	noun	Duolingo
instante	instante	noun	Duolingo
institucionais	institucionais	adjective	Duolingo
institucional	institucional	adjective	Duolingo
instituição	instituicao	noun	Duolingo
instituições	instituicoes	noun	Duolingo
instituto	instituto	noun	Duolingo
instruções	instrucoes	noun	Duolingo
instrumento	instrumento	noun	Duolingo
instrumentos	instrumentos	noun	Duolingo
integração	integracao	noun	Duolingo
integrantes	integrantes	noun	Duolingo
intelectuais	intelectuais	adjective	Duolingo
intelectual	intelectual	adjective	Duolingo
inteligência	inteligencia	noun	Duolingo
intenção	intencao	noun	Duolingo
intenções	intencoes	noun	Duolingo
intensidade	intensidade	noun	Duolingo
intercâmbio	intercambio	noun	Duolingo
interessa	interessa	verb	Duolingo
interessante	interessante	adjective	Duolingo
interesse	interesse	noun	Duolingo
interesses	interesses	noun	Duolingo
interior	interior	noun	Duolingo
internacionais	internacionais	adjective	Duolingo
internacional	internacional	adjective	Duolingo
internet	internet	noun	Duolingo
interpretação	interpretacao	noun	Duolingo
intervenção	intervencao	noun	Duolingo
introdução	introducao	noun	Duolingo
introduz	introduz	verb	Duolingo
introduzem	introduzem	verb	Duolingo
introduzo	introduzo	verb	Duolingo
invenção	invencao	noun	Duolingo
inverno	inverno	noun	Duolingo
investigação	investigacao	noun	Duolingo
investigações	investigacoes	noun	Duolingo
investimento	investimento	noun	Duolingo
investimentos	investimentos	noun	Duolingo
ir	ir	verb	Duolingo
irá	ira	verb	Duolingo
irei	irei	verb	Duolingo
iria	iria	verb	Duolingo
iriam	iriam	verb	Duolingo
irmã	irma	noun	Duolingo
irmão	irmao	noun	Duolingo
irmãos	irmaos	noun	Duolingo
irmãs	irmas	noun	Duolingo
isso	isso	pronoun	Duolingo
isto	isto	pronoun	Duolingo
itália	italia	proper noun	Duolingo
italiana	italiana	adjective	Duolingo
italiano	italiano	adjective	Duolingo
italiano	italiano	noun	Duolingo
italianos	italianos	adjective	Duolingo
italianos	italianos	noun	Duolingo
já	ja	adverb	Duolingo
janeiro	janeiro	noun	Duolingo
janela	janela	noun	Duolingo
janelas	janelas	noun	Duolingo
jantar	jantar	noun	Duolingo
jaqueta	jaqueta	noun	Duolingo
jardim	jardim	noun	Duolingo
jeans	jeans	noun	Duolingo
jeito	jeito	noun	Duolingo
joelho	joelho	noun	Duolingo
joelhos	joelhos	noun	Duolingo
joga	joga	verb	Duolingo
jogador	jogador	noun	Duolingo
jogadoras	jogadoras	noun	Duolingo
jogadores	jogadores	noun	Duolingo
jogam	jogam	verb	Duolingo
jogamos	jogamos	verb	Duolingo
jogar	jogar	verb	Duolingo
jogarei	jogarei	verb	Duolingo
jogaremos	jogaremos	verb	Duolingo
jogaria	jogaria	verb	Duolingo
jogava	jogava	verb	Duolingo
jogo	jogo	noun	Duolingo
jogo	jogo	verb	Duolingo
jogos	jogos	noun	Duolingo
jornais	jornais	noun	Duolingo
jornal	jornal	noun	Duolingo
jornalista	jornalista	noun	Duolingo
jovem	jovem	adjective	Duolingo
jovens	jovens	adjective	Duolingo
juiz	juiz	noun	Duolingo
juíza	juiza	noun	Duolingo
juízes	juizes	noun	Duolingo
julga	julga	verb	Duolingo
julgamento	julgamento	noun	Duolingo
julho	julho	noun	Duolingo
junho	junho	noun	Duolingo
juntamos	juntamos	verb	Duolingo
juntas	juntas	adjective	Duolingo
juntas	juntas	verb	Duolingo
junto	junto	adverb	Duolingo
juro	juro	noun	Duolingo
juros	juros	noun	Duolingo
justa	justa	adjective	Duolingo
justiça	justica	noun	Duolingo
justo	justo	adjective	Duolingo
juventude	juventude	noun	Duolingo
lá	la	adverb	Duolingo
lábio	labio	noun	Duolingo
lábios	labios	noun	Duolingo
laboratório	laboratorio	noun	Duolingo
lado	lado	noun	Duolingo
lago	lago	noun	Duolingo
lágrimas	lagrimas	noun	Duolingo
lâmpada	lampada	noun	Duolingo
lâmpadas	lampadas	noun	Duolingo
lança	lanca	verb	Duolingo
lançamos	lancamos	verb	Duolingo
lançando	lancando	verb	Duolingo
lançaram	lancaram	verb	Duolingo
lanche	lanche	noun	Duolingo
lançou	lancou	verb	Duolingo
lápis	lapis	noun	Duolingo
lar	lar	noun	Duolingo
laranja	laranja		Duolingo
laranja	laranja	noun	Duolingo
larga	larga	adjective	Duolingo
largas	largas	adjective	Duolingo
largo	largo	adjective	Duolingo
lata	lata	noun	Duolingo
lava	lava	verb	Duolingo
lavamos	lavamos	verb	Duolingo
lavo	lavo	verb	Duolingo
lazer	lazer	noun	Duolingo
lê	le	verb	Duolingo
leão	leao	noun	Duolingo
leem	leem	verb	Duolingo
legais	legais	adjective	Duolingo
legal	legal	adjective	Duolingo
lei	lei	noun	Duolingo
leio	leio	verb	Duolingo
leis	leis	noun	Duolingo
leite	leite	noun	Duolingo
leitor	leitor	noun	Duolingo
leitura	leitura	noun	Duolingo
lembra	lembra	verb	Duolingo
lembram	lembram	verb	Duolingo
lembrando	lembrando	verb	Duolingo
lembrará	lembrara	verb	Duolingo
lembrarei	lembrarei	verb	Duolingo
lembraria	lembraria	verb	Duolingo
lembrasse	lembrasse	verb	Duolingo
lembrava	lembrava	verb	Duolingo
lembre	lembre	verb	Duolingo
lembrem	lembrem	verb	Duolingo
lembro	lembro	verb	Duolingo
lemos	lemos	verb	Duolingo
lençóis	lencois	noun	Duolingo
lençol	lencol	noun	Duolingo
lendo	lendo	verb	Duolingo
ler	ler	verb	Duolingo
leres	leres	verb	Duolingo
lês	les	verb	Duolingo
leste	leste	noun	Duolingo
letra	letra	noun	Duolingo
letras	letras	noun	Duolingo
leva	leva	verb	Duolingo
levam	levam	verb	Duolingo
levanta	levanta	verb	Duolingo
levantou	levantou	verb	Duolingo
levar	levar	verb	Duolingo
levava	levava	verb	Duolingo
leve	leve	verb	Duolingo
levem	levem	verb	Duolingo
levou	levou	verb	Duolingo
lhe	lhe	pronoun	Duolingo
lhes	lhes	pronoun	Duolingo
liberal	liberal	adjective	Duolingo
liberdade	liberdade	noun	Duolingo
libertação	libertacao	noun	Duolingo
lição	licao	noun	Duolingo
licença	licenca	noun	Duolingo
líder	lider	noun	Duolingo
líderes	lideres	noun	Duolingo
ligo	ligo	verb	Duolingo
lilás	lilas	adjective	Duolingo
limão	limao	noun	Duolingo
limite	limite	noun	Duolingo
limites	limites	noun	Duolingo
limonada	limonada	noun	Duolingo
limpa	limpa	adjective	Duolingo
limpa	limpa	verb	Duolingo
limpam	limpam	verb	Duolingo
limpas	limpas	adjective	Duolingo
limpe	limpe	verb	Duolingo
limpemos	limpemos	verb	Duolingo
limpos	limpos	adjective	Duolingo
língua	lingua	noun	Duolingo
linguagem	linguagem	noun	Duolingo
línguas	linguas	noun	Duolingo
literatura	literatura	noun	Duolingo
litoral	litoral	noun	Duolingo
litro	litro	noun	Duolingo
litros	litros	noun	Duolingo
livraria	livraria	noun	Duolingo
livrarias	livrarias	noun	Duolingo
livre	livre	adjective	Duolingo
livro	livro	noun	Duolingo
livros	livros	noun	Duolingo
lobo	lobo	noun	Duolingo
local	local	noun	Duolingo
localidade	localidade	noun	Duolingo
lógica	logica	adjective	Duolingo
lógico	logico	adjective	Duolingo
logo	logo	adverb	Duolingo
loja	loja	noun	Duolingo
longa	longa	adjective	Duolingo
longas	longas	adjective	Duolingo
longe	longe	adverb	Duolingo
longo	longo	adjective	Duolingo
longos	longos	adjective	Duolingo
lote	lote	noun	Duolingo
lua	lua	noun	Duolingo
lugar	lugar	noun	Duolingo
lugares	lugares	noun	Duolingo
lustre	lustre	noun	Duolingo
lustres	lustres	noun	Duolingo
luta	luta	noun	Duolingo
luva	luva	noun	Duolingo
luvas	luvas	noun	Duolingo
luz	luz	noun	Duolingo
luzes	luzes	noun	Duolingo
maçã	maca	noun	Duolingo
macaco	macaco	noun	Duolingo
macarrão	macarrao	noun	Duolingo
maçãs	macas	noun	Duolingo
machucam	machucam	verb	Duolingo
machucando	machucando	verb	Duolingo
machucaram	machucaram	verb	Duolingo
machucou	machucou	verb	Duolingo
macia	macia	adjective	Duolingo
macio	macio	adjective	Duolingo
madeira	madeira	noun	Duolingo
madrugada	madrugada	noun	Duolingo
mãe	mae	noun	Duolingo
maestro	maestro	noun	Duolingo
maio	maio	noun	Duolingo
maior	maior	adjective	Duolingo
maiores	maiores	adjective	Duolingo
maioria	maioria	noun	Duolingo
mais	mais	adverb	Duolingo
mal	mal	adverb	Duolingo
mala	mala	noun	Duolingo
mamãe	mamae	noun	Duolingo
manchete	manchete	noun	Duolingo
maneira	maneira	noun	Duolingo
maneiras	maneiras	noun	Duolingo
manhã	manha	noun	Duolingo
manteiga	manteiga	noun	Duolingo
mantém	mantem	verb	Duolingo
mantenho	mantenho	verb	Duolingo
manter	manter	verb	Duolingo
manterá	mantera	verb	Duolingo
manterei	manterei	verb	Duolingo
manteremos	manteremos	verb	Duolingo
manteria	manteria	verb	Duolingo
mantinha	mantinha	verb	Duolingo
manutenção	manutencao	noun	Duolingo
mão	mao	noun	Duolingo
mãos	maos	noun	Duolingo
mapa	mapa	noun	Duolingo
máquina	maquina	noun	Duolingo
mar	mar	noun	Duolingo
maravilhosa	maravilhosa	adjective	Duolingo
março	marco	noun	Duolingo
margem	margem	noun	Duolingo
marido	marido	noun	Duolingo
mas	mas	conjunction	Duolingo
massa	massa	noun	Duolingo
matemática	matematica	noun	Duolingo
matéria	materia	noun	Duolingo
mau	mau	adjective	Duolingo
maus	maus	adjective	Duolingo
máxima	maxima	adjective	Duolingo
máximo	maximo	adjective	Duolingo
me	me	pronoun	Duolingo
mede	mede	verb	Duolingo
medi	medi	verb	Duolingo
média	media	adjective	Duolingo
média	media	noun	Duolingo
médica	medica	noun	Duolingo
médicas	medicas	noun	Duolingo
medicina	medicina	noun	Duolingo
médico	medico	noun	Duolingo
médicos	medicos	noun	Duolingo
medida	medida	noun	Duolingo
medidas	medidas	noun	Duolingo
medimos	medimos	verb	Duolingo
medindo	medindo	verb	Duolingo
mediste	mediste	verb	Duolingo
medo	medo	noun	Duolingo
meia	meia	noun	Duolingo
meias	meias	noun	Duolingo
meio	meio	noun	Duolingo
melhor	melhor	adjective	Duolingo
melhor	melhor	adverb	Duolingo
melhora	melhora	verb	Duolingo
melhoramos	melhoramos	verb	Duolingo
melhorar	melhorar	verb	Duolingo
melhores	melhores	adjective	Duolingo
membros	membros	noun	Duolingo
memória	memoria	noun	Duolingo
memórias	memorias	noun	Duolingo
menina	menina	noun	Duolingo
meninas	meninas	noun	Duolingo
menino	menino	noun	Duolingo
meninos	meninos	noun	Duolingo
menor	menor	adjective	Duolingo
menores	menores	adjective	Duolingo
menos	menos	adverb	Duolingo
mensagem	mensagem	noun	Duolingo
mensagens	mensagens	noun	Duolingo
mensais	mensais	adjective	Duolingo
mensal	mensal	adjective	Duolingo
mente	mente	noun	Duolingo
mente	mente	verb	Duolingo
mentem	mentem	verb	Duolingo
mentira	mentira	noun	Duolingo
menu	menu	noun	Duolingo
mercado	mercado	noun	Duolingo
mercados	mercados	noun	Duolingo
merece	merece	verb	Duolingo
mês	mes	noun	Duolingo
mesa	mesa	noun	Duolingo
mesas	mesas	noun	Duolingo
meses	meses	noun	Duolingo
mesma	mesma	adjective	Duolingo
mesmo	mesmo	adjective	Duolingo
mesmo	mesmo	adverb	Duolingo
mesmos	mesmos	adjective	Duolingo
mesquita	mesquita	noun	Duolingo
mesquitas	mesquitas	noun	Duolingo
mestre	mestre	noun	Duolingo
metade	metade	noun	Duolingo
método	metodo	noun	Duolingo
métodos	metodos	noun	Duolingo
metrô	metro	noun	Duolingo
metros	metros	noun	Duolingo
meu	meu	determiner	Duolingo
meu	meu	pronoun	Duolingo
meus	meus	determiner	Duolingo
mexicano	mexicano	adjective	Duolingo
mexicanos	mexicanos	adjective	Duolingo
mil	mil	numeral	Duolingo
milhão	milhao	noun	Duolingo
milhões	milhoes	noun	Duolingo
militar	militar	adjective	Duolingo
militares	militares	adjective	Duolingo
mim	mim	pronoun	Duolingo
minha	minha	determiner	Duolingo
minha	minha	pronoun	Duolingo
minhas	minhas	determiner	Duolingo
minhas	minhas	pronoun	Duolingo
mínima	minima	adjective	Duolingo
mínimo	minimo	adjective	Duolingo
ministério	ministerio	noun	Duolingo
ministra	ministra	noun	Duolingo
ministro	ministro	noun	Duolingo
minto	minto	verb	Duolingo
minuto	minuto	noun	Duolingo
minutos	minutos	noun	Duolingo
missão	missao	noun	Duolingo
mistura	mistura	verb	Duolingo
misturam	misturam	verb	Duolingo
misturo	misturo	verb	Duolingo
moda	moda	noun	Duolingo
modas	modas	noun	Duolingo
modelo	modelo	noun	Duolingo
modelos	modelos	noun	Duolingo
moderna	moderna	adjective	Duolingo
moderno	moderno	adjective	Duolingo
modernos	modernos	adjective	Duolingo
modo	modo	noun	Duolingo
moeda	moeda	noun	Duolingo
molho	molho	noun	Duolingo
momento	momento	noun	Duolingo
momentos	momentos	noun	Duolingo
monta	monta	verb	Duolingo
montanha	montanha	noun	Duolingo
monte	monte	noun	Duolingo
monto	monto	verb	Duolingo
mora	mora	verb	Duolingo
moram	moram	verb	Duolingo
morango	morango	noun	Duolingo
morena	morena	adjective	Duolingo
moreno	moreno	adjective	Duolingo
morenos	morenos	adjective	Duolingo
morna	morna	adjective	Duolingo
morno	morno	adjective	Duolingo
moro	moro	verb	Duolingo
morte	morte	noun	Duolingo
mosca	mosca	noun	Duolingo
moscas	moscas	noun	Duolingo
mostra	mostra	verb	Duolingo
mostrar	mostrar	verb	Duolingo
mostrarei	mostrarei	verb	Duolingo
mostraria	mostraria	verb	Duolingo
mostro	mostro	verb	Duolingo
mostrou	mostrou	verb	Duolingo
motivo	motivo	noun	Duolingo
motivos	motivos	noun	Duolingo
moto	moto	noun	Duolingo
motor	motor	noun	Duolingo
motorista	motorista	noun	Duolingo
move	move	verb	Duolingo
móveis	moveis	noun	Duolingo
móvel	movel	noun	Duolingo
movem	movem	verb	Duolingo
movimento	movimento	noun	Duolingo
movimentos	movimentos	noun	Duolingo
movo	movo	verb	Duolingo
muda	muda	verb	Duolingo
mudam	mudam	verb	Duolingo
mudança	mudanca	noun	Duolingo
mudanças	mudancas	noun	Duolingo
mudar	mudar	verb	Duolingo
mudará	mudara	verb	Duolingo
mudarei	mudarei	verb	Duolingo
mudaremos	mudaremos	verb	Duolingo
mudaria	mudaria	verb	Duolingo
mudava	mudava	verb	Duolingo
mudavam	mudavam	verb	Duolingo
mudo	mudo	verb	Duolingo
muita	muita	adjective	Duolingo
muitas	muitas	adjective	Duolingo
muito	muito	adverb	Duolingo
muitos	muitos	adjective	Duolingo
mulher	mulher	noun	Duolingo
mulheres	mulheres	noun	Duolingo
multidão	multidao	noun	Duolingo
múltiplas	multiplas	adjective	Duolingo
mundiais	mundiais	adjective	Duolingo
mundial	mundial	adjective	Duolingo
mundo	mundo	noun	Duolingo
municipais	municipais	adjective	Duolingo
municipal	municipal	adjective	Duolingo
município	municipio	noun	Duolingo
muro	muro	noun	Duolingo
muros	muros	noun	Duolingo
músculo	musculo	noun	Duolingo
músculos	musculos	noun	Duolingo
museu	museu	noun	Duolingo
música	musica	noun	Duolingo
musicais	musicais	adjective	Duolingo
musical	musical	adjective	Duolingo
músico	musico	noun	Duolingo
na	na	preposition	Duolingo
nação	nacao	noun	Duolingo
nacionais	nacionais	adjective	Duolingo
nacional	nacional	adjective	Duolingo
nações	nacoes	noun	Duolingo
nada	nada	adverb	Duolingo
nada	nada	pronoun	Duolingo
nada	nada	verb	Duolingo
nadamos	nadamos	verb	Duolingo
nadando	nadando	verb	Duolingo
nadar	nadar	verb	Duolingo
nado	nado	verb	Duolingo
namorada	namorada	noun	Duolingo
namorado	namorado	noun	Duolingo
não	nao	adverb	Duolingo
naquela	naquela	preposition	Duolingo
naquelas	naquelas	preposition	Duolingo
naquele	naquele	preposition	Duolingo
naqueles	naqueles	preposition	Duolingo
naquilo	naquilo	preposition	Duolingo
nariz	nariz	noun	Duolingo
nas	nas	preposition	Duolingo
nasceu	nasceu	verb	Duolingo
nasci	nasci	verb	Duolingo
nascida	nascida	verb	Duolingo
nascido	nascido	verb	Duolingo
nascidos	nascidos	verb	Duolingo
nascimento	nascimento	noun	Duolingo
natal	natal	noun	Duolingo
naturais	naturais	adjective	Duolingo
natureza	natureza	noun	Duolingo
nave	nave	noun	Duolingo
navega	navega	verb	Duolingo
navegação	navegacao	noun	Duolingo
navego	navego	verb	Duolingo
naves	naves	noun	Duolingo
neblina	neblina	noun	Duolingo
necessidade	necessidade	noun	Duolingo
necessidades	necessidades	noun	Duolingo
negativa	negativa	adjective	Duolingo
negativas	negativas	adjective	Duolingo
negativo	negativo	adjective	Duolingo
negativos	negativos	adjective	Duolingo
negociação	negociacao	noun	Duolingo
negociações	negociacoes	noun	Duolingo
negócio	negocio	noun	Duolingo
negócios	negocios	noun	Duolingo
negou	negou	verb	Duolingo
negra	negra	adjective	Duolingo
negro	negro	adjective	Duolingo
nela	nela	preposition	Duolingo
nelas	nelas	preposition	Duolingo
nele	nele	preposition	Duolingo
neles	neles	preposition	Duolingo
nem	nem	conjunction	Duolingo
nenhum	nenhum	pronoun	Duolingo
nenhuma	nenhuma	pronoun	Duolingo
nervosa	nervosa	adjective	Duolingo
nervoso	nervoso	adjective	Duolingo
nessa	nessa	preposition	Duolingo
nessas	nessas	preposition	Duolingo
nesse	nesse	preposition	Duolingo
nesses	nesses	preposition	Duolingo
nesta	nesta	preposition	Duolingo
nestas	nestas	preposition	Duolingo
neste	neste	preposition	Duolingo
nestes	nestes	preposition	Duolingo
neta	neta	noun	Duolingo
neto	neto	noun	Duolingo
netos	netos	noun	Duolingo
nevar	nevar	verb	Duolingo
neve	neve	noun	Duolingo
ninguém	ninguem	pronoun	Duolingo
nisso	nisso	preposition	Duolingo
nisto	nisto	preposition	Duolingo
níveis	niveis	noun	Duolingo
nível	nivel	noun	Duolingo
no	no	preposition	Duolingo
noite	noite	noun	Duolingo
noites	noites	noun	Duolingo
noiva	noiva	noun	Duolingo
nome	nome	noun	Duolingo
nona	nona	determiner	Duolingo
nono	nono	determiner	Duolingo
norma	norma	noun	Duolingo
normalmente	normalmente	adverb	Duolingo
norte	norte	noun	Duolingo
norte-americana	norte-americana	adjective	Duolingo
norte-americano	norte-americano	adjective	Duolingo
nos	nos	preposition	Duolingo
nós	nos	pronoun	Duolingo
nossa	nossa	determiner	Duolingo
nossa	nossa	pronoun	Duolingo
nossas	nossas	determiner	Duolingo
nossas	nossas	pronoun	Duolingo
nosso	nosso	determiner	Duolingo
nosso	nosso	pronoun	Duolingo
nossos	nossos	determiner	Duolingo
nossos	nossos	pronoun	Duolingo
nota	nota	noun	Duolingo
notas	notas	noun	Duolingo
notícias	noticias	noun	Duolingo
nova	nova	adjective	Duolingo
novamente	novamente	adverb	Duolingo
novas	novas	adjective	Duolingo
nove	nove	numeral	Duolingo
novela	novela	noun	Duolingo
novembro	novembro	noun	Duolingo
noventa	noventa	numeral	Duolingo
novo	novo	adjective	Duolingo
novos	novos	adjective	Duolingo
núcleo	nucleo	noun	Duolingo
número	numero	noun	Duolingo
nunca	nunca	adverb	Duolingo
nuvem	nuvem	noun	Duolingo
nuvens	nuvens	noun	Duolingo
o	o	determiner	Duolingo
o	o	pronoun	Duolingo
objetivo	objetivo	noun	Duolingo
objeto	objeto	noun	Duolingo
objetos	objetos	noun	Duolingo
obra	obra	noun	Duolingo
obrigação	obrigacao	noun	Duolingo
obrigada	obrigada	interjection	Duolingo
obrigado	obrigado	interjection	Duolingo
observa	observa	verb	Duolingo
observação	observacao	noun	Duolingo
observações	observacoes	noun	Duolingo
observar	observar	verb	Duolingo
obter	obter	verb	Duolingo
ocasião	ocasiao	noun	Duolingo
óculos	oculos	noun	Duolingo
ocupação	ocupacao	noun	Duolingo
odeio	odeio	verb	Duolingo
ódio	odio	noun	Duolingo
oeste	oeste	noun	Duolingo
oferece	oferece	verb	Duolingo
oferecer	oferecer	verb	Duolingo
ofereceram	ofereceram	verb	Duolingo
ofereceu	ofereceu	verb	Duolingo
ofereço	ofereco	verb	Duolingo
oferta	oferta	noun	Duolingo
oficiais	oficiais	noun	Duolingo
oficial	oficial	noun	Duolingo
oi	oi	interjection	Duolingo
oitava	oitava	determiner	Duolingo
oitavo	oitavo	determiner	Duolingo
oitenta	oitenta	numeral	Duolingo
oito	oito	numeral	Duolingo
olá	ola	interjection	Duolingo
óleo	oleo	noun	Duolingo
olha	olha	verb	Duolingo
olhada	olhada	noun	Duolingo
olhamos	olhamos	verb	Duolingo
olhando	olhando	verb	Duolingo
olhar	olhar	verb	Duolingo
olharão	olharao	verb	Duolingo
olharei	olharei	verb	Duolingo
olharia	olharia	verb	Duolingo
olhasse	olhasse	verb	Duolingo
olhassem	olhassem	verb	Duolingo
olhe	olhe	verb	Duolingo
olhem	olhem	verb	Duolingo
olho	olho	noun	Duolingo
olho	olho	verb	Duolingo
olhos	olhos	noun	Duolingo
olhou	olhou	verb	Duolingo
ombro	ombro	noun	Duolingo
ombros	ombros	noun	Duolingo
onde	onde	adverb	Duolingo
ônibus	onibus	noun	Duolingo
ontem	ontem	adverb	Duolingo
onze	onze	numeral	Duolingo
opção	opcao	noun	Duolingo
opções	opcoes	noun	Duolingo
ópera	opera	noun	Duolingo
operação	operacao	noun	Duolingo
opinião	opiniao	noun	Duolingo
opiniões	opinioes	noun	Duolingo
oportunidade	oportunidade	noun	Duolingo
oposição	oposicao	noun	Duolingo
orçamento	orcamento	noun	Duolingo
ordem	ordem	noun	Duolingo
ordens	ordens	noun	Duolingo
orelha	orelha	noun	Duolingo
orelhas	orelhas	noun	Duolingo
organismo	organismo	noun	Duolingo
organização	organizacao	noun	Duolingo
organizações	organizacoes	noun	Duolingo
órgão	orgao	noun	Duolingo
orientação	orientacao	noun	Duolingo
orientações	orientacoes	noun	Duolingo
origem	origem	noun	Duolingo
originais	originais	adjective	Duolingo
original	original	adjective	Duolingo
orquestra	orquestra	noun	Duolingo
os	os	determiner	Duolingo
os	os	pronoun	Duolingo
osso	osso	noun	Duolingo
ossos	ossos	noun	Duolingo
ótima	otima	adjective	Duolingo
ótimo	otimo	adjective	Duolingo
ou	ou	conjunction	Duolingo
ouço	ouco	verb	Duolingo
ouro	ouro	noun	Duolingo
outono	outono	noun	Duolingo
outra	outra	determiner	Duolingo
outra	outra	pronoun	Duolingo
outras	outras	determiner	Duolingo
outro	outro	determiner	Duolingo
outro	outro	pronoun	Duolingo
outros	outros	determiner	Duolingo
outros	outros	pronoun	Duolingo
outubro	outubro	noun	Duolingo
ouve	ouve	verb	Duolingo
ouvem	ouvem	verb	Duolingo
ouvi	ouvi	verb	Duolingo
ouvido	ouvido	noun	Duolingo
ouvidos	ouvidos	noun	Duolingo
ouvir	ouvir	verb	Duolingo
ouviram	ouviram	verb	Duolingo
ouviu	ouviu	verb	Duolingo
ovo	ovo	noun	Duolingo
ovos	ovos	noun	Duolingo
paciente	paciente	noun	Duolingo
pacientes	pacientes	noun	Duolingo
padaria	padaria	noun	Duolingo
paga	paga	verb	Duolingo
pagado	pagado	verb	Duolingo
pagam	pagam	verb	Duolingo
pagamento	pagamento	noun	Duolingo
pagamos	pagamos	verb	Duolingo
pagando	pagando	verb	Duolingo
pagar	pagar	verb	Duolingo
pagarei	pagarei	verb	Duolingo
pagaria	pagaria	verb	Duolingo
página	pagina	noun	Duolingo
páginas	paginas	noun	Duolingo
pago	pago	verb	Duolingo
pai	pai	noun	Duolingo
país	pais	noun	Duolingo
paisagem	paisagem	noun	Duolingo
paixão	paixao	noun	Duolingo
palácio	palacio	noun	Duolingo
palavra	palavra	noun	Duolingo
palavras	palavras	noun	Duolingo
palco	palco	noun	Duolingo
palestra	palestra	noun	Duolingo
panorama	panorama	noun	Duolingo
pão	pao	noun	Duolingo
papai	papai	noun	Duolingo
papel	papel	noun	Duolingo
par	par	noun	Duolingo
para	para	preposition	Duolingo
para	para	verb	Duolingo
parabéns	parabens	interjection	Duolingo
parada	parada	noun	Duolingo
parágrafo	paragrafo	noun	Duolingo
param	param	verb	Duolingo
paramos	paramos	verb	Duolingo
parando	parando	verb	Duolingo
parar	parar	verb	Duolingo
parará	parara	verb	Duolingo
pararei	pararei	verb	Duolingo
pararia	pararia	verb	Duolingo
parasse	parasse	verb	Duolingo
parassem	parassem	verb	Duolingo
parava	parava	verb	Duolingo
pare	pare	verb	Duolingo
parece	parece	verb	Duolingo
parecem	parecem	verb	Duolingo
pareceu	pareceu	verb	Duolingo
pareço	pareco	verb	Duolingo
parede	parede	noun	Duolingo
paredes	paredes	noun	Duolingo
paremos	paremos	verb	Duolingo
paro	paro	verb	Duolingo
parque	parque	noun	Duolingo
parte	parte	noun	Duolingo
parte	parte	verb	Duolingo
participar	participar	verb	Duolingo
particular	particular	adjective	Duolingo
particulares	particulares	adjective	Duolingo
partida	partida	noun	Duolingo
partido	partido	noun	Duolingo
partidos	partidos	noun	Duolingo
partir	partir	verb	Duolingo
passa	passa	verb	Duolingo
passageira	passageira	noun	Duolingo
passageiros	passageiros	noun	Duolingo
passam	passam	verb	Duolingo
passando	passando	verb	Duolingo
passaporte	passaporte	noun	Duolingo
passar	passar	verb	Duolingo
passaram	passaram	verb	Duolingo
passarei	passarei	verb	Duolingo
passaremos	passaremos	verb	Duolingo
passaria	passaria	verb	Duolingo
pássaro	passaro	noun	Duolingo
pássaros	passaros	noun	Duolingo
passasse	passasse	verb	Duolingo
passatempo	passatempo	noun	Duolingo
passatempos	passatempos	noun	Duolingo
passava	passava	verb	Duolingo
passe	passe	verb	Duolingo
passei	passei	verb	Duolingo
passeio	passeio	noun	Duolingo
passo	passo	noun	Duolingo
passo	passo	verb	Duolingo
passou	passou	verb	Duolingo
pátio	patio	noun	Duolingo
pato	pato	noun	Duolingo
pátria	patria	noun	Duolingo
pausa	pausa	noun	Duolingo
paz	paz	noun	Duolingo
pé	pe	noun	Duolingo
peça	peca	noun	Duolingo
peças	pecas	noun	Duolingo
peço	peco	verb	Duolingo
pedaço	pedaco	noun	Duolingo
pedaços	pedacos	noun	Duolingo
pede	pede	verb	Duolingo
pedi	pedi	verb	Duolingo
pedimos	pedimos	verb	Duolingo
pedir	pedir	verb	Duolingo
pediu	pediu	verb	Duolingo
pedra	pedra	noun	Duolingo
pedras	pedras	noun	Duolingo
pega	pega	verb	Duolingo
pegando	pegando	verb	Duolingo
pegará	pegara	verb	Duolingo
pegarei	pegarei	verb	Duolingo
pegaria	pegaria	verb	Duolingo
pegasse	pegasse	verb	Duolingo
pegassem	pegassem	verb	Duolingo
pegava	pegava	verb	Duolingo
pegue	pegue	verb	Duolingo
peguem	peguem	verb	Duolingo
peguemos	peguemos	verb	Duolingo
peito	peito	noun	Duolingo
peixe	peixe	noun	Duolingo
pela	pela	preposition	Duolingo
pelas	pelas	preposition	Duolingo
pele	pele	noun	Duolingo
pelo	pelo	preposition	Duolingo
pelos	pelos	preposition	Duolingo
pena	pena	noun	Duolingo
pensa	pensa	verb	Duolingo
pensamento	pensamento	noun	Duolingo
pensamentos	pensamentos	noun	Duolingo
pensando	pensando	verb	Duolingo
pensar	pensar	verb	Duolingo
pensarei	pensarei	verb	Duolingo
pensaria	pensaria	verb	Duolingo
pensasse	pensasse	verb	Duolingo
pensava	pensava	verb	Duolingo
pense	pense	verb	Duolingo
pensei	pensei	verb	Duolingo
penso	penso	verb	Duolingo
pente	pente	noun	Duolingo
pequena	pequena	adjective	Duolingo
pequenas	pequenas	adjective	Duolingo
pequeno	pequeno	adjective	Duolingo
pequenos	pequenos	adjective	Duolingo
perca	perca	verb	Duolingo
percepção	percepcao	noun	Duolingo
perda	perda	noun	Duolingo
perdas	perdas	noun	Duolingo
perde	perde	verb	Duolingo
perdemos	perdemos	verb	Duolingo
perdendo	perdendo	verb	Duolingo
perder	perder	verb	Duolingo
perderam	perderam	verb	Duolingo
perderão	perderao	verb	Duolingo
perderei	perderei	verb	Duolingo
perderia	perderia	verb	Duolingo
perdesse	perdesse	verb	Duolingo
perdessem	perdessem	verb	Duolingo
perdêssemos	perdessemos	verb	Duolingo
perdesses	perdesses	verb	Duolingo
perdeu	perdeu	verb	Duolingo
perdi	perdi	verb	Duolingo
perdia	perdia	verb	Duolingo
perfeita	perfeita	adjective	Duolingo
perfeito	perfeito	adjective	Duolingo
perfil	perfil	noun	Duolingo
pergunta	pergunta	noun	Duolingo
pergunta	pergunta	verb	Duolingo
perguntará	perguntara	verb	Duolingo
perguntaram	perguntaram	verb	Duolingo
perguntarei	perguntarei	verb	Duolingo
perguntaria	perguntaria	verb	Duolingo
perguntei	perguntei	verb	Duolingo
perguntou	perguntou	verb	Duolingo
perigo	perigo	noun	Duolingo
perigosa	perigosa	adjective	Duolingo
perigoso	perigoso	adjective	Duolingo
período	periodo	noun	Duolingo
perito	perito	noun	Duolingo
perna	perna	noun	Duolingo
pernas	pernas	noun	Duolingo
personagem	personagem	noun	Duolingo
personagens	personagens	noun	Duolingo
personalidade	personalidade	noun	Duolingo
perspectiva	perspectiva	noun	Duolingo
pertence	pertence	verb	Duolingo
perto	perto	adverb	Duolingo
pés	pes	noun	Duolingo
pesada	pesada	adjective	Duolingo
pesado	pesado	adjective	Duolingo
pesar	pesar	verb	Duolingo
pesca	pesca	verb	Duolingo
pescador	pescador	noun	Duolingo
pescadores	pescadores	noun	Duolingo
pescoço	pescoco	noun	Duolingo
pesquisa	pesquisa	noun	Duolingo
pesquisador	pesquisador	noun	Duolingo
pesquisadores	pesquisadores	noun	Duolingo
pesquisei	pesquisei	verb	Duolingo
pesquisou	pesquisou	verb	Duolingo
pessoa	pessoa	noun	Duolingo
pessoais	pessoais	adjective	Duolingo
pessoal	pessoal	adjective	Duolingo
pessoal	pessoal	noun	Duolingo
pessoas	pessoas	noun	Duolingo
petróleo	petroleo	noun	Duolingo
piano	piano	noun	Duolingo
pilha	pilha	noun	Duolingo
pilhas	pilhas	noun	Duolingo
piloto	piloto	noun	Duolingo
pilotos	pilotos	noun	Duolingo
pimenta	pimenta	noun	Duolingo
pintar	pintar	verb	Duolingo
pintor	pintor	noun	Duolingo
pintora	pintora	noun	Duolingo
pintura	pintura	noun	Duolingo
pinturas	pinturas	noun	Duolingo
pior	pior	adjective	Duolingo
pista	pista	noun	Duolingo
planeta	planeta	noun	Duolingo
plano	plano	noun	Duolingo
planos	planos	noun	Duolingo
planta	planta	noun	Duolingo
plástico	plastico	noun	Duolingo
pneus	pneus	noun	Duolingo
pobre	pobre	adjective	Duolingo
pobres	pobres	adjective	Duolingo
pobreza	pobreza	noun	Duolingo
pode	pode	verb	Duolingo
podem	podem	verb	Duolingo
podemos	podemos	verb	Duolingo
podendo	podendo	verb	Duolingo
poder	poder	noun	Duolingo
poderei	poderei	verb	Duolingo
poderemos	poderemos	verb	Duolingo
poderes	poderes	noun	Duolingo
poderia	poderia	verb	Duolingo
podia	podia	verb	Duolingo
podiam	podiam	verb	Duolingo
põe	poe	verb	Duolingo
põem	poem	verb	Duolingo
poesia	poesia	noun	Duolingo
polícia	policia	noun	Duolingo
policial	policial	noun	Duolingo
política	politica	adjective	Duolingo
política	politica	noun	Duolingo
político	politico	adjective	Duolingo
político	politico	noun	Duolingo
ponho	ponho	verb	Duolingo
ponta	ponta	noun	Duolingo
ponte	ponte	noun	Duolingo
ponto	ponto	noun	Duolingo
pontos	pontos	noun	Duolingo
população	populacao	noun	Duolingo
popular	popular	adjective	Duolingo
populares	populares	adjective	Duolingo
por	por	preposition	Duolingo
pôr	por	verb	Duolingo
por favor	por favor		Duolingo
porco	porco	noun	Duolingo
porque	porque	conjunction	Duolingo
porta	porta	noun	Duolingo
porta-voz	porta-voz	noun	Duolingo
portão	portao	noun	Duolingo
porto	porto	noun	Duolingo
português	portugues	noun	Duolingo
portuguesa	portuguesa	noun	Duolingo
pôs	pos	verb	Duolingo
positiva	positiva	adjective	Duolingo
positivo	positivo	adjective	Duolingo
possa	possa	verb	Duolingo
possibilidade	possibilidade	noun	Duolingo
possibilidades	possibilidades	noun	Duolingo
possíveis	possiveis	adjective	Duolingo
possível	possivel	adjective	Duolingo
posso	posso	verb	Duolingo
postais	postais	noun	Duolingo
postal	postal	noun	Duolingo
posto	posto	noun	Duolingo
postura	postura	noun	Duolingo
potência	potencia	noun	Duolingo
potências	potencias	noun	Duolingo
pouco	pouco	adjective	Duolingo
pouco	pouco	adverb	Duolingo
pouco	pouco	noun	Duolingo
poucos	poucos	adjective	Duolingo
poupa	poupa	verb	Duolingo
poupamos	poupamos	verb	Duolingo
poupo	poupo	verb	Duolingo
povo	povo	noun	Duolingo
praça	praca	noun	Duolingo
praia	praia	noun	Duolingo
prateadas	prateadas	verb	Duolingo
prateado	prateado	verb	Duolingo
prática	pratica	noun	Duolingo
pratica	pratica	verb	Duolingo
praticam	praticam	verb	Duolingo
praticamente	praticamente	adverb	Duolingo
pratico	pratico	verb	Duolingo
prato	prato	noun	Duolingo
prazer	prazer	noun	Duolingo
prazer em conhecer	prazer em conhecer		Duolingo
prazo	prazo	noun	Duolingo
precisa	precisa	adjective	Duolingo
precisa	precisa	verb	Duolingo
precisam	precisam	verb	Duolingo
precisamos	precisamos	verb	Duolingo
precisando	precisando	verb	Duolingo
precisarei	precisarei	verb	Duolingo
precisaremos	precisaremos	verb	Duolingo
precisaria	precisaria	verb	Duolingo
precisas	precisas	adjective	Duolingo
precisas	precisas	verb	Duolingo
precisasse	precisasse	verb	Duolingo
precisava	precisava	verb	Duolingo
precise	precise	verb	Duolingo
preciso	preciso	adjective	Duolingo
preciso	preciso	verb	Duolingo
preço	preco	noun	Duolingo
preços	precos	noun	Duolingo
prefeita	prefeita	noun	Duolingo
prefeito	prefeito	noun	Duolingo
prefeitura	prefeitura	noun	Duolingo
prefere	prefere	verb	Duolingo
prêmio	premio	noun	Duolingo
prêmios	premios	noun	Duolingo
preocupação	preocupacao	noun	Duolingo
preocupações	preocupacoes	noun	Duolingo
preocupada	preocupada	verb	Duolingo
preocupado	preocupado	verb	Duolingo
preparar	preparar	verb	Duolingo
presa	presa	noun	Duolingo
presença	presenca	noun	Duolingo
presente	presente	noun	Duolingo
presentes	presentes	noun	Duolingo
presidência	presidencia	noun	Duolingo
presidenciais	presidenciais	adjective	Duolingo
presidencial	presidencial	adjective	Duolingo
presidente	presidente	noun	Duolingo
presidentes	presidentes	noun	Duolingo
preso	preso	noun	Duolingo
pressão	pressao	noun	Duolingo
prestígio	prestigio	noun	Duolingo
preto	preto	adjective	Duolingo
prima	prima	noun	Duolingo
primavera	primavera	noun	Duolingo
primeira	primeira	adjective	Duolingo
primeiras	primeiras	adjective	Duolingo
primeiro	primeiro	adjective	Duolingo
primeiro	primeiro	adverb	Duolingo
primeiro	primeiro	determiner	Duolingo
primo	primo	noun	Duolingo
primos	primos	noun	Duolingo
principais	principais	adjective	Duolingo
principal	principal	adjective	Duolingo
principalmente	principalmente	adverb	Duolingo
príncipe	principe	noun	Duolingo
princípio	principio	noun	Duolingo
princípios	principios	noun	Duolingo
prisão	prisao	noun	Duolingo
privada	privada	adjective	Duolingo
privado	privado	adjective	Duolingo
problema	problema	noun	Duolingo
problemas	problemas	noun	Duolingo
procedimento	procedimento	noun	Duolingo
processo	processo	noun	Duolingo
processos	processos	noun	Duolingo
procura	procura	verb	Duolingo
procurando	procurando	verb	Duolingo
procurar	procurar	verb	Duolingo
procuro	procuro	verb	Duolingo
produção	producao	noun	Duolingo
produto	produto	noun	Duolingo
produtora	produtora	noun	Duolingo
produtores	produtores	noun	Duolingo
produtos	produtos	noun	Duolingo
produz	produz	verb	Duolingo
produzem	produzem	verb	Duolingo
produzi	produzi	verb	Duolingo
produzimos	produzimos	verb	Duolingo
produzir	produzir	verb	Duolingo
produziram	produziram	verb	Duolingo
produziu	produziu	verb	Duolingo
professor	professor	noun	Duolingo
professora	professora	noun	Duolingo
professoras	professoras	noun	Duolingo
professores	professores	noun	Duolingo
profissão	profissao	noun	Duolingo
profissionais	profissionais	noun	Duolingo
profissional	profissional	noun	Duolingo
profunda	profunda	adjective	Duolingo
profundidade	profundidade	noun	Duolingo
profundo	profundo	adjective	Duolingo
programa	programa	noun	Duolingo
projeto	projeto	noun	Duolingo
promete	promete	verb	Duolingo
prometem	prometem	verb	Duolingo
prometeu	prometeu	verb	Duolingo
promoção	promocao	noun	Duolingo
promotor	promotor	noun	Duolingo
proporção	proporcao	noun	Duolingo
propósito	proposito	noun	Duolingo
proposta	proposta	noun	Duolingo
propostas	propostas	noun	Duolingo
propriedade	propriedade	noun	Duolingo
propriedades	propriedades	noun	Duolingo
proteção	protecao	noun	Duolingo
prova	prova	noun	Duolingo
prova	prova	verb	Duolingo
provam	provam	verb	Duolingo
provavelmente	provavelmente	adverb	Duolingo
próxima	proxima	noun	Duolingo
próximo	proximo	noun	Duolingo
próximos	proximos	noun	Duolingo
pública	publica	adjective	Duolingo
publicação	publicacao	noun	Duolingo
publicada	publicada	verb	Duolingo
publicadas	publicadas	verb	Duolingo
publicado	publicado	verb	Duolingo
publicidade	publicidade	noun	Duolingo
público	publico	adjective	Duolingo
pude	pude	verb	Duolingo
pudesse	pudesse	verb	Duolingo
pula	pula	verb	Duolingo
pulamos	pulamos	verb	Duolingo
pura	pura	adjective	Duolingo
puras	puras	adjective	Duolingo
puro	puro	adjective	Duolingo
pusemos	pusemos	verb	Duolingo
quadrada	quadrada	adjective	Duolingo
quadrados	quadrados	adjective	Duolingo
quadro	quadro	noun	Duolingo
quadros	quadros	noun	Duolingo
quais	quais	pronoun	Duolingo
qual	qual		Duolingo
qual	qual	pronoun	Duolingo
qualidade	qualidade	noun	Duolingo
qualidades	qualidades	noun	Duolingo
qualquer	qualquer	determiner	Duolingo
qualquer	qualquer	pronoun	Duolingo
quando	quando	adverb	Duolingo
quando	quando	conjunction	Duolingo
quanta	quanta		Duolingo
quantas	quantas	pronoun	Duolingo
quantidade	quantidade	noun	Duolingo
quanto	quanto		Duolingo
quanto	quanto	conjunction	Duolingo
quanto	quanto	pronoun	Duolingo
quantos	quantos		Duolingo
quantos	quantos	pronoun	Duolingo
quarenta	quarenta	numeral	Duolingo
quarta	quarta	determiner	Duolingo
quarta-feira	quarta-feira	noun	Duolingo
quartas-feiras	quartas-feiras	noun	Duolingo
quarto	quarto	determiner	Duolingo
quarto	quarto	noun	Duolingo
quartos	quartos	noun	Duolingo
quase	quase	adverb	Duolingo
quatorze	quatorze	numeral	Duolingo
quatro	quatro	numeral	Duolingo
que	que		Duolingo
que	que	conjunction	Duolingo
que	que	pronoun	Duolingo
queijo	queijo	noun	Duolingo
queima	queima	verb	Duolingo
queimam	queimam	verb	Duolingo
queimamos	queimamos	verb	Duolingo
queira	queira	verb	Duolingo
quem	quem	pronoun	Duolingo
quente	quente	adjective	Duolingo
quer	quer	verb	Duolingo
querem	querem	verb	Duolingo
queremos	queremos	verb	Duolingo
querendo	querendo	verb	Duolingo
querer	querer	verb	Duolingo
quererá	querera	verb	Duolingo
quererei	quererei	verb	Duolingo
quereria	quereria	verb	Duolingo
queria	queria	verb	Duolingo
queriam	queriam	verb	Duolingo
querida	querida	adjective	Duolingo
querido	querido	adjective	Duolingo
quero	quero	verb	Duolingo
questão	questao	noun	Duolingo
quilo	quilo	noun	Duolingo
quilômetro	quilometro	noun	Duolingo
quilômetros	quilometros	noun	Duolingo
quilos	quilos	noun	Duolingo
química	quimica	noun	Duolingo
quinta	quinta	noun	Duolingo
quinta-feira	quinta-feira	noun	Duolingo
quintas-feiras	quintas-feiras	noun	Duolingo
quinto	quinto	determiner	Duolingo
quinze	quinze	numeral	Duolingo
quis	quis	verb	Duolingo
quisesse	quisesse	verb	Duolingo
radicais	radicais	adjective	Duolingo
radical	radical	adjective	Duolingo
rádio	radio	noun	Duolingo
rainha	rainha	noun	Duolingo
raios	raios	noun	Duolingo
raiz	raiz	noun	Duolingo
raízes	raizes	noun	Duolingo
rapariga	rapariga	noun	Duolingo
rapaz	rapaz	noun	Duolingo
rapazes	rapazes	noun	Duolingo
rápidas	rapidas	adjective	Duolingo
rápido	rapido	adjective	Duolingo
rápido	rapido	adverb	Duolingo
rápidos	rapidos	adjective	Duolingo
rara	rara	adjective	Duolingo
raro	raro	adjective	Duolingo
raros	raros	adjective	Duolingo
rato	rato	noun	Duolingo
razão	razao	noun	Duolingo
razões	razoes	noun	Duolingo
reação	reacao	noun	Duolingo
reações	reacoes	noun	Duolingo
reais	reais	adjective	Duolingo
real	real	adjective	Duolingo
realidade	realidade	noun	Duolingo
realidades	realidades	noun	Duolingo
realizar	realizar	verb	Duolingo
realmente	realmente	adverb	Duolingo
recebe	recebe	verb	Duolingo
recebemos	recebemos	verb	Duolingo
receber	receber	verb	Duolingo
recebeu	recebeu	verb	Duolingo
recebi	recebi	verb	Duolingo
receita	receita	noun	Duolingo
recém	recem	adverb	Duolingo
recente	recente	adjective	Duolingo
recentemente	recentemente	adverb	Duolingo
recentes	recentes	adjective	Duolingo
reconhece	reconhece	verb	Duolingo
reconhecem	reconhecem	verb	Duolingo
reconhecer	reconhecer	verb	Duolingo
reconheceu	reconheceu	verb	Duolingo
recuperar	recuperar	verb	Duolingo
recurso	recurso	noun	Duolingo
recursos	recursos	noun	Duolingo
recusa	recusa	verb	Duolingo
recusam	recusam	verb	Duolingo
redação	redacao	noun	Duolingo
rede	rede	noun	Duolingo
reencontrassem	reencontrassem	verb	Duolingo
refeição	refeicao	noun	Duolingo
referência	referencia	noun	Duolingo
reflexão	reflexao	noun	Duolingo
reforma	reforma	noun	Duolingo
reformas	reformas	noun	Duolingo
região	regiao	noun	Duolingo
regime	regime	noun	Duolingo
regiões	regioes	noun	Duolingo
regional	regional	adjective	Duolingo
registro	registro	noun	Duolingo
registros	registros	noun	Duolingo
regra	regra	noun	Duolingo
regras	regras	noun	Duolingo
regularmente	regularmente	adverb	Duolingo
rei	rei	noun	Duolingo
reis	reis	noun	Duolingo
relação	relacao	noun	Duolingo
relacionada	relacionada	verb	Duolingo
relacionadas	relacionadas	verb	Duolingo
relacionado	relacionado	verb	Duolingo
relações	relacoes	noun	Duolingo
relato	relato	noun	Duolingo
relatório	relatorio	noun	Duolingo
relatos	relatos	noun	Duolingo
religião	religiao	noun	Duolingo
religiosa	religiosa	adjective	Duolingo
religioso	religioso	adjective	Duolingo
religiosos	religiosos	adjective	Duolingo
relógio	relogio	noun	Duolingo
relógios	relogios	noun	Duolingo
remédio	remedio	noun	Duolingo
rendimento	rendimento	noun	Duolingo
repetir	repetir	verb	Duolingo
representante	representante	noun	Duolingo
reserva	reserva	verb	Duolingo
reservam	reservam	verb	Duolingo
residência	residencia	noun	Duolingo
resistência	resistencia	noun	Duolingo
resolver	resolver	verb	Duolingo
respeita	respeita	verb	Duolingo
respeitamos	respeitamos	verb	Duolingo
respeito	respeito	noun	Duolingo
respeito	respeito	verb	Duolingo
responde	responde	verb	Duolingo
responder	responder	verb	Duolingo
respondeu	respondeu	verb	Duolingo
respondi	respondi	verb	Duolingo
responsabilidade	responsabilidade	noun	Duolingo
responsáveis	responsaveis	adjective	Duolingo
responsável	responsavel	adjective	Duolingo
resposta	resposta	noun	Duolingo
restaurante	restaurante	noun	Duolingo
resto	resto	noun	Duolingo
resultado	resultado	noun	Duolingo
resultados	resultados	noun	Duolingo
reunião	reuniao	noun	Duolingo
reuniões	reunioes	noun	Duolingo
revisão	revisao	noun	Duolingo
revista	revista	noun	Duolingo
revolução	revolucao	noun	Duolingo
revolucionária	revolucionaria	adjective	Duolingo
revolucionário	revolucionario	adjective	Duolingo
revolucionários	revolucionarios	adjective	Duolingo
reza	reza	noun	Duolingo
ri	ri	verb	Duolingo
rico	rico	adjective	Duolingo
ricos	ricos	adjective	Duolingo
riem	riem	verb	Duolingo
rio	rio	noun	Duolingo
riqueza	riqueza	noun	Duolingo
risco	risco	noun	Duolingo
riscos	riscos	noun	Duolingo
riso	riso	noun	Duolingo
risos	risos	noun	Duolingo
ritmo	ritmo	noun	Duolingo
rivais	rivais	noun	Duolingo
rival	rival	noun	Duolingo
rocha	rocha	noun	Duolingo
rochas	rochas	noun	Duolingo
roda	roda	noun	Duolingo
rodas	rodas	noun	Duolingo
rodoviária	rodoviaria	noun	Duolingo
romper	romper	verb	Duolingo
rosa	rosa	adjective	Duolingo
rosa	rosa	noun	Duolingo
rosto	rosto	noun	Duolingo
rota	rota	noun	Duolingo
rotas	rotas	noun	Duolingo
rouba	rouba	verb	Duolingo
roubamos	roubamos	verb	Duolingo
roupa	roupa	noun	Duolingo
roupas	roupas	noun	Duolingo
roxa	roxa	adjective	Duolingo
roxas	roxas	adjective	Duolingo
rua	rua	noun	Duolingo
rumo	rumo	noun	Duolingo
rumos	rumos	noun	Duolingo
rurais	rurais	adjective	Duolingo
rural	rural	adjective	Duolingo
sã	sa	adjective	Duolingo
sábado	sabado	noun	Duolingo
sábados	sabados	noun	Duolingo
sabão	sabao	noun	Duolingo
sabe	sabe	verb	Duolingo
sabem	sabem	verb	Duolingo
sabendo	sabendo	verb	Duolingo
saber	saber	verb	Duolingo
saberá	sabera	verb	Duolingo
saberão	saberao	verb	Duolingo
saberei	saberei	verb	Duolingo
saberia	saberia	verb	Duolingo
sabia	sabia	verb	Duolingo
sabor	sabor	noun	Duolingo
sacada	sacada	noun	Duolingo
saem	saem	verb	Duolingo
saí	sai	verb	Duolingo
saia	saia	noun	Duolingo
saias	saias	noun	Duolingo
saiba	saiba	verb	Duolingo
saibam	saibam	verb	Duolingo
saída	saida	noun	Duolingo
saio	saio	verb	Duolingo
sair	sair	verb	Duolingo
saíram	sairam	verb	Duolingo
saíste	saiste	verb	Duolingo
saiu	saiu	verb	Duolingo
sal	sal	noun	Duolingo
sala	sala	noun	Duolingo
salada	salada	noun	Duolingo
salário	salario	noun	Duolingo
salgada	salgada	adjective	Duolingo
salgado	salgado	adjective	Duolingo
salmão	salmao	noun	Duolingo
salto	salto	noun	Duolingo
saltos	saltos	noun	Duolingo
salva	salva	adjective	Duolingo
salva	salva	verb	Duolingo
salvamos	salvamos	verb	Duolingo
salvas	salvas	adjective	Duolingo
salvas	salvas	verb	Duolingo
salvo	salvo	verb	Duolingo
salvos	salvos	adjective	Duolingo
sandália	sandalia	noun	Duolingo
sandálias	sandalias	noun	Duolingo
sanduíche	sanduiche	noun	Duolingo
sangue	sangue	noun	Duolingo
são	sao	adjective	Duolingo
são	sao	verb	Duolingo
sãos	saos	adjective	Duolingo
sapato	sapato	noun	Duolingo
sapatos	sapatos	noun	Duolingo
satisfação	satisfacao	noun	Duolingo
saudade	saudade	noun	Duolingo
saúde	saude	noun	Duolingo
se	se	conjunction	Duolingo
se	se	pronoun	Duolingo
secam	secam	verb	Duolingo
seção	secao	noun	Duolingo
secas	secas	adjective	Duolingo
seco	seco	adjective	Duolingo
seco	seco	verb	Duolingo
secos	secos	adjective	Duolingo
secretária	secretaria	noun	Duolingo
secretário	secretario	noun	Duolingo
século	seculo	noun	Duolingo
séculos	seculos	noun	Duolingo
segredo	segredo	noun	Duolingo
segue	segue	verb	Duolingo
segui	segui	verb	Duolingo
seguia	seguia	verb	Duolingo
seguida	seguida	verb	Duolingo
seguidas	seguidas	verb	Duolingo
seguido	seguido	verb	Duolingo
seguimos	seguimos	verb	Duolingo
seguindo	seguindo	verb	Duolingo
seguir	seguir	verb	Duolingo
seguirá	seguira	verb	Duolingo
seguiram	seguiram	verb	Duolingo
seguirei	seguirei	verb	Duolingo
seguiremos	seguiremos	verb	Duolingo
seguiria	seguiria	verb	Duolingo
seguiu	seguiu	verb	Duolingo
segunda	segunda	determiner	Duolingo
segunda	segunda	noun	Duolingo
segunda-feira	segunda-feira	noun	Duolingo
segundas	segundas	noun	Duolingo
segundas-feiras	segundas-feiras	noun	Duolingo
segundo	segundo	determiner	Duolingo
segundo	segundo	noun	Duolingo
segundos	segundos	noun	Duolingo
segura	segura	adjective	Duolingo
segurança	seguranca	noun	Duolingo
seguro	seguro	adjective	Duolingo
sei	sei	verb	Duolingo
seis	seis	numeral	Duolingo
seleção	selecao	noun	Duolingo
seleções	selecoes	noun	Duolingo
selo	selo	noun	Duolingo
selos	selos	noun	Duolingo
sem	sem	preposition	Duolingo
semana	semana	noun	Duolingo
semanais	semanais	adjective	Duolingo
semanal	semanal	adjective	Duolingo
semanas	semanas	noun	Duolingo
semestre	semestre	noun	Duolingo
sempre	sempre	adverb	Duolingo
senador	senador	noun	Duolingo
senadores	senadores	noun	Duolingo
senha	senha	noun	Duolingo
senhor	senhor	noun	Duolingo
senhora	senhora	noun	Duolingo
senhoras	senhoras	noun	Duolingo
sensação	sensacao	noun	Duolingo
sensações	sensacoes	noun	Duolingo
sensibilidade	sensibilidade	noun	Duolingo
senta	senta	verb	Duolingo
sentadas	sentadas	verb	Duolingo
sentado	sentado	verb	Duolingo
sentamos	sentamos	verb	Duolingo
sente	sente	verb	Duolingo
senti	senti	verb	Duolingo
sentido	sentido	noun	Duolingo
sentimento	sentimento	noun	Duolingo
sentimentos	sentimentos	noun	Duolingo
sentindo	sentindo	verb	Duolingo
sentir	sentir	verb	Duolingo
sentirá	sentira	verb	Duolingo
sentirei	sentirei	verb	Duolingo
sentiria	sentiria	verb	Duolingo
sentisse	sentisse	verb	Duolingo
sentissem	sentissem	verb	Duolingo
sentiu	sentiu	verb	Duolingo
ser	ser	verb	Duolingo
será	sera	verb	Duolingo
serão	serao	verb	Duolingo
serei	serei	verb	Duolingo
seremos	seremos	verb	Duolingo
séria	seria	adjective	Duolingo
seria	seria	verb	Duolingo
série	serie	noun	Duolingo
sério	serio	adjective	Duolingo
serve	serve	verb	Duolingo
serviço	servico	noun	Duolingo
serviços	servicos	noun	Duolingo
servir	servir	verb	Duolingo
sessão	sessao	noun	Duolingo
sessenta	sessenta	numeral	Duolingo
sessões	sessoes	noun	Duolingo
sete	sete	numeral	Duolingo
setembro	setembro	noun	Duolingo
setenta	setenta	numeral	Duolingo
sétima	setima	determiner	Duolingo
sétimo	setimo	determiner	Duolingo
setor	setor	noun	Duolingo
seu	seu	determiner	Duolingo
seu	seu	pronoun	Duolingo
seus	seus	determiner	Duolingo
seus	seus	pronoun	Duolingo
sexta	sexta	determiner	Duolingo
sexta-feira	sexta-feira	noun	Duolingo
sextas-feiras	sextas-feiras	noun	Duolingo
sexto	sexto	determiner	Duolingo
si	si	pronoun	Duolingo
significa	significa	verb	Duolingo
signo	signo	noun	Duolingo
signos	signos	noun	Duolingo
silêncio	silencio	noun	Duolingo
sim	sim	adverb	Duolingo
símbolo	simbolo	noun	Duolingo
símbolos	simbolos	noun	Duolingo
simples	simples	adjective	Duolingo
simplesmente	simplesmente	adverb	Duolingo
sinais	sinais	noun	Duolingo
sinal	sinal	noun	Duolingo
sindicato	sindicato	noun	Duolingo
sindicatos	sindicatos	noun	Duolingo
sinta	sinta	verb	Duolingo
sintam	sintam	verb	Duolingo
síntese	sintese	noun	Duolingo
sinto	sinto	verb	Duolingo
sintoma	sintoma	noun	Duolingo
sintomas	sintomas	noun	Duolingo
sistema	sistema	noun	Duolingo
sistemas	sistemas	noun	Duolingo
situação	situacao	noun	Duolingo
situações	situacoes	noun	Duolingo
só	so	adverb	Duolingo
soa	soa	verb	Duolingo
sobre	sobre	preposition	Duolingo
sobrenome	sobrenome	noun	Duolingo
sobrinha	sobrinha	noun	Duolingo
sobrinho	sobrinho	noun	Duolingo
sobrinhos	sobrinhos	noun	Duolingo
sócia	socia	noun	Duolingo
socialista	socialista	adjective	Duolingo
sociedade	sociedade	noun	Duolingo
sócios	socios	noun	Duolingo
sofá	sofa	noun	Duolingo
sofrer	sofrer	verb	Duolingo
sol	sol	noun	Duolingo
solidão	solidao	noun	Duolingo
solidariedade	solidariedade	noun	Duolingo
solução	solucao	noun	Duolingo
soluções	solucoes	noun	Duolingo
som	som	noun	Duolingo
soma	soma	verb	Duolingo
somam	somam	verb	Duolingo
somas	somas	verb	Duolingo
sombra	sombra	noun	Duolingo
somente	somente	adverb	Duolingo
somo	somo	verb	Duolingo
somos	somos	verb	Duolingo
sonha	sonha	verb	Duolingo
sonho	sonho	noun	Duolingo
sonho	sonho	verb	Duolingo
sonhos	sonhos	noun	Duolingo
sopa	sopa	noun	Duolingo
sorri	sorri	verb	Duolingo
sorrio	sorrio	verb	Duolingo
sorriso	sorriso	noun	Duolingo
sorte	sorte	noun	Duolingo
sou	sou	verb	Duolingo
soube	soube	verb	Duolingo
soubesse	soubesse	verb	Duolingo
soubesses	soubesses	verb	Duolingo
sua	sua	determiner	Duolingo
sua	sua	pronoun	Duolingo
suas	suas	determiner	Duolingo
suas	suas	pronoun	Duolingo
subir	subir	verb	Duolingo
substância	substancia	noun	Duolingo
substâncias	substancias	noun	Duolingo
sucesso	sucesso	noun	Duolingo
suco	suco	noun	Duolingo
suficiente	suficiente	adjective	Duolingo
suficientes	suficientes	adjective	Duolingo
suja	suja	adjective	Duolingo
sujeito	sujeito	noun	Duolingo
sujeitos	sujeitos	noun	Duolingo
sujo	sujo	adjective	Duolingo
sujos	sujos	adjective	Duolingo
sul	sul	noun	Duolingo
superfície	superficie	noun	Duolingo
superior	superior	adjective	Duolingo
superiores	superiores	adjective	Duolingo
supermercado	supermercado	noun	Duolingo
supõe	supoe	verb	Duolingo
supomos	supomos	verb	Duolingo
suponho	suponho	verb	Duolingo
surpresa	surpresa	adjective	Duolingo
surpresa	surpresa	noun	Duolingo
surpreso	surpreso	adjective	Duolingo
surpresos	surpresos	adjective	Duolingo
sustentam	sustentam	verb	Duolingo
sustento	sustento	verb	Duolingo
tabela	tabela	noun	Duolingo
talvez	talvez	adverb	Duolingo
tamanho	tamanho	noun	Duolingo
também	tambem	adverb	Duolingo
tambor	tambor	noun	Duolingo
tambores	tambores	noun	Duolingo
tanto	tanto	adverb	Duolingo
tantos	tantos	adjective	Duolingo
tantos	tantos	adverb	Duolingo
tão	tao	adverb	Duolingo
tapete	tapete	noun	Duolingo
tarde	tarde	adverb	Duolingo
tarde	tarde	noun	Duolingo
tardes	tardes	noun	Duolingo
tarefa	tarefa	noun	Duolingo
tartaruga	tartaruga	noun	Duolingo
tatu	tatu	noun	Duolingo
taxa	taxa	noun	Duolingo
taxas	taxas	noun	Duolingo
táxi	taxi	noun	Duolingo
tchau	tchau	interjection	Duolingo
te	te	pronoun	Duolingo
teatro	teatro	noun	Duolingo
teclado	teclado	noun	Duolingo
técnico	tecnico	noun	Duolingo
tecnologia	tecnologia	noun	Duolingo
tela	tela	noun	Duolingo
telefona	telefona	verb	Duolingo
telefonar	telefonar	verb	Duolingo
telefone	telefone	noun	Duolingo
telefonema	telefonema	noun	Duolingo
telefones	telefones	noun	Duolingo
telefono	telefono	verb	Duolingo
televisão	televisao	noun	Duolingo
tem	tem	verb	Duolingo
tema	tema	noun	Duolingo
temos	temos	verb	Duolingo
temperatura	temperatura	noun	Duolingo
tempo	tempo	noun	Duolingo
temporada	temporada	noun	Duolingo
temporadas	temporadas	noun	Duolingo
temporal	temporal	noun	Duolingo
tempos	tempos	noun	Duolingo
tendência	tendencia	noun	Duolingo
tendo	tendo	verb	Duolingo
tenha	tenha	verb	Duolingo
tenhamos	tenhamos	verb	Duolingo
tenho	tenho	verb	Duolingo
tênis	tenis	noun	Duolingo
tens	tens	verb	Duolingo
tensão	tensao	noun	Duolingo
tenta	tenta	verb	Duolingo
tentamos	tentamos	verb	Duolingo
tentando	tentando	verb	Duolingo
tentar	tentar	verb	Duolingo
tentará	tentara	verb	Duolingo
tentarei	tentarei	verb	Duolingo
tentaria	tentaria	verb	Duolingo
tentasse	tentasse	verb	Duolingo
tentava	tentava	verb	Duolingo
tente	tente	verb	Duolingo
tentem	tentem	verb	Duolingo
tento	tento	verb	Duolingo
tentou	tentou	verb	Duolingo
teoria	teoria	noun	Duolingo
ter	ter	verb	Duolingo
terá	tera	verb	Duolingo
terão	terao	verb	Duolingo
terça	terca	noun	Duolingo
terça-feira	terca-feira	noun	Duolingo
terças-feiras	tercas-feiras	noun	Duolingo
terceira	terceira	determiner	Duolingo
terceiro	terceiro	determiner	Duolingo
terei	terei	verb	Duolingo
teremos	teremos	verb	Duolingo
teria	teria	verb	Duolingo
teriam	teriam	verb	Duolingo
termina	termina	verb	Duolingo
terminar	terminar	verb	Duolingo
terminaram	terminaram	verb	Duolingo
terminei	terminei	verb	Duolingo
terminou	terminou	verb	Duolingo
terno	terno	noun	Duolingo
terra	terra	noun	Duolingo
terreno	terreno	noun	Duolingo
território	territorio	noun	Duolingo
tese	tese	noun	Duolingo
teste	teste	noun	Duolingo
testemunha	testemunha	noun	Duolingo
testemunhas	testemunhas	noun	Duolingo
testes	testes	noun	Duolingo
teto	teto	noun	Duolingo
teu	teu	determiner	Duolingo
teu	teu	pronoun	Duolingo
teus	teus	determiner	Duolingo
teus	teus	pronoun	Duolingo
teve	teve	verb	Duolingo
texto	texto	noun	Duolingo
ti	ti	pronoun	Duolingo
tia	tia	noun	Duolingo
tigre	tigre	noun	Duolingo
time	time	noun	Duolingo
tímida	timida	adjective	Duolingo
tímidas	timidas	adjective	Duolingo
tímido	timido	adjective	Duolingo
tímidos	timidos	adjective	Duolingo
tinha	tinha	verb	Duolingo
tinhas	tinhas	verb	Duolingo
tio	tio	noun	Duolingo
tipo	tipo	noun	Duolingo
tipos	tipos	noun	Duolingo
tirando	tirando	verb	Duolingo
tirará	tirara	verb	Duolingo
tirarei	tirarei	verb	Duolingo
tiraria	tiraria	verb	Duolingo
tirasse	tirasse	verb	Duolingo
tirassem	tirassem	verb	Duolingo
tire	tire	verb	Duolingo
título	titulo	noun	Duolingo
títulos	titulos	noun	Duolingo
tive	tive	verb	Duolingo
tivemos	tivemos	verb	Duolingo
tivesse	tivesse	verb	Duolingo
toalha	toalha	noun	Duolingo
toca	toca	verb	Duolingo
tocam	tocam	verb	Duolingo
tocando	tocando	verb	Duolingo
tocar	tocar	verb	Duolingo
tocaram	tocaram	verb	Duolingo
toco	toco	verb	Duolingo
tocou	tocou	verb	Duolingo
toda	toda	determiner	Duolingo
todas	todas	determiner	Duolingo
todas	todas	pronoun	Duolingo
todo	todo	determiner	Duolingo
todos	todos	determiner	Duolingo
todos	todos	pronoun	Duolingo
tom	tom	noun	Duolingo
toma	toma	verb	Duolingo
tomada	tomada	noun	Duolingo
tomadas	tomadas	noun	Duolingo
tomam	tomam	verb	Duolingo
tomamos	tomamos	verb	Duolingo
tomando	tomando	verb	Duolingo
tomar	tomar	verb	Duolingo
tomara	tomara		Duolingo
tomate	tomate	noun	Duolingo
tomei	tomei	verb	Duolingo
tomou	tomou	verb	Duolingo
toneladas	toneladas	noun	Duolingo
topo	topo	noun	Duolingo
toquei	toquei	verb	Duolingo
torneio	torneio	noun	Duolingo
tornozelo	tornozelo	noun	Duolingo
torre	torre	noun	Duolingo
torres	torres	noun	Duolingo
total	total	noun	Duolingo
trabalha	trabalha	verb	Duolingo
trabalhadores	trabalhadores	noun	Duolingo
trabalham	trabalham	verb	Duolingo
trabalhando	trabalhando	verb	Duolingo
trabalhar	trabalhar	verb	Duolingo
trabalharei	trabalharei	verb	Duolingo
trabalharia	trabalharia	verb	Duolingo
trabalhasse	trabalhasse	verb	Duolingo
trabalhassem	trabalhassem	verb	Duolingo
trabalhava	trabalhava	verb	Duolingo
trabalhavam	trabalhavam	verb	Duolingo
trabalhe	trabalhe	verb	Duolingo
trabalhem	trabalhem	verb	Duolingo
trabalho	trabalho	noun	Duolingo
trabalho	trabalho	verb	Duolingo
tradição	tradicao	noun	Duolingo
tradições	tradicoes	noun	Duolingo
tradução	traducao	noun	Duolingo
traduções	traducoes	noun	Duolingo
tráfico	trafico	noun	Duolingo
traga	traga	verb	Duolingo
traje	traje	noun	Duolingo
tranquila	tranquila	adjective	Duolingo
tranquilo	tranquilo	adjective	Duolingo
transformação	transformacao	noun	Duolingo
transição	transicao	noun	Duolingo
trânsito	transito	noun	Duolingo
transporte	transporte	noun	Duolingo
trará	trara	verb	Duolingo
trarão	trarao	verb	Duolingo
trarei	trarei	verb	Duolingo
traria	traria	verb	Duolingo
trata	trata	verb	Duolingo
tratamento	tratamento	noun	Duolingo
tratando	tratando	verb	Duolingo
tratar	tratar	verb	Duolingo
travesseiro	travesseiro	noun	Duolingo
traz	traz	verb	Duolingo
trazia	trazia	verb	Duolingo
treina	treina	verb	Duolingo
treinador	treinador	noun	Duolingo
treinadora	treinadora	noun	Duolingo
treinam	treinam	verb	Duolingo
treino	treino	verb	Duolingo
trem	trem	noun	Duolingo
três	tres	numeral	Duolingo
treze	treze	numeral	Duolingo
tribunais	tribunais	noun	Duolingo
tribunal	tribunal	noun	Duolingo
trimestre	trimestre	noun	Duolingo
trimestres	trimestres	noun	Duolingo
trinta	trinta	numeral	Duolingo
triste	triste	adjective	Duolingo
trouxesse	trouxesse	verb	Duolingo
tu	tu	pronoun	Duolingo
tua	tua	determiner	Duolingo
tua	tua	pronoun	Duolingo
tuas	tuas	determiner	Duolingo
tuas	tuas	pronoun	Duolingo
tubarão	tubarao	noun	Duolingo
tudo	tudo	pronoun	Duolingo
tudo bem	tudo bem		Duolingo
turismo	turismo	noun	Duolingo
turista	turista	noun	Duolingo
turistas	turistas	noun	Duolingo
turquesa	turquesa	noun	Duolingo
tv	tv	noun	Duolingo
última	ultima	adjective	Duolingo
ultimamente	ultimamente	adverb	Duolingo
último	ultimo	adjective	Duolingo
últimos	ultimos	adjective	Duolingo
um	um	determiner	Duolingo
um	um	numeral	Duolingo
um	um	pronoun	Duolingo
uma	uma	determiner	Duolingo
uma	uma	numeral	Duolingo
umas	umas	determiner	Duolingo
umas	umas	pronoun	Duolingo
úmida	umida	adjective	Duolingo
úmidas	umidas	adjective	Duolingo
úmido	umido	adjective	Duolingo
unha	unha	noun	Duolingo
unhas	unhas	noun	Duolingo
união	uniao	noun	Duolingo
único	unico	adjective	Duolingo
unidade	unidade	noun	Duolingo
unidades	unidades	noun	Duolingo
uniões	unioes	noun	Duolingo
universal	universal	adjective	Duolingo
universidade	universidade	noun	Duolingo
universidades	universidades	noun	Duolingo
universo	universo	noun	Duolingo
uns	uns	pronoun	Duolingo
urbana	urbana	adjective	Duolingo
urbano	urbano	adjective	Duolingo
urbanos	urbanos	adjective	Duolingo
urso	urso	noun	Duolingo
usa	usa	verb	Duolingo
usam	usam	verb	Duolingo
usamos	usamos	verb	Duolingo
usando	usando	verb	Duolingo
usar	usar	verb	Duolingo
usará	usara	verb	Duolingo
usarão	usarao	verb	Duolingo
usarei	usarei	verb	Duolingo
usaria	usaria	verb	Duolingo
usariam	usariam	verb	Duolingo
usasse	usasse	verb	Duolingo
usassem	usassem	verb	Duolingo
usássemos	usassemos	verb	Duolingo
usava	usava	verb	Duolingo
use	use	verb	Duolingo
usemos	usemos	verb	Duolingo
uso	uso	verb	Duolingo
usuário	usuario	noun	Duolingo
usuários	usuarios	noun	Duolingo
úteis	uteis	adjective	Duolingo
útil	util	adjective	Duolingo
uva	uva	noun	Duolingo
vá	va	verb	Duolingo
vaca	vaca	noun	Duolingo
vago	vago	adjective	Duolingo
vagos	vagos	adjective	Duolingo
vai	vai	verb	Duolingo
vamos	vamos	verb	Duolingo
vantagem	vantagem	noun	Duolingo
vantagens	vantagens	noun	Duolingo
vão	vao	verb	Duolingo
várias	varias	determiner	Duolingo
variedade	variedade	noun	Duolingo
vários	varios	determiner	Duolingo
vazia	vazia	adjective	Duolingo
vazio	vazio	adjective	Duolingo
vazios	vazios	adjective	Duolingo
vê	ve	verb	Duolingo
vegetais	vegetais	noun	Duolingo
vegetal	vegetal	noun	Duolingo
vegetariana	vegetariana	adjective	Duolingo
vegetariano	vegetariano	adjective	Duolingo
veículo	veiculo	noun	Duolingo
veículos	veiculos	noun	Duolingo
veio	veio	verb	Duolingo
vejo	vejo	verb	Duolingo
velha	velha	adjective	Duolingo
velho	velho	adjective	Duolingo
velocidade	velocidade	noun	Duolingo
vêm	vem	verb	Duolingo
vemos	vemos	verb	Duolingo
venda	venda	noun	Duolingo
vendas	vendas	noun	Duolingo
vendedor	vendedor	noun	Duolingo
vendedora	vendedora	noun	Duolingo
vendem	vendem	verb	Duolingo
vender	vender	verb	Duolingo
vendo	vendo	verb	Duolingo
venha	venha	verb	Duolingo
venham	venham	verb	Duolingo
ventilador	ventilador	noun	Duolingo
vento	vento	noun	Duolingo
ver	ver	verb	Duolingo
verão	verao	noun	Duolingo
verão	verao	verb	Duolingo
verdade	verdade	noun	Duolingo
verdadeira	verdadeira	adjective	Duolingo
verdadeiro	verdadeiro	adjective	Duolingo
verde	verde	adjective	Duolingo
verdes	verdes	adjective	Duolingo
verei	verei	verb	Duolingo
veremos	veremos	verb	Duolingo
vermelha	vermelha	adjective	Duolingo
vermelhas	vermelhas	adjective	Duolingo
vermelho	vermelho	adjective	Duolingo
vermelhos	vermelhos	adjective	Duolingo
versão	versao	noun	Duolingo
versões	versoes	noun	Duolingo
veste	veste	verb	Duolingo
vestido	vestido	noun	Duolingo
vestidos	vestidos	noun	Duolingo
vez	vez	noun	Duolingo
vezes	vezes	noun	Duolingo
vi	vi	verb	Duolingo
via	via	verb	Duolingo
viagem	viagem	noun	Duolingo
viajo	viajo	verb	Duolingo
víamos	viamos	verb	Duolingo
vida	vida	noun	Duolingo
vidas	vidas	noun	Duolingo
vídeo	video	noun	Duolingo
viesse	viesse	verb	Duolingo
viessem	viessem	verb	Duolingo
vigilância	vigilancia	noun	Duolingo
vim	vim	verb	Duolingo
vindo	vindo	verb	Duolingo
vinho	vinho	noun	Duolingo
vinhos	vinhos	noun	Duolingo
vinte	vinte	numeral	Duolingo
violão	violao	noun	Duolingo
violência	violencia	noun	Duolingo
violeta	violeta	adjective	Duolingo
vir	vir	verb	Duolingo
virá	vira	verb	Duolingo
viram	viram	verb	Duolingo
viramos	viramos	verb	Duolingo
vire	vire	verb	Duolingo
virei	virei	verb	Duolingo
virem	virem	verb	Duolingo
viria	viria	verb	Duolingo
virtude	virtude	noun	Duolingo
vírus	virus	noun	Duolingo
visão	visao	noun	Duolingo
visita	visita	noun	Duolingo
visita	visita	verb	Duolingo
vista	vista	noun	Duolingo
visto	visto	verb	Duolingo
vital	vital	adjective	Duolingo
vítima	vitima	noun	Duolingo
vítimas	vitimas	noun	Duolingo
vitória	vitoria	noun	Duolingo
vitórias	vitorias	noun	Duolingo
viu	viu	verb	Duolingo
viva	viva	adjective	Duolingo
vivas	vivas	adjective	Duolingo
vive	vive	verb	Duolingo
vivem	vivem	verb	Duolingo
vivemos	vivemos	verb	Duolingo
viver	viver	verb	Duolingo
vivo	vivo	adjective	Duolingo
vivo	vivo	verb	Duolingo
vivos	vivos	adjective	Duolingo
vizinha	vizinha	noun	Duolingo
vizinhos	vizinhos	noun	Duolingo
vó	vo	noun	Duolingo
voa	voa	verb	Duolingo
você	voce	pronoun	Duolingo
vocês	voces	pronoun	Duolingo
volta	volta	verb	Duolingo
voltam	voltam	verb	Duolingo
voltando	voltando	verb	Duolingo
voltar	voltar	verb	Duolingo
voltaram	voltaram	verb	Duolingo
voltarei	voltarei	verb	Duolingo
voltarem	voltarem	verb	Duolingo
voltaria	voltaria	verb	Duolingo
voltas	voltas	verb	Duolingo
voltasse	voltasse	verb	Duolingo
voltava	voltava	verb	Duolingo
voltavam	voltavam	verb	Duolingo
volte	volte	verb	Duolingo
voltei	voltei	verb	Duolingo
volto	volto	verb	Duolingo
voltou	voltou	verb	Duolingo
volume	volume	noun	Duolingo
vontade	vontade	noun	Duolingo
voo	voo	noun	Duolingo
voo	voo	verb	Duolingo
voos	voos	noun	Duolingo
vota	vota	verb	Duolingo
voto	voto	noun	Duolingo
votos	votos	noun	Duolingo
vou	vou	verb	Duolingo
voz	voz	noun	Duolingo
xampu	xampu	noun	Duolingo
xícara	xicara	noun	Duolingo
xícaras	xicaras	noun	Duolingo
zero	zero	numeral	Duolingo
zona	zona	noun	Duolingo
