learnable	normalized	partOfSpeech	source
а	a		Duolingo
август	avgust		Duolingo
августе	avguste		Duolingo
автобус	avtobus		Duolingo
автобуса	avtobusa		Duolingo
автобусная	avtobusnaia		Duolingo
автобусной	avtobusnoi		Duolingo
автобусные	avtobusnye		Duolingo
автор	avtor		Duolingo
автора	avtora		Duolingo
авторе	avtore		Duolingo
ага	aga		Duolingo
адвокат	advokat		Duolingo
адвоката	advokata		Duolingo
адвокаты	advokaty		Duolingo
администратор	administrator		Duolingo
администратора	administratora		Duolingo
адрес	adres		Duolingo
адреса	adresa		Duolingo
адресе	adrese		Duolingo
азиатские	aziatskie		Duolingo
азиатский	aziatskii		Duolingo
азиатском	aziatskom		Duolingo
азии	azii		Duolingo
академией	akademiei		Duolingo
академии	akademii		Duolingo
академия	akademiia		Duolingo
актёр	akter		Duolingo
актёры	aktery		Duolingo
актриса	aktrisa		Duolingo
актрисы	aktrisy		Duolingo
алло	allo		Duolingo
альбом	al'bom		Duolingo
альбома	al'boma		Duolingo
америка	amerika		Duolingo
американец	amerikanets		Duolingo
американка	amerikanka		Duolingo
американке	amerikanke		Duolingo
американский	amerikanskii		Duolingo
американскую	amerikanskuiu		Duolingo
американцев	amerikantsev		Duolingo
американцу	amerikantsu		Duolingo
америке	amerike		Duolingo
анализ	analiz		Duolingo
анализа	analiza		Duolingo
анализом	analizom		Duolingo
ангел	angel		Duolingo
ангела	angela		Duolingo
ангелы	angely		Duolingo
англии	anglii		Duolingo
английски	angliiski		Duolingo
английский	angliiskii		Duolingo
англичане	anglichane		Duolingo
англичанин	anglichanin		Duolingo
англию	angliiu		Duolingo
англия	angliia		Duolingo
англо-русский	anglo-russkii		Duolingo
англо-русского	anglo-russkogo		Duolingo
анна	anna		Duolingo
анне	anne		Duolingo
анну	annu		Duolingo
антон	anton		Duolingo
апельсин	apel'sin		Duolingo
апельсинами	apel'sinami		Duolingo
апельсиновый	apel'sinovyi		Duolingo
апельсины	apel'siny		Duolingo
апрель	aprel'		Duolingo
апреля	aprelia		Duolingo
аптека	apteka		Duolingo
аптеку	apteku		Duolingo
арестовали	arestovali		Duolingo
арестован	arestovan		Duolingo
арестованы	arestovany		Duolingo
армии	armii		Duolingo
армия	armiia		Duolingo
артист	artist		Duolingo
артисты	artisty		Duolingo
архитектор	arkhitektor		Duolingo
архитектура	arkhitektura		Duolingo
архитектурой	arkhitekturoi		Duolingo
атеист	ateist		Duolingo
атеистом	ateistom		Duolingo
атом	atom		Duolingo
атома	atoma		Duolingo
атомов	atomov		Duolingo
аудитории	auditorii		Duolingo
аэропорт	aeroport		Duolingo
аэропорту	aeroportu		Duolingo
бабушка	babushka		Duolingo
бабушки	babushki		Duolingo
бабушку	babushku		Duolingo
багаж	bagazh		Duolingo
балерина	balerina		Duolingo
балерину	balerinu		Duolingo
балет	balet		Duolingo
балета	baleta		Duolingo
балетом	baletom		Duolingo
балкон	balkon		Duolingo
банан	banan		Duolingo
бананов	bananov		Duolingo
бананы	banany		Duolingo
банк	bank		Duolingo
банка	banka		Duolingo
банком	bankom		Duolingo
банку	banku		Duolingo
банок	banok		Duolingo
баскетбол	basketbol		Duolingo
баскетболист	basketbolist		Duolingo
баскетболиста	basketbolista		Duolingo
баскетболисты	basketbolisty		Duolingo
баскетболом	basketbolom		Duolingo
бегает	begaet		Duolingo
бегать	begat'		Duolingo
бегают	begaiut		Duolingo
беги	begi		Duolingo
бегу	begu		Duolingo
бегут	begut		Duolingo
бедной	bednoi		Duolingo
бедный	bednyi		Duolingo
бежал	bezhal		Duolingo
бежали	bezhali		Duolingo
бежать	bezhat'		Duolingo
бежим	bezhim		Duolingo
бежит	bezhit		Duolingo
бежите	bezhite		Duolingo
без	bez		Duolingo
белой	beloi		Duolingo
белоруссии	belorussii		Duolingo
белоруссия	belorussiia		Duolingo
белую	beluiu		Duolingo
белые	belye		Duolingo
белый	belyi		Duolingo
белым	belym		Duolingo
белых	belykh		Duolingo
бензин	benzin		Duolingo
бензина	benzina		Duolingo
берегу	beregu		Duolingo
берём	berem		Duolingo
берёт	beret		Duolingo
беру	beru		Duolingo
бесплатно	besplatno		Duolingo
бесплатные	besplatnye		Duolingo
бесплатный	besplatnyi		Duolingo
беспокоимся	bespokoimsia		Duolingo
беспокойтесь	bespokoites'		Duolingo
беспокоюсь	bespokoius'		Duolingo
бесполезная	bespoleznaia		Duolingo
бесполезные	bespoleznye		Duolingo
бесполезный	bespoleznyi		Duolingo
библиотека	biblioteka		Duolingo
библиотеке	biblioteke		Duolingo
бизнес	biznes		Duolingo
бизнесмен	biznesmen		Duolingo
бизнесмена	biznesmena		Duolingo
бизнесменам	biznesmenam		Duolingo
бизнесом	biznesom		Duolingo
билет	bilet		Duolingo
билете	bilete		Duolingo
билеты	bilety		Duolingo
биологии	biologii		Duolingo
биологический	biologicheskii		Duolingo
биологическом	biologicheskom		Duolingo
биология	biologiia		Duolingo
битва	bitva		Duolingo
битве	bitve		Duolingo
благодарю	blagodariu		Duolingo
благодаря	blagodaria		Duolingo
близко	blizko		Duolingo
блин	blin		Duolingo
блог	blog		Duolingo
блога	bloga		Duolingo
бог	bog		Duolingo
бога	boga		Duolingo
богатая	bogataia		Duolingo
богатые	bogatye		Duolingo
богатый	bogatyi		Duolingo
богов	bogov		Duolingo
боимся	boimsia		Duolingo
боится	boitsia		Duolingo
более	bolee		Duolingo
болен	bolen		Duolingo
болеть	bolet'		Duolingo
болит	bolit		Duolingo
больна	bol'na		Duolingo
больнице	bol'nitse		Duolingo
больницу	bol'nitsu		Duolingo
больницы	bol'nitsy		Duolingo
большая	bol'shaia		Duolingo
больше	bol'she		Duolingo
большие	bol'shie		Duolingo
большинство	bol'shinstvo		Duolingo
больших	bol'shikh		Duolingo
большое	bol'shoe		Duolingo
большой	bol'shoi		Duolingo
большом	bol'shom		Duolingo
большую	bol'shuiu		Duolingo
болят	boliat		Duolingo
борщ	borshch		Duolingo
ботинки	botinki		Duolingo
ботинок	botinok		Duolingo
боюсь	boius'		Duolingo
боялась	boialas'		Duolingo
брат	brat		Duolingo
брата	brata		Duolingo
братом	bratom		Duolingo
братья	brat'ia		Duolingo
бреетесь	breetes'		Duolingo
бреется	breetsia		Duolingo
брился	brilsia		Duolingo
бросает	brosaet		Duolingo
бросать	brosat'		Duolingo
бросаю	brosaiu		Duolingo
бросил	brosil		Duolingo
бросила	brosila		Duolingo
брюки	briuki		Duolingo
буддистом	buddistom		Duolingo
буддисты	buddisty		Duolingo
будем	budem		Duolingo
будет	budet		Duolingo
будете	budete		Duolingo
будешь	budesh'		Duolingo
буду	budu		Duolingo
будут	budut		Duolingo
будущая	budushchaia		Duolingo
будущий	budushchii		Duolingo
будь	bud'		Duolingo
будьте	bud'te		Duolingo
бумага	bumaga		Duolingo
бумаги	bumagi		Duolingo
бутылка	butylka		Duolingo
бутылки	butylki		Duolingo
бутылку	butylku		Duolingo
бутылок	butylok		Duolingo
бы	by		Duolingo
был	byl		Duolingo
была	byla		Duolingo
были	byli		Duolingo
было	bylo		Duolingo
быстрая	bystraia		Duolingo
быстрее	bystree		Duolingo
быстро	bystro		Duolingo
быстрый	bystryi		Duolingo
быть	byt'		Duolingo
в	v		Duolingo
в виду	v vidu		Duolingo
в депутаты	v deputaty		Duolingo
в-третьих	v-tret'ikh		Duolingo
вагон	vagon		Duolingo
вагоне	vagone		Duolingo
вагонов	vagonov		Duolingo
важно	vazhno		Duolingo
важный	vazhnyi		Duolingo
ваза	vaza		Duolingo
вазе	vaze		Duolingo
вазу	vazu		Duolingo
вам	vam		Duolingo
ванна	vanna		Duolingo
ванне	vanne		Duolingo
ванну	vannu		Duolingo
ваня	vania		Duolingo
варить	varit'		Duolingo
вас	vas		Duolingo
ваш	vash		Duolingo
ваша	vasha		Duolingo
ваше	vashe		Duolingo
вашего	vashego		Duolingo
вашей	vashei		Duolingo
вашем	vashem		Duolingo
ваши	vashi		Duolingo
вашу	vashu		Duolingo
введите	vvedite		Duolingo
ввела	vvela		Duolingo
ввели	vveli		Duolingo
вверх ногами	vverkh nogami		Duolingo
вдвоём	vdvoem		Duolingo
вдруг	vdrug		Duolingo
ведёт	vedet		Duolingo
веду	vedu		Duolingo
ведут	vedut		Duolingo
ведь	ved'		Duolingo
век	vek		Duolingo
века	veka		Duolingo
веке	veke		Duolingo
велик	velik		Duolingo
велика	velika		Duolingo
велики	veliki		Duolingo
великие	velikie		Duolingo
великий	velikii		Duolingo
велико	veliko		Duolingo
велосипед	velosiped		Duolingo
велосипеда	velosipeda		Duolingo
велосипеде	velosipede		Duolingo
вера	vera		Duolingo
верит	verit		Duolingo
верить	verit'		Duolingo
веришь	verish'		Duolingo
верно	verno		Duolingo
вернуться	vernut'sia		Duolingo
верх	verkh		Duolingo
верю	veriu		Duolingo
верят	veriat		Duolingo
весёлая	veselaia		Duolingo
весёлые	veselye		Duolingo
весёлым	veselym		Duolingo
весенние	vesennie		Duolingo
весенним	vesennim		Duolingo
весенних	vesennikh		Duolingo
весна	vesna		Duolingo
весне	vesne		Duolingo
весной	vesnoi		Duolingo
весны	vesny		Duolingo
весом	vesom		Duolingo
весь	ves'		Duolingo
ветер	veter		Duolingo
вечер	vecher		Duolingo
вечера	vechera		Duolingo
вечером	vecherom		Duolingo
вещества	veshchestva		Duolingo
веществами	veshchestvami		Duolingo
вещество	veshchestvo		Duolingo
вещи	veshchi		Duolingo
вещь	veshch'		Duolingo
взрослые	vzroslye		Duolingo
взрослый	vzroslyi		Duolingo
взрослых	vzroslykh		Duolingo
взял	vzial		Duolingo
взяла	vziala		Duolingo
взяли	vziali		Duolingo
вид	vid		Duolingo
видел	videl		Duolingo
видела	videla		Duolingo
видели	videli		Duolingo
видео	video		Duolingo
видим	vidim		Duolingo
видит	vidit		Duolingo
видите	vidite		Duolingo
видишь	vidish'		Duolingo
видов	vidov		Duolingo
виды	vidy		Duolingo
видят	vidiat		Duolingo
вижу	vizhu		Duolingo
вилка	vilka		Duolingo
вилки	vilki		Duolingo
вилкой	vilkoi		Duolingo
вилок	vilok		Duolingo
вина	vina		Duolingo
вино	vino		Duolingo
виновен	vinoven		Duolingo
виновна	vinovna		Duolingo
виновны	vinovny		Duolingo
висел	visel		Duolingo
висела	visela		Duolingo
висеть	viset'		Duolingo
висит	visit		Duolingo
включи	vkliuchi		Duolingo
включил	vkliuchil		Duolingo
включила	vkliuchila		Duolingo
включите	vkliuchite		Duolingo
включить	vkliuchit'		Duolingo
вкусная	vkusnaia		Duolingo
вкусное	vkusnoe		Duolingo
вкусные	vkusnye		Duolingo
вкусный	vkusnyi		Duolingo
власти	vlasti		Duolingo
власть	vlast'		Duolingo
вместе	vmeste		Duolingo
вместо	vmesto		Duolingo
внимателен	vnimatelen		Duolingo
внимательна	vnimatel'na		Duolingo
внимательны	vnimatel'ny		Duolingo
внук	vnuk		Duolingo
внуки	vnuki		Duolingo
внучка	vnuchka		Duolingo
во-вторых	vo-vtorykh		Duolingo
во-первых	vo-pervykh		Duolingo
вовремя	vovremia		Duolingo
вода	voda		Duolingo
водород	vodorod		Duolingo
водорода	vodoroda		Duolingo
воду	vodu		Duolingo
воды	vody		Duolingo
возвращалась	vozvrashchalas'		Duolingo
возвращаться	vozvrashchat'sia		Duolingo
возвращаюсь	vozvrashchaius'		Duolingo
возле	vozle		Duolingo
возможность	vozmozhnost'		Duolingo
возьми	voz'mi		Duolingo
возьмите	voz'mite		Duolingo
воин	voin		Duolingo
воином	voinom		Duolingo
войду	voidu		Duolingo
война	voina		Duolingo
войне	voine		Duolingo
войну	voinu		Duolingo
войны	voiny		Duolingo
войти	voiti		Duolingo
вокруг	vokrug		Duolingo
волейбол	voleibol		Duolingo
волейболе	voleibole		Duolingo
волейболом	voleibolom		Duolingo
волк	volk		Duolingo
волосы	volosy		Duolingo
волшебник	volshebnik		Duolingo
волшебников	volshebnikov		Duolingo
вон	von		Duolingo
вообще-то	voobshche-to		Duolingo
вопрос	vopros		Duolingo
вопросы	voprosy		Duolingo
вор	vor		Duolingo
вора	vora		Duolingo
воре	vore		Duolingo
восемнадцать	vosemnadtsat'		Duolingo
восемь	vosem'		Duolingo
восемьдесят	vosem'desiat		Duolingo
воскресенье	voskresen'e		Duolingo
воскресенью	voskresen'iu		Duolingo
воскресеньям	voskresen'iam		Duolingo
восстание	vosstanie		Duolingo
восстании	vosstanii		Duolingo
восстановили	vosstanovili		Duolingo
восстановить	vosstanovit'		Duolingo
восток	vostok		Duolingo
востоке	vostoke		Duolingo
восточной	vostochnoi		Duolingo
восточную	vostochnuiu		Duolingo
восьмидесяти	vos'midesiati		Duolingo
восьмой	vos'moi		Duolingo
вот	vot		Duolingo
вошла	voshla		Duolingo
вошли	voshli		Duolingo
впереди	vperedi		Duolingo
враг	vrag		Duolingo
врага	vraga		Duolingo
враги	vragi		Duolingo
врагов	vragov		Duolingo
врач	vrach		Duolingo
врача	vracha		Duolingo
врачом	vrachom		Duolingo
вращается	vrashchaetsia		Duolingo
вредная	vrednaia		Duolingo
вредную	vrednuiu		Duolingo
времени	vremeni		Duolingo
время	vremia		Duolingo
всё	vse		Duolingo
всё равно	vse ravno		Duolingo
всегда	vsegda		Duolingo
всего	vsego		Duolingo
вселенная	vselennaia		Duolingo
вселенной	vselennoi		Duolingo
всем	vsem		Duolingo
всему	vsemu		Duolingo
всех	vsekh		Duolingo
вспоминаем	vspominaem		Duolingo
вспоминает	vspominaet		Duolingo
вспоминаете	vspominaete		Duolingo
вспоминаю	vspominaiu		Duolingo
вставать	vstavat'		Duolingo
вставил	vstavil		Duolingo
вставить	vstavit'		Duolingo
вставь	vstav'		Duolingo
встаёт	vstaet		Duolingo
встал	vstal		Duolingo
встала	vstala		Duolingo
встанем	vstanem		Duolingo
встань	vstan'		Duolingo
встаньте	vstan'te		Duolingo
встать	vstat'		Duolingo
встаю	vstaiu		Duolingo
встретил	vstretil		Duolingo
встретила	vstretila		Duolingo
встретили	vstretili		Duolingo
встретились	vstretilis'		Duolingo
встретиться	vstretit'sia		Duolingo
встречается	vstrechaetsia		Duolingo
встречаться	vstrechat'sia		Duolingo
встречаются	vstrechaiutsia		Duolingo
вся	vsia		Duolingo
вторник	vtornik		Duolingo
второй	vtoroi		Duolingo
вход	vkhod		Duolingo
входа	vkhoda		Duolingo
вчера	vchera		Duolingo
вы	vy		Duolingo
выборах	vyborakh		Duolingo
выборы	vybory		Duolingo
выбрал	vybral		Duolingo
выбрала	vybrala		Duolingo
выбрать	vybrat'		Duolingo
выиграл	vyigral		Duolingo
выиграла	vyigrala		Duolingo
выиграли	vyigrali		Duolingo
выйду	vyidu		Duolingo
выйти	vyiti		Duolingo
выключи	vykliuchi		Duolingo
выключил	vykliuchil		Duolingo
выключила	vykliuchila		Duolingo
выключили	vykliuchili		Duolingo
выключить	vykliuchit'		Duolingo
выпил	vypil		Duolingo
выпила	vypila		Duolingo
выпьем	vyp'em		Duolingo
выпьет	vyp'et		Duolingo
выпью	vyp'iu		Duolingo
вырос	vyros		Duolingo
выросла	vyrosla		Duolingo
высокая	vysokaia		Duolingo
высокие	vysokie		Duolingo
высокий	vysokii		Duolingo
высокое	vysokoe		Duolingo
выставка	vystavka		Duolingo
выстрелил	vystrelil		Duolingo
выступал	vystupal		Duolingo
выступать	vystupat'		Duolingo
выступили	vystupili		Duolingo
выступит	vystupit		Duolingo
выступят	vystupiat		Duolingo
выход	vykhod		Duolingo
выхода	vykhoda		Duolingo
выходные	vykhodnye		Duolingo
выходным	vykhodnym		Duolingo
выходом	vykhodom		Duolingo
выше	vyshe		Duolingo
вышедшая	vyshedshaia		Duolingo
вышедшего	vyshedshego		Duolingo
вышедший	vyshedshii		Duolingo
вышедших	vyshedshikh		Duolingo
вышел	vyshel		Duolingo
газ	gaz		Duolingo
газета	gazeta		Duolingo
газету	gazetu		Duolingo
газеты	gazety		Duolingo
газы	gazy		Duolingo
галерее	galeree		Duolingo
галерея	galereia		Duolingo
гараж	garazh		Duolingo
гараже	garazhe		Duolingo
где	gde		Duolingo
где-нибудь	gde-nibud'		Duolingo
где-то	gde-to		Duolingo
германии	germanii		Duolingo
германию	germaniiu		Duolingo
германия	germaniia		Duolingo
герой	geroi		Duolingo
гитара	gitara		Duolingo
гитаре	gitare		Duolingo
гитару	gitaru		Duolingo
глава	glava		Duolingo
главное	glavnoe		Duolingo
главный	glavnyi		Duolingo
главными	glavnymi		Duolingo
главой	glavoi		Duolingo
глаз	glaz		Duolingo
глаза	glaza		Duolingo
глубина	glubina		Duolingo
глубине	glubine		Duolingo
глубиной	glubinoi		Duolingo
глупая	glupaia		Duolingo
глупое	glupoe		Duolingo
глупые	glupye		Duolingo
глупый	glupyi		Duolingo
говори	govori		Duolingo
говорил	govoril		Duolingo
говорила	govorila		Duolingo
говорили	govorili		Duolingo
говорим	govorim		Duolingo
говорит	govorit		Duolingo
говорите	govorite		Duolingo
говорить	govorit'		Duolingo
говоришь	govorish'		Duolingo
говорю	govoriu		Duolingo
говорят	govoriat		Duolingo
говорящая	govoriashchaia		Duolingo
говорящего	govoriashchego		Duolingo
говорящую	govoriashchuiu		Duolingo
год	god		Duolingo
года	goda		Duolingo
году	godu		Duolingo
голова	golova		Duolingo
головы	golovy		Duolingo
голос	golos		Duolingo
голосовали	golosovali		Duolingo
голосовать	golosovat'		Duolingo
голуби	golubi		Duolingo
голубь	golub'		Duolingo
голубя	golubia		Duolingo
гор	gor		Duolingo
гора	gora		Duolingo
гораздо	gorazdo		Duolingo
горе	gore		Duolingo
город	gorod		Duolingo
города	goroda		Duolingo
городе	gorode		Duolingo
городу	gorodu		Duolingo
горы	gory		Duolingo
горячая	goriachaia		Duolingo
горячее	goriachee		Duolingo
горячий	goriachii		Duolingo
гости	gosti		Duolingo
гостиниц	gostinits		Duolingo
гостиница	gostinitsa		Duolingo
гостиницы	gostinitsy		Duolingo
гость	gost'		Duolingo
государства	gosudarstva		Duolingo
готов	gotov		Duolingo
готова	gotova		Duolingo
готовилась	gotovilas'		Duolingo
готовим	gotovim		Duolingo
готовит	gotovit		Duolingo
готовите	gotovite		Duolingo
готовить	gotovit'		Duolingo
готовиться	gotovit'sia		Duolingo
готовишь	gotovish'		Duolingo
готовлю	gotovliu		Duolingo
готовлюсь	gotovlius'		Duolingo
готово	gotovo		Duolingo
готовят	gotoviat		Duolingo
градуса	gradusa		Duolingo
градусов	gradusov		Duolingo
граница	granitsa		Duolingo
границей	granitsei		Duolingo
границу	granitsu		Duolingo
греции	gretsii		Duolingo
грецию	gretsiiu		Duolingo
греция	gretsiia		Duolingo
грибы	griby		Duolingo
громкая	gromkaia		Duolingo
громкий	gromkii		Duolingo
громкую	gromkuiu		Duolingo
груди	grudi		Duolingo
группа	gruppa		Duolingo
группе	gruppe		Duolingo
грустная	grustnaia		Duolingo
грустно	grustno		Duolingo
грустную	grustnuiu		Duolingo
грустный	grustnyi		Duolingo
грязно	griazno		Duolingo
гуляем	guliaem		Duolingo
гуляет	guliaet		Duolingo
гуляешь	guliaesh'		Duolingo
гуляла	guliala		Duolingo
гулять	guliat'		Duolingo
гуляя	guliaia		Duolingo
да	da		Duolingo
да здравствует	da zdravstvuet		Duolingo
давай	davai		Duolingo
давайте	davaite		Duolingo
давление	davlenie		Duolingo
давлении	davlenii		Duolingo
давления	davleniia		Duolingo
давно	davno		Duolingo
даёт	daet		Duolingo
даже	dazhe		Duolingo
дай	dai		Duolingo
дайте	daite		Duolingo
дал	dal		Duolingo
дала	dala		Duolingo
далеко	daleko		Duolingo
дам	dam		Duolingo
данные	dannye		Duolingo
данным	dannym		Duolingo
данных	dannykh		Duolingo
даст	dast		Duolingo
дают	daiut		Duolingo
два	dva		Duolingo
двадцатого	dvadtsatogo		Duolingo
двадцатом	dvadtsatom		Duolingo
двадцатый	dvadtsatyi		Duolingo
двадцать	dvadtsat'		Duolingo
две	dve		Duolingo
двенадцать	dvenadtsat'		Duolingo
двери	dveri		Duolingo
дверь	dver'		Duolingo
дверью	dver'iu		Duolingo
двести	dvesti		Duolingo
двигается	dvigaetsia		Duolingo
движется	dvizhetsia		Duolingo
двойка	dvoika		Duolingo
двойки	dvoiki		Duolingo
двойку	dvoiku		Duolingo
двор	dvor		Duolingo
дворе	dvore		Duolingo
дворец	dvorets		Duolingo
дворца	dvortsa		Duolingo
дворце	dvortse		Duolingo
двум	dvum		Duolingo
двух	dvukh		Duolingo
двухтысячного	dvukhtysiachnogo		Duolingo
двухтысячном	dvukhtysiachnom		Duolingo
девочек	devochek		Duolingo
девочка	devochka		Duolingo
девочкам	devochkam		Duolingo
девочках	devochkakh		Duolingo
девочке	devochke		Duolingo
девочки	devochki		Duolingo
девочкой	devochkoi		Duolingo
девочку	devochku		Duolingo
девушка	devushka		Duolingo
девушки	devushki		Duolingo
девяносто	devianosto		Duolingo
девятнадцатого	deviatnadtsatogo		Duolingo
девятнадцатом	deviatnadtsatom		Duolingo
девятнадцатый	deviatnadtsatyi		Duolingo
девятнадцать	deviatnadtsat'		Duolingo
девятое	deviatoe		Duolingo
девятый	deviatyi		Duolingo
девять	deviat'		Duolingo
девятьсот	deviat'sot		Duolingo
дедушка	dedushka		Duolingo
дедушки	dedushki		Duolingo
дедушку	dedushku		Duolingo
действия	deistviia		Duolingo
декабрь	dekabr'		Duolingo
декабря	dekabria		Duolingo
дела	dela		Duolingo
делает	delaet		Duolingo
делаете	delaete		Duolingo
делаешь	delaesh'		Duolingo
делал	delal		Duolingo
делать	delat'		Duolingo
делаю	delaiu		Duolingo
дело	delo		Duolingo
дело в том	delo v tom		Duolingo
денег	deneg		Duolingo
день	den'		Duolingo
деньги	den'gi		Duolingo
депутат	deputat		Duolingo
дереве	dereve		Duolingo
деревне	derevne		Duolingo
деревни	derevni		Duolingo
деревня	derevnia		Duolingo
дерево	derevo		Duolingo
дереву	derevu		Duolingo
деревья	derev'ia		Duolingo
деревьям	derev'iam		Duolingo
деревянная	dereviannaia		Duolingo
деревянный	dereviannyi		Duolingo
держит	derzhit		Duolingo
держите	derzhite		Duolingo
держу	derzhu		Duolingo
десерт	desert		Duolingo
десерта	deserta		Duolingo
десяти	desiati		Duolingo
десятое	desiatoe		Duolingo
десятом	desiatom		Duolingo
десятый	desiatyi		Duolingo
десять	desiat'		Duolingo
детей	detei		Duolingo
дети	deti		Duolingo
детская	detskaia		Duolingo
детский	detskii		Duolingo
детям	detiam		Duolingo
детях	detiakh		Duolingo
дешёвая	deshevaia		Duolingo
дешевле	deshevle		Duolingo
дёшево	deshevo		Duolingo
дешёвый	deshevyi		Duolingo
дженни	dzhenni		Duolingo
диван	divan		Duolingo
диване	divane		Duolingo
диваны	divany		Duolingo
дима	dima		Duolingo
директор	direktor		Duolingo
директора	direktora		Duolingo
директором	direktorom		Duolingo
дирижёр	dirizher		Duolingo
дирижёром	dirizherom		Duolingo
диск	disk		Duolingo
диске	diske		Duolingo
дискотеке	diskoteke		Duolingo
дискотеку	diskoteku		Duolingo
длина	dlina		Duolingo
длинная	dlinnaia		Duolingo
длиннее	dlinnee		Duolingo
длинную	dlinnuiu		Duolingo
длинный	dlinnyi		Duolingo
длинных	dlinnykh		Duolingo
длиной	dlinoi		Duolingo
длину	dlinu		Duolingo
для	dlia		Duolingo
дней	dnei		Duolingo
днём	dnem		Duolingo
дня	dnia		Duolingo
до	do		Duolingo
до сих пор	do sikh por		Duolingo
добро пожаловать	dobro pozhalovat'		Duolingo
доброе	dobroe		Duolingo
добрый	dobryi		Duolingo
договор	dogovor		Duolingo
договорились	dogovorilis'		Duolingo
договорился	dogovorilsia		Duolingo
договориться	dogovorit'sia		Duolingo
дождь	dozhd'		Duolingo
дождя	dozhdia		Duolingo
доказана	dokazana		Duolingo
доказано	dokazano		Duolingo
доказательств	dokazatel'stv		Duolingo
доказательства	dokazatel'stva		Duolingo
документ	dokument		Duolingo
документе	dokumente		Duolingo
долгие	dolgie		Duolingo
долгий	dolgii		Duolingo
долго	dolgo		Duolingo
должен	dolzhen		Duolingo
должна	dolzhna		Duolingo
должны	dolzhny		Duolingo
долларов	dollarov		Duolingo
дом	dom		Duolingo
дома	doma		Duolingo
домашнее	domashnee		Duolingo
домашние	domashnie		Duolingo
домашних	domashnikh		Duolingo
доме	dome		Duolingo
домов	domov		Duolingo
домой	domoi		Duolingo
домом	domom		Duolingo
дорога	doroga		Duolingo
дороге	doroge		Duolingo
дорогое	dorogoe		Duolingo
дорогой	dorogoi		Duolingo
дорогу	dorogu		Duolingo
дороже	dorozhe		Duolingo
доска	doska		Duolingo
достаточно	dostatochno		Duolingo
дочерей	docherei		Duolingo
дочери	docheri		Duolingo
дочь	doch'		Duolingo
дракон	drakon		Duolingo
драконов	drakonov		Duolingo
древнего	drevnego		Duolingo
древней	drevnei		Duolingo
древнем	drevnem		Duolingo
древнюю	drevniuiu		Duolingo
древняя	drevniaia		Duolingo
друг	drug		Duolingo
друг друга	drug druga		Duolingo
друг другу	drug drugu		Duolingo
друг с другом	drug s drugom		Duolingo
другая	drugaia		Duolingo
другой	drugoi		Duolingo
другом	drugom		Duolingo
друзей	druzei		Duolingo
друзья	druz'ia		Duolingo
думает	dumaet		Duolingo
думаете	dumaete		Duolingo
думаешь	dumaesh'		Duolingo
думай	dumai		Duolingo
думайте	dumaite		Duolingo
думал	dumal		Duolingo
думала	dumala		Duolingo
думали	dumali		Duolingo
думаю	dumaiu		Duolingo
думая	dumaia		Duolingo
душ	dush		Duolingo
душа	dusha		Duolingo
душе	dushe		Duolingo
души	dushi		Duolingo
дяди	diadi		Duolingo
дядю	diadiu		Duolingo
дядя	diadia		Duolingo
европа	evropa		Duolingo
европе	evrope		Duolingo
европейские	evropeiskie		Duolingo
европейский	evropeiskii		Duolingo
европейских	evropeiskikh		Duolingo
европу	evropu		Duolingo
европы	evropy		Duolingo
его	ego		Duolingo
еда	eda		Duolingo
едем	edem		Duolingo
едет	edet		Duolingo
едете	edete		Duolingo
единственную	edinstvennuiu		Duolingo
единственный	edinstvennyi		Duolingo
едите	edite		Duolingo
еду	edu		Duolingo
едут	edut		Duolingo
еды	edy		Duolingo
едят	ediat		Duolingo
её	ee		Duolingo
ежедневная	ezhednevnaia		Duolingo
ежедневно	ezhednevno		Duolingo
ежедневные	ezhednevnye		Duolingo
ездил	ezdil		Duolingo
ездила	ezdila		Duolingo
ездим	ezdim		Duolingo
ездит	ezdit		Duolingo
ездите	ezdite		Duolingo
ездить	ezdit'		Duolingo
езжу	ezzhu		Duolingo
ей	ei		Duolingo
ем	em		Duolingo
ему	emu		Duolingo
если	esli		Duolingo
ест	est		Duolingo
естественно	estestvenno		Duolingo
естественный	estestvennyi		Duolingo
есть	est'		Duolingo
ехать	ekhat'		Duolingo
ешь	esh'		Duolingo
ешьте	esh'te		Duolingo
ещё	eshche		Duolingo
жалко	zhalko		Duolingo
жаль	zhal'		Duolingo
жарко	zharko		Duolingo
ждал	zhdal		Duolingo
ждала	zhdala		Duolingo
ждали	zhdali		Duolingo
ждать	zhdat'		Duolingo
ждёт	zhdet		Duolingo
ждите	zhdite		Duolingo
жду	zhdu		Duolingo
ждут	zhdut		Duolingo
железная	zheleznaia		Duolingo
железное	zheleznoe		Duolingo
железной	zheleznoi		Duolingo
железную	zheleznuiu		Duolingo
железный	zheleznyi		Duolingo
жёлтая	zheltaia		Duolingo
жёлтые	zheltye		Duolingo
жёлтый	zheltyi		Duolingo
жена	zhena		Duolingo
женился	zhenilsia		Duolingo
женится	zhenitsia		Duolingo
жениться	zhenit'sia		Duolingo
женский	zhenskii		Duolingo
женскую	zhenskuiu		Duolingo
жену	zhenu		Duolingo
женщина	zhenshchina		Duolingo
женщиной	zhenshchinoi		Duolingo
женщины	zhenshchiny		Duolingo
жёсткий диск	zhestkii disk		Duolingo
жёстком диске	zhestkom diske		Duolingo
живём	zhivem		Duolingo
живёт	zhivet		Duolingo
живёшь	zhivesh'		Duolingo
живопись	zhivopis'		Duolingo
живописью	zhivopis'iu		Duolingo
живот	zhivot		Duolingo
живота	zhivota		Duolingo
животе	zhivote		Duolingo
животное	zhivotnoe		Duolingo
животные	zhivotnye		Duolingo
животных	zhivotnykh		Duolingo
живу	zhivu		Duolingo
живут	zhivut		Duolingo
живущая	zhivushchaia		Duolingo
живущие	zhivushchie		Duolingo
живущих	zhivushchikh		Duolingo
жидкости	zhidkosti		Duolingo
жидкость	zhidkost'		Duolingo
жизнь	zhizn'		Duolingo
жил	zhil		Duolingo
жила	zhila		Duolingo
жили	zhili		Duolingo
жило	zhilo		Duolingo
жить	zhit'		Duolingo
журнал	zhurnal		Duolingo
журналистом	zhurnalistom		Duolingo
журналы	zhurnaly		Duolingo
за	za		Duolingo
заботился	zabotilsia		Duolingo
заботится	zabotitsia		Duolingo
заботишься	zabotish'sia		Duolingo
забочусь	zabochus'		Duolingo
заброшенном	zabroshennom		Duolingo
заброшенную	zabroshennuiu		Duolingo
заброшенных	zabroshennykh		Duolingo
забывает	zabyvaet		Duolingo
забываю	zabyvaiu		Duolingo
забыл	zabyl		Duolingo
забыла	zabyla		Duolingo
забыли	zabyli		Duolingo
забыт	zabyt		Duolingo
забыта	zabyta		Duolingo
забыто	zabyto		Duolingo
завод	zavod		Duolingo
завода	zavoda		Duolingo
заводе	zavode		Duolingo
завтра	zavtra		Duolingo
завтрак	zavtrak		Duolingo
завтракаете	zavtrakaete		Duolingo
завтракал	zavtrakal		Duolingo
завтракать	zavtrakat'		Duolingo
завтракаю	zavtrakaiu		Duolingo
загорает	zagoraet		Duolingo
загорать	zagorat'		Duolingo
задала	zadala		Duolingo
задам	zadam		Duolingo
задание	zadanie		Duolingo
задать	zadat'		Duolingo
задача	zadacha		Duolingo
задачи	zadachi		Duolingo
зайду	zaidu		Duolingo
зайти	zaiti		Duolingo
закажу	zakazhu		Duolingo
заказал	zakazal		Duolingo
заказываем	zakazyvaem		Duolingo
заказывает	zakazyvaet		Duolingo
заказываете	zakazyvaete		Duolingo
заканчивает	zakanchivaet		Duolingo
заключат	zakliuchat		Duolingo
заключили	zakliuchili		Duolingo
заключить	zakliuchit'		Duolingo
закон	zakon		Duolingo
закончить	zakonchit'		Duolingo
законы	zakony		Duolingo
закрой	zakroi		Duolingo
закройте	zakroite		Duolingo
закрывается	zakryvaetsia		Duolingo
закрылась	zakrylas'		Duolingo
закрылся	zakrylsia		Duolingo
закрыт	zakryt		Duolingo
закрыто	zakryto		Duolingo
закрыты	zakryty		Duolingo
зал	zal		Duolingo
зале	zale		Duolingo
замка	zamka		Duolingo
замке	zamke		Duolingo
замок	zamok		Duolingo
замуж	zamuzh		Duolingo
занимает	zanimaet		Duolingo
занимается	zanimaetsia		Duolingo
занимаешься	zanimaesh'sia		Duolingo
занимался	zanimalsia		Duolingo
занимаюсь	zanimaius'		Duolingo
занят	zaniat		Duolingo
занята	zaniata		Duolingo
занятий	zaniatii		Duolingo
заняты	zaniaty		Duolingo
запад	zapad		Duolingo
западе	zapade		Duolingo
западная	zapadnaia		Duolingo
западной	zapadnoi		Duolingo
западную	zapadnuiu		Duolingo
записал	zapisal		Duolingo
записала	zapisala		Duolingo
записали	zapisali		Duolingo
записывает	zapisyvaet		Duolingo
записываете	zapisyvaete		Duolingo
записываешь	zapisyvaesh'		Duolingo
записываю	zapisyvaiu		Duolingo
заплатившая	zaplativshaia		Duolingo
заплатившего	zaplativshego		Duolingo
заплативший	zaplativshii		Duolingo
заплатил	zaplatil		Duolingo
заплатить	zaplatit'		Duolingo
запомнил	zapomnil		Duolingo
запомнили	zapomnili		Duolingo
запомнит	zapomnit		Duolingo
запомню	zapomniu		Duolingo
запускать	zapuskat'		Duolingo
запусти	zapusti		Duolingo
запустил	zapustil		Duolingo
зарплата	zarplata		Duolingo
зато	zato		Duolingo
зачем	zachem		Duolingo
зашла	zashla		Duolingo
защищает	zashchishchaet		Duolingo
защищали	zashchishchali		Duolingo
защищать	zashchishchat'		Duolingo
заявил	zaiavil		Duolingo
звезда	zvezda		Duolingo
звезду	zvezdu		Duolingo
звёзды	zvezdy		Duolingo
звонил	zvonil		Duolingo
звонила	zvonila		Duolingo
звонит	zvonit		Duolingo
здание	zdanie		Duolingo
здании	zdanii		Duolingo
зданию	zdaniiu		Duolingo
здесь	zdes'		Duolingo
здоров	zdorov		Duolingo
здорова	zdorova		Duolingo
здоровую	zdorovuiu		Duolingo
здоровы	zdorovy		Duolingo
здоровые	zdorovye		Duolingo
здоровый	zdorovyi		Duolingo
здравствуй	zdravstvui		Duolingo
здравствуйте	zdravstvuite		Duolingo
зелёной	zelenoi		Duolingo
зелёные	zelenye		Duolingo
зелёный	zelenyi		Duolingo
зелёным	zelenym		Duolingo
земле	zemle		Duolingo
земля	zemlia		Duolingo
зеркале	zerkale		Duolingo
зеркало	zerkalo		Duolingo
зима	zima		Duolingo
зиме	zime		Duolingo
зимнее	zimnee		Duolingo
зимние	zimnie		Duolingo
зимний	zimnii		Duolingo
зимняя	zimniaia		Duolingo
зимой	zimoi		Duolingo
зиму	zimu		Duolingo
зимы	zimy		Duolingo
злое	zloe		Duolingo
злой	zloi		Duolingo
змеи	zmei		Duolingo
змею	zmeiu		Duolingo
знает	znaet		Duolingo
знаете	znaete		Duolingo
знаешь	znaesh'		Duolingo
знакомую	znakomuiu		Duolingo
знакомый	znakomyi		Duolingo
знал	znal		Duolingo
знала	znala		Duolingo
знали	znali		Duolingo
знаменитый	znamenityi		Duolingo
знаменитым	znamenitym		Duolingo
знаменитых	znamenitykh		Duolingo
знать	znat'		Duolingo
значит	znachit		Duolingo
знаю	znaiu		Duolingo
зная	znaia		Duolingo
зовут	zovut		Duolingo
золотое	zolotoe		Duolingo
золотой	zolotoi		Duolingo
зонт	zont		Duolingo
зонта	zonta		Duolingo
зонты	zonty		Duolingo
зоопарк	zoopark		Duolingo
зоопарка	zooparka		Duolingo
зоопарке	zooparke		Duolingo
зрители	zriteli		Duolingo
зрителю	zriteliu		Duolingo
и	i		Duolingo
и так	i tak		Duolingo
иван	ivan		Duolingo
иванович	ivanovich		Duolingo
ивановна	ivanovna		Duolingo
игра	igra		Duolingo
играет	igraet		Duolingo
играй	igrai		Duolingo
играйте	igraite		Duolingo
играл	igral		Duolingo
играла	igrala		Duolingo
играли	igrali		Duolingo
играть	igrat'		Duolingo
играю	igraiu		Duolingo
играют	igraiut		Duolingo
играющая	igraiushchaia		Duolingo
играющий	igraiushchii		Duolingo
играющих	igraiushchikh		Duolingo
играющую	igraiushchuiu		Duolingo
игру	igru		Duolingo
игры	igry		Duolingo
идём	idem		Duolingo
идёт	idet		Duolingo
идёте	idete		Duolingo
идёшь	idesh'		Duolingo
иди	idi		Duolingo
идите	idite		Duolingo
идти	idti		Duolingo
иду	idu		Duolingo
идут	idut		Duolingo
из	iz		Duolingo
из-за	iz-za		Duolingo
известная	izvestnaia		Duolingo
известно	izvestno		Duolingo
известный	izvestnyi		Duolingo
извини	izvini		Duolingo
извините	izvinite		Duolingo
измерить	izmerit'		Duolingo
изучает	izuchaet		Duolingo
изучаете	izuchaete		Duolingo
изучал	izuchal		Duolingo
изучала	izuchala		Duolingo
изучать	izuchat'		Duolingo
изучаю	izuchaiu		Duolingo
изучен	izuchen		Duolingo
изучено	izucheno		Duolingo
или	ili		Duolingo
им	im		Duolingo
имеет	imeet		Duolingo
имеете	imeete		Duolingo
имел	imel		Duolingo
имена	imena		Duolingo
имени	imeni		Duolingo
имею	imeiu		Duolingo
имя	imia		Duolingo
инженер	inzhener		Duolingo
инженером	inzhenerom		Duolingo
инженеры	inzhenery		Duolingo
иногда	inogda		Duolingo
иностранец	inostranets		Duolingo
иностранные	inostrannye		Duolingo
иностранный	inostrannyi		Duolingo
иностранных	inostrannykh		Duolingo
иностранцев	inostrantsev		Duolingo
инструмент	instrument		Duolingo
инструментах	instrumentakh		Duolingo
инструменте	instrumente		Duolingo
интересная	interesnaia		Duolingo
интереснее	interesnee		Duolingo
интересно	interesno		Duolingo
интересные	interesnye		Duolingo
интересный	interesnyi		Duolingo
интересных	interesnykh		Duolingo
интересовалась	interesovalas'		Duolingo
интересуетесь	interesuetes'		Duolingo
интересуется	interesuetsia		Duolingo
интересуюсь	interesuius'		Duolingo
интернет	internet		Duolingo
интернете	internete		Duolingo
ирина	irina		Duolingo
искусство	iskusstvo		Duolingo
искусством	iskusstvom		Duolingo
испанец	ispanets		Duolingo
испании	ispanii		Duolingo
испанию	ispaniiu		Duolingo
испания	ispaniia		Duolingo
испанка	ispanka		Duolingo
испанский	ispanskii		Duolingo
испанского	ispanskogo		Duolingo
испанском	ispanskom		Duolingo
испанскую	ispanskuiu		Duolingo
испанцев	ispantsev		Duolingo
использовала	ispol'zovala		Duolingo
использовались	ispol'zovalis'		Duolingo
использовать	ispol'zovat'		Duolingo
используете	ispol'zuete		Duolingo
используется	ispol'zuetsia		Duolingo
используй	ispol'zui		Duolingo
истории	istorii		Duolingo
историк	istorik		Duolingo
историки	istoriki		Duolingo
историком	istorikom		Duolingo
история	istoriia		Duolingo
италией	italiei		Duolingo
италии	italii		Duolingo
италия	italiia		Duolingo
итальянец	ital'ianets		Duolingo
итальянка	ital'ianka		Duolingo
итальянские	ital'ianskie		Duolingo
итальянский	ital'ianskii		Duolingo
итальянское	ital'ianskoe		Duolingo
их	ikh		Duolingo
ищем	ishchem		Duolingo
ищет	ishchet		Duolingo
ищу	ishchu		Duolingo
ищут	ishchut		Duolingo
июле	iiule		Duolingo
июль	iiul'		Duolingo
июля	iiulia		Duolingo
июне	iiune		Duolingo
июнь	iiun'		Duolingo
июня	iiunia		Duolingo
к	k		Duolingo
к сожалению	k sozhaleniiu		Duolingo
кабинет	kabinet		Duolingo
кабинетов	kabinetov		Duolingo
каждое	kazhdoe		Duolingo
каждой	kazhdoi		Duolingo
каждый	kazhdyi		Duolingo
кажется	kazhetsia		Duolingo
казань	kazan'		Duolingo
казахстан	kazakhstan		Duolingo
казахстана	kazakhstana		Duolingo
казахстане	kazakhstane		Duolingo
как	kak		Duolingo
как раз	kak raz		Duolingo
какао	kakao		Duolingo
какая	kakaia		Duolingo
какая-нибудь	kakaia-nibud'		Duolingo
какие	kakie		Duolingo
какова	kakova		Duolingo
каковы	kakovy		Duolingo
какого-нибудь	kakogo-nibud'		Duolingo
какой	kakoi		Duolingo
какой-нибудь	kakoi-nibud'		Duolingo
календари	kalendari		Duolingo
календарь	kalendar'		Duolingo
каменное	kamennoe		Duolingo
каменном	kamennom		Duolingo
каменный	kamennyi		Duolingo
камень	kamen'		Duolingo
камня	kamnia		Duolingo
канада	kanada		Duolingo
канаде	kanade		Duolingo
канаду	kanadu		Duolingo
канады	kanady		Duolingo
канал	kanal		Duolingo
канале	kanale		Duolingo
каналов	kanalov		Duolingo
кандидат	kandidat		Duolingo
кандидата	kandidata		Duolingo
каникул	kanikul		Duolingo
каникулы	kanikuly		Duolingo
карандаш	karandash		Duolingo
карандаша	karandasha		Duolingo
карандашей	karandashei		Duolingo
карандаши	karandashi		Duolingo
карандашом	karandashom		Duolingo
карта	karta		Duolingo
карте	karte		Duolingo
картина	kartina		Duolingo
картине	kartine		Duolingo
картинка	kartinka		Duolingo
картинку	kartinku		Duolingo
картинок	kartinok		Duolingo
картошка	kartoshka		Duolingo
картошки	kartoshki		Duolingo
картошкой	kartoshkoi		Duolingo
картошку	kartoshku		Duolingo
карту	kartu		Duolingo
кастрюлю	kastriuliu		Duolingo
кастрюля	kastriulia		Duolingo
катаемся	kataemsia		Duolingo
катается	kataetsia		Duolingo
кататься	katat'sia		Duolingo
катаюсь	kataius'		Duolingo
кафе	kafe		Duolingo
качество	kachestvo		Duolingo
каша	kasha		Duolingo
кашу	kashu		Duolingo
квартира	kvartira		Duolingo
квартире	kvartire		Duolingo
квартиру	kvartiru		Duolingo
кем	kem		Duolingo
кем-то	kem-to		Duolingo
киев	kiev		Duolingo
киева	kieva		Duolingo
киеве	kieve		Duolingo
килограмм	kilogramm		Duolingo
килограмма	kilogramma		Duolingo
километр	kilometr		Duolingo
километра	kilometra		Duolingo
километров	kilometrov		Duolingo
кино	kino		Duolingo
кинотеатр	kinoteatr		Duolingo
кинотеатрах	kinoteatrakh		Duolingo
киоск	kiosk		Duolingo
киоске	kioske		Duolingo
кислород	kislorod		Duolingo
кислорода	kisloroda		Duolingo
китае	kitae		Duolingo
китаец	kitaets		Duolingo
китай	kitai		Duolingo
китайская	kitaiskaia		Duolingo
китайский	kitaiskii		Duolingo
китайскому	kitaiskomu		Duolingo
китайцев	kitaitsev		Duolingo
китая	kitaia		Duolingo
клавиатура	klaviatura		Duolingo
клавиатуре	klaviature		Duolingo
клавиатуру	klaviaturu		Duolingo
клавиш	klavish		Duolingo
клавиша	klavisha		Duolingo
клавишу	klavishu		Duolingo
кладу	kladu		Duolingo
клал	klal		Duolingo
клала	klala		Duolingo
класс	klass		Duolingo
классе	klasse		Duolingo
классическая	klassicheskaia		Duolingo
классической	klassicheskoi		Duolingo
классом	klassom		Duolingo
клетка	kletka		Duolingo
клетки	kletki		Duolingo
клеток	kletok		Duolingo
клуб	klub		Duolingo
клуба	kluba		Duolingo
клубе	klube		Duolingo
ключ	kliuch		Duolingo
ключи	kliuchi		Duolingo
книг	knig		Duolingo
книга	kniga		Duolingo
книги	knigi		Duolingo
книгу	knigu		Duolingo
книжный	knizhnyi		Duolingo
кнопку	knopku		Duolingo
ковёр	kover		Duolingo
ковра	kovra		Duolingo
ковром	kovrom		Duolingo
когда	kogda		Duolingo
когда-нибудь	kogda-nibud'		Duolingo
кого	kogo		Duolingo
кого-нибудь	kogo-nibud'		Duolingo
кого-то	kogo-to		Duolingo
колец	kolets		Duolingo
коллега	kollega		Duolingo
коллеги	kollegi		Duolingo
колледж	kolledzh		Duolingo
колледже	kolledzhe		Duolingo
колумбии	kolumbii		Duolingo
колумбия	kolumbiia		Duolingo
кольца	kol'tsa		Duolingo
кольцо	kol'tso		Duolingo
ком	kom		Duolingo
команда	komanda		Duolingo
команде	komande		Duolingo
комедии	komedii		Duolingo
комедию	komediiu		Duolingo
комедия	komediia		Duolingo
комната	komnata		Duolingo
комнате	komnate		Duolingo
комнату	komnatu		Duolingo
комнаты	komnaty		Duolingo
компании	kompanii		Duolingo
компания	kompaniia		Duolingo
композитор	kompozitor		Duolingo
компьютер	komp'iuter		Duolingo
компьютере	komp'iutere		Duolingo
компьютеры	komp'iutery		Duolingo
кому	komu		Duolingo
конверт	konvert		Duolingo
конверте	konverte		Duolingo
конвертов	konvertov		Duolingo
конец	konets		Duolingo
конечно	konechno		Duolingo
контрольная	kontrol'naia		Duolingo
контрольную	kontrol'nuiu		Duolingo
конфет	konfet		Duolingo
конфеты	konfety		Duolingo
конце	kontse		Duolingo
концерт	kontsert		Duolingo
концерте	kontserte		Duolingo
концерты	kontserty		Duolingo
коньках	kon'kakh		Duolingo
коньки	kon'ki		Duolingo
копьё	kop'e		Duolingo
корабль	korabl'		Duolingo
корабля	korablia		Duolingo
кораблях	korabliakh		Duolingo
коридор	koridor		Duolingo
коридора	koridora		Duolingo
коробка	korobka		Duolingo
коробке	korobke		Duolingo
коробку	korobku		Duolingo
коробок	korobok		Duolingo
королева	koroleva		Duolingo
королеве	koroleve		Duolingo
королевой	korolevoi		Duolingo
королевы	korolevy		Duolingo
король	korol'		Duolingo
короткая	korotkaia		Duolingo
короткий	korotkii		Duolingo
костюм	kostium		Duolingo
кот	kot		Duolingo
которое	kotoroe		Duolingo
котором	kotorom		Duolingo
который	kotoryi		Duolingo
кофе	kofe		Duolingo
кофточка	koftochka		Duolingo
кофточке	koftochke		Duolingo
кошек	koshek		Duolingo
кошка	koshka		Duolingo
кошке	koshke		Duolingo
кошки	koshki		Duolingo
кошку	koshku		Duolingo
красивая	krasivaia		Duolingo
красивый	krasivyi		Duolingo
красная	krasnaia		Duolingo
красного	krasnogo		Duolingo
красное	krasnoe		Duolingo
красной	krasnoi		Duolingo
красную	krasnuiu		Duolingo
красные	krasnye		Duolingo
красный	krasnyi		Duolingo
красных	krasnykh		Duolingo
крепость	krepost'		Duolingo
кресла	kresla		Duolingo
кресло	kreslo		Duolingo
кристалл	kristall		Duolingo
кристаллов	kristallov		Duolingo
критиковал	kritikoval		Duolingo
критиковали	kritikovali		Duolingo
критиковать	kritikovat'		Duolingo
критикует	kritikuet		Duolingo
кроватей	krovatei		Duolingo
кровати	krovati		Duolingo
кровать	krovat'		Duolingo
кроватью	krovat'iu		Duolingo
кровь	krov'		Duolingo
кроме	krome		Duolingo
кружек	kruzhek		Duolingo
кружка	kruzhka		Duolingo
кружки	kruzhki		Duolingo
круто	kruto		Duolingo
крыша	krysha		Duolingo
крыше	kryshe		Duolingo
крышу	kryshu		Duolingo
кстати	kstati		Duolingo
кто	kto		Duolingo
кто-нибудь	kto-nibud'		Duolingo
кто-то	kto-to		Duolingo
куда	kuda		Duolingo
купи	kupi		Duolingo
купил	kupil		Duolingo
купила	kupila		Duolingo
купили	kupili		Duolingo
купим	kupim		Duolingo
купить	kupit'		Duolingo
куплю	kupliu		Duolingo
курил	kuril		Duolingo
курили	kurili		Duolingo
курит	kurit		Duolingo
курите	kurite		Duolingo
курить	kurit'		Duolingo
курица	kuritsa		Duolingo
курицу	kuritsu		Duolingo
курсы	kursy		Duolingo
куртка	kurtka		Duolingo
куртку	kurtku		Duolingo
курю	kuriu		Duolingo
куска	kuska		Duolingo
кусков	kuskov		Duolingo
кусок	kusok		Duolingo
кухне	kukhne		Duolingo
кухни	kukhni		Duolingo
кухня	kukhnia		Duolingo
куча	kucha		Duolingo
кучу	kuchu		Duolingo
лаборатории	laboratorii		Duolingo
лаборатория	laboratoriia		Duolingo
лампа	lampa		Duolingo
лампой	lampoi		Duolingo
лампы	lampy		Duolingo
лев	lev		Duolingo
левая	levaia		Duolingo
левой	levoi		Duolingo
лёг	leg		Duolingo
лёгкий	legkii		Duolingo
легко	legko		Duolingo
легла	legla		Duolingo
лежал	lezhal		Duolingo
лежала	lezhala		Duolingo
лежали	lezhali		Duolingo
лежат	lezhat		Duolingo
лежит	lezhit		Duolingo
лежу	lezhu		Duolingo
лекарств	lekarstv		Duolingo
лекарство	lekarstvo		Duolingo
лекцию	lektsiiu		Duolingo
лекция	lektsiia		Duolingo
лес	les		Duolingo
лестниц	lestnits		Duolingo
лестница	lestnitsa		Duolingo
лестнице	lestnitse		Duolingo
лесу	lesu		Duolingo
лет	let		Duolingo
лета	leta		Duolingo
летали	letali		Duolingo
летать	letat'		Duolingo
летают	letaiut		Duolingo
летел	letel		Duolingo
летит	letit		Duolingo
летнее	letnee		Duolingo
летние	letnie		Duolingo
летний	letnii		Duolingo
лето	leto		Duolingo
летят	letiat		Duolingo
лечу	lechu		Duolingo
лечь	lech'		Duolingo
ли	li		Duolingo
лидер	lider		Duolingo
лимон	limon		Duolingo
лимона	limona		Duolingo
лимонов	limonov		Duolingo
лимоном	limonom		Duolingo
лимоны	limony		Duolingo
лист	list		Duolingo
листа	lista		Duolingo
листов	listov		Duolingo
листы	listy		Duolingo
литература	literatura		Duolingo
литературу	literaturu		Duolingo
лифт	lift		Duolingo
лифта	lifta		Duolingo
лифте	lifte		Duolingo
лица	litsa		Duolingo
лице	litse		Duolingo
лицо	litso		Duolingo
логин	login		Duolingo
ложек	lozhek		Duolingo
ложится	lozhitsia		Duolingo
ложиться	lozhit'sia		Duolingo
ложка	lozhka		Duolingo
ложки	lozhki		Duolingo
ложку	lozhku		Duolingo
ложусь	lozhus'		Duolingo
лондон	london		Duolingo
лондоне	londone		Duolingo
лошадей	loshadei		Duolingo
лошади	loshadi		Duolingo
лошадь	loshad'		Duolingo
лук	luk		Duolingo
лука	luka		Duolingo
луком	lukom		Duolingo
луна	luna		Duolingo
луны	luny		Duolingo
лучшая	luchshaia		Duolingo
лучше	luchshe		Duolingo
лучший	luchshii		Duolingo
лыжах	lyzhakh		Duolingo
лыжи	lyzhi		Duolingo
львы	l'vy		Duolingo
любим	liubim		Duolingo
любимая	liubimaia		Duolingo
любимый	liubimyi		Duolingo
любит	liubit		Duolingo
любите	liubite		Duolingo
любишь	liubish'		Duolingo
люблю	liubliu		Duolingo
любят	liubiat		Duolingo
людей	liudei		Duolingo
люди	liudi		Duolingo
ляг	liag		Duolingo
лягте	liagte		Duolingo
магазин	magazin		Duolingo
магазина	magazina		Duolingo
мае	mae		Duolingo
май	mai		Duolingo
макарон	makaron		Duolingo
макароны	makarony		Duolingo
мала	mala		Duolingo
маленькая	malen'kaia		Duolingo
маленькие	malen'kie		Duolingo
маленький	malen'kii		Duolingo
маленьких	malen'kikh		Duolingo
маленькое	malen'koe		Duolingo
мало	malo		Duolingo
малы	maly		Duolingo
мальчик	mal'chik		Duolingo
мальчика	mal'chika		Duolingo
мальчикам	mal'chikam		Duolingo
мальчиках	mal'chikakh		Duolingo
мальчики	mal'chiki		Duolingo
мальчиков	mal'chikov		Duolingo
мальчиком	mal'chikom		Duolingo
мальчику	mal'chiku		Duolingo
мама	mama		Duolingo
маме	mame		Duolingo
мамой	mamoi		Duolingo
маму	mamu		Duolingo
мамы	mamy		Duolingo
март	mart		Duolingo
марта	marta		Duolingo
масла	masla		Duolingo
масло	maslo		Duolingo
масса	massa		Duolingo
массу	massu		Duolingo
математика	matematika		Duolingo
математике	matematike		Duolingo
математики	matematiki		Duolingo
математику	matematiku		Duolingo
матери	materi		Duolingo
матч	match		Duolingo
матча	matcha		Duolingo
мать	mat'		Duolingo
маша	masha		Duolingo
машин	mashin		Duolingo
машина	mashina		Duolingo
машиной	mashinoi		Duolingo
мая	maia		Duolingo
мебели	mebeli		Duolingo
мебель	mebel'		Duolingo
медведи	medvedi		Duolingo
медведь	medved'		Duolingo
медик	medik		Duolingo
медленная	medlennaia		Duolingo
медленнее	medlennee		Duolingo
медленно	medlenno		Duolingo
медленные	medlennye		Duolingo
между	mezhdu		Duolingo
международная	mezhdunarodnaia		Duolingo
международные	mezhdunarodnye		Duolingo
международный	mezhdunarodnyi		Duolingo
менеджер	menedzher		Duolingo
менеджером	menedzherom		Duolingo
менее	menee		Duolingo
меньше	men'she		Duolingo
меню	meniu		Duolingo
меня	menia		Duolingo
меняется	meniaetsia		Duolingo
меняться	meniat'sia		Duolingo
меняются	meniaiutsia		Duolingo
мест	mest		Duolingo
места	mesta		Duolingo
месте	meste		Duolingo
место	mesto		Duolingo
месяц	mesiats		Duolingo
месяца	mesiatsa		Duolingo
месяцев	mesiatsev		Duolingo
металл	metall		Duolingo
металлов	metallov		Duolingo
металлы	metally		Duolingo
метод	metod		Duolingo
методов	metodov		Duolingo
метр	metr		Duolingo
метра	metra		Duolingo
метро	metro		Duolingo
метров	metrov		Duolingo
меч	mech		Duolingo
мечетей	mechetei		Duolingo
мечеть	mechet'		Duolingo
мечтает	mechtaet		Duolingo
мечтать	mechtat'		Duolingo
микроскоп	mikroskop		Duolingo
микрофон	mikrofon		Duolingo
микрофона	mikrofona		Duolingo
микрофоны	mikrofony		Duolingo
миллион	million		Duolingo
миллиона	milliona		Duolingo
миллионов	millionov		Duolingo
мимо	mimo		Duolingo
министр	ministr		Duolingo
министра	ministra		Duolingo
минус	minus		Duolingo
минут	minut		Duolingo
минута	minuta		Duolingo
минуту	minutu		Duolingo
минуты	minuty		Duolingo
мир	mir		Duolingo
мира	mira		Duolingo
мире	mire		Duolingo
мировая	mirovaia		Duolingo
мировой	mirovoi		Duolingo
миска	miska		Duolingo
младшая	mladshaia		Duolingo
младший	mladshii		Duolingo
млекопитающее	mlekopitaiushchee		Duolingo
млекопитающих	mlekopitaiushchikh		Duolingo
мне	mne		Duolingo
мнение	mnenie		Duolingo
много	mnogo		Duolingo
мной	mnoi		Duolingo
мобильного	mobil'nogo		Duolingo
мобильный	mobil'nyi		Duolingo
мобильных	mobil'nykh		Duolingo
могу	mogu		Duolingo
моё	moe		Duolingo
моего	moego		Duolingo
моей	moei		Duolingo
моет	moet		Duolingo
может	mozhet		Duolingo
может быть	mozhet byt'		Duolingo
можете	mozhete		Duolingo
можешь	mozhesh'		Duolingo
можно	mozhno		Duolingo
мои	moi		Duolingo
моим	moim		Duolingo
моих	moikh		Duolingo
мой	moi		Duolingo
молекул	molekul		Duolingo
молекула	molekula		Duolingo
молекулы	molekuly		Duolingo
молись	molis'		Duolingo
молитесь	molites'		Duolingo
молиться	molit'sia		Duolingo
молодая	molodaia		Duolingo
молодец	molodets		Duolingo
молодой	molodoi		Duolingo
молодцы	molodtsy		Duolingo
молока	moloka		Duolingo
молоко	moloko		Duolingo
монитор	monitor		Duolingo
монитора	monitora		Duolingo
море	more		Duolingo
мороженое	morozhenoe		Duolingo
моря	moria		Duolingo
москва	moskva		Duolingo
москве	moskve		Duolingo
москву	moskvu		Duolingo
москвы	moskvy		Duolingo
мост	most		Duolingo
моста	mosta		Duolingo
мостом	mostom		Duolingo
мосту	mostu		Duolingo
мотор	motor		Duolingo
мотоцикл	mototsikl		Duolingo
мотоцикле	mototsikle		Duolingo
мошенник	moshennik		Duolingo
мошенника	moshennika		Duolingo
мою	moiu		Duolingo
моюсь	moius'		Duolingo
моют	moiut		Duolingo
моя	moia		Duolingo
муж	muzh		Duolingo
мужа	muzha		Duolingo
мужская	muzhskaia		Duolingo
мужской	muzhskoi		Duolingo
мужчина	muzhchina		Duolingo
мужчиной	muzhchinoi		Duolingo
мужчины	muzhchiny		Duolingo
музее	muzee		Duolingo
музей	muzei		Duolingo
музыка	muzyka		Duolingo
музыкальном	muzykal'nom		Duolingo
музыкальный	muzykal'nyi		Duolingo
музыкальных	muzykal'nykh		Duolingo
музыкант	muzykant		Duolingo
музыкантом	muzykantom		Duolingo
мультфильм	mul'tfil'm		Duolingo
мультфильма	mul'tfil'ma		Duolingo
мультфильмы	mul'tfil'my		Duolingo
мусульманин	musul'manin		Duolingo
мусульманка	musul'manka		Duolingo
муха	mukha		Duolingo
мухи	mukhi		Duolingo
мы	my		Duolingo
мыла	myla		Duolingo
мыло	mylo		Duolingo
мылся	mylsia		Duolingo
мыть	myt'		Duolingo
мыться	myt'sia		Duolingo
мышей	myshei		Duolingo
мыши	myshi		Duolingo
мышь	mysh'		Duolingo
мягкая	miagkaia		Duolingo
мягкие	miagkie		Duolingo
мягкий	miagkii		Duolingo
мясо	miaso		Duolingo
мяч	miach		Duolingo
на	na		Duolingo
на свободе	na svobode		Duolingo
наблюдается	nabliudaetsia		Duolingo
над	nad		Duolingo
надеваем	nadevaem		Duolingo
надевает	nadevaet		Duolingo
надеваешь	nadevaesh'		Duolingo
надеваю	nadevaiu		Duolingo
надела	nadela		Duolingo
надень	naden'		Duolingo
наденьте	naden'te		Duolingo
надеть	nadet'		Duolingo
надо	nado		Duolingo
нажал	nazhal		Duolingo
нажала	nazhala		Duolingo
нажать	nazhat'		Duolingo
нажмите	nazhmite		Duolingo
назад	nazad		Duolingo
название	nazvanie		Duolingo
называется	nazyvaetsia		Duolingo
найдём	naidem		Duolingo
найду	naidu		Duolingo
найти	naiti		Duolingo
наконец	nakonets		Duolingo
налево	nalevo		Duolingo
нам	nam		Duolingo
нами	nami		Duolingo
напечатай	napechatai		Duolingo
напечатайте	napechataite		Duolingo
напечатала	napechatala		Duolingo
напечатать	napechatat'		Duolingo
написав	napisav		Duolingo
написавшего	napisavshego		Duolingo
написавший	napisavshii		Duolingo
написал	napisal		Duolingo
написала	napisala		Duolingo
написали	napisali		Duolingo
написан	napisan		Duolingo
написана	napisana		Duolingo
написанная	napisannaia		Duolingo
написанное	napisannoe		Duolingo
написанные	napisannye		Duolingo
написано	napisano		Duolingo
написать	napisat'		Duolingo
напишет	napishet		Duolingo
напиши	napishi		Duolingo
напишите	napishite		Duolingo
напишу	napishu		Duolingo
напишут	napishut		Duolingo
направо	napravo		Duolingo
нарезать	narezat'		Duolingo
нарисовал	narisoval		Duolingo
нарисовала	narisovala		Duolingo
нарисуем	narisuem		Duolingo
нарисует	narisuet		Duolingo
нарисуешь	narisuesh'		Duolingo
нарисуй	narisui		Duolingo
нарисуйте	narisuite		Duolingo
нарисую	narisuiu		Duolingo
народу	narodu		Duolingo
нас	nas		Duolingo
население	naselenie		Duolingo
настоящая	nastoiashchaia		Duolingo
настоящего	nastoiashchego		Duolingo
настоящие	nastoiashchie		Duolingo
настоящий	nastoiashchii		Duolingo
настройки	nastroiki		Duolingo
наука	nauka		Duolingo
науке	nauke		Duolingo
наукой	naukoi		Duolingo
научилась	nauchilas'		Duolingo
научились	nauchilis'		Duolingo
научился	nauchilsia		Duolingo
научится	nauchitsia		Duolingo
научиться	nauchit'sia		Duolingo
научишься	nauchish'sia		Duolingo
научусь	nauchus'		Duolingo
наушники	naushniki		Duolingo
находимся	nakhodimsia		Duolingo
находитесь	nakhodites'		Duolingo
находится	nakhoditsia		Duolingo
находятся	nakhodiatsia		Duolingo
начал	nachal		Duolingo
начала	nachala		Duolingo
началась	nachalas'		Duolingo
начале	nachale		Duolingo
начали	nachali		Duolingo
начало	nachalo		Duolingo
начальник	nachal'nik		Duolingo
начальника	nachal'nika		Duolingo
начинается	nachinaetsia		Duolingo
начинаются	nachinaiutsia		Duolingo
начнём	nachnem		Duolingo
начнёт	nachnet		Duolingo
начнётся	nachnetsia		Duolingo
начну	nachnu		Duolingo
наш	nash		Duolingo
наша	nasha		Duolingo
наше	nashe		Duolingo
нашего	nashego		Duolingo
нашей	nashei		Duolingo
нашёл	nashel		Duolingo
нашем	nashem		Duolingo
наши	nashi		Duolingo
нашла	nashla		Duolingo
нашу	nashu		Duolingo
не	ne		Duolingo
не о чем	ne o chem		Duolingo
не подумав	ne podumav		Duolingo
не с кем	ne s kem		Duolingo
небе	nebe		Duolingo
небо	nebo		Duolingo
неверно	neverno		Duolingo
неверный	nevernyi		Duolingo
негде	negde		Duolingo
него	nego		Duolingo
недель	nedel'		Duolingo
неделя	nedelia		Duolingo
недостаточно	nedostatochno		Duolingo
неё	nee		Duolingo
незачем	nezachem		Duolingo
неизвестно	neizvestno		Duolingo
ней	nei		Duolingo
некогда	nekogda		Duolingo
некого	nekogo		Duolingo
некому	nekomu		Duolingo
некуда	nekuda		Duolingo
нельзя	nel'zia		Duolingo
нём	nem		Duolingo
немец	nemets		Duolingo
немецки	nemetski		Duolingo
немецкий	nemetskii		Duolingo
немка	nemka		Duolingo
немного	nemnogo		Duolingo
непонятно	neponiatno		Duolingo
неправильно	nepravil'no		Duolingo
неправильный	nepravil'nyi		Duolingo
несколько	neskol'ko		Duolingo
несмотря на	nesmotria na		Duolingo
нет	net		Duolingo
нету	netu		Duolingo
неудивительно	neudivitel'no		Duolingo
неудобный	neudobnyi		Duolingo
нечего	nechego		Duolingo
ни	ni		Duolingo
нигде	nigde		Duolingo
низ	niz		Duolingo
никогда	nikogda		Duolingo
никому	nikomu		Duolingo
никто	nikto		Duolingo
ним	nim		Duolingo
ними	nimi		Duolingo
них	nikh		Duolingo
ничего	nichego		Duolingo
но	no		Duolingo
новая	novaia		Duolingo
нового	novogo		Duolingo
новой	novoi		Duolingo
новость	novost'		Duolingo
новую	novuiu		Duolingo
новый	novyi		Duolingo
ног	nog		Duolingo
нога	noga		Duolingo
ноги	nogi		Duolingo
нож	nozh		Duolingo
ножей	nozhei		Duolingo
ножи	nozhi		Duolingo
нормальная	normal'naia		Duolingo
нормальные	normal'nye		Duolingo
нормальный	normal'nyi		Duolingo
нос	nos		Duolingo
носы	nosy		Duolingo
ночи	nochi		Duolingo
ночь	noch'		Duolingo
ночью	noch'iu		Duolingo
ноябрь	noiabr'		Duolingo
ноября	noiabria		Duolingo
нравится	nravitsia		Duolingo
нравятся	nraviatsia		Duolingo
нужен	nuzhen		Duolingo
нужна	nuzhna		Duolingo
нужно	nuzhno		Duolingo
нужны	nuzhny		Duolingo
о	o		Duolingo
об	ob		Duolingo
оба	oba		Duolingo
обе	obe		Duolingo
обед	obed		Duolingo
обедать	obedat'		Duolingo
обо	obo		Duolingo
обсудили	obsudili		Duolingo
обсудить	obsudit'		Duolingo
обсуждаем	obsuzhdaem		Duolingo
обсуждаете	obsuzhdaete		Duolingo
обсуждать	obsuzhdat'		Duolingo
обсуждают	obsuzhdaiut		Duolingo
обуви	obuvi		Duolingo
обувь	obuv'		Duolingo
общая	obshchaia		Duolingo
общее	obshchee		Duolingo
общественного	obshchestvennogo		Duolingo
общественный	obshchestvennyi		Duolingo
общий	obshchii		Duolingo
объясни	ob'iasni		Duolingo
объяснил	ob'iasnil		Duolingo
объяснит	ob'iasnit		Duolingo
объясните	ob'iasnite		Duolingo
объяснить	ob'iasnit'		Duolingo
объясняет	ob'iasniaet		Duolingo
объясняется	ob'iasniaetsia		Duolingo
объяснял	ob'iasnial		Duolingo
объясняла	ob'iasniala		Duolingo
объяснять	ob'iasniat'		Duolingo
объясняю	ob'iasniaiu		Duolingo
объясняются	ob'iasniaiutsia		Duolingo
обычно	obychno		Duolingo
обычного	obychnogo		Duolingo
обычный	obychnyi		Duolingo
овощи	ovoshchi		Duolingo
огромная	ogromnaia		Duolingo
огромный	ogromnyi		Duolingo
огурец	ogurets		Duolingo
огурца	ogurtsa		Duolingo
огурцы	ogurtsy		Duolingo
одеваемся	odevaemsia		Duolingo
одевается	odevaetsia		Duolingo
одеваешься	odevaesh'sia		Duolingo
одевалась	odevalas'		Duolingo
одеваюсь	odevaius'		Duolingo
одевшись	odevshis'		Duolingo
одежда	odezhda		Duolingo
одежду	odezhdu		Duolingo
один	odin		Duolingo
один и тот же	odin i tot zhe		Duolingo
одинаковые	odinakovye		Duolingo
одинаковый	odinakovyi		Duolingo
одинаковых	odinakovykh		Duolingo
одиннадцатое	odinnadtsatoe		Duolingo
одиннадцатый	odinnadtsatyi		Duolingo
одиннадцать	odinnadtsat'		Duolingo
одна	odna		Duolingo
одно	odno		Duolingo
одного и того же	odnogo i togo zhe		Duolingo
одном и том же	odnom i tom zhe		Duolingo
озёра	ozera		Duolingo
озере	ozere		Duolingo
озеро	ozero		Duolingo
оказалась	okazalas'		Duolingo
оказались	okazalis'		Duolingo
оказалось	okazalos'		Duolingo
окна	okna		Duolingo
окно	okno		Duolingo
окном	oknom		Duolingo
около	okolo		Duolingo
окончил	okonchil		Duolingo
окончила	okonchila		Duolingo
окончили	okonchili		Duolingo
октябре	oktiabre		Duolingo
октябрь	oktiabr'		Duolingo
он	on		Duolingo
она	ona		Duolingo
они	oni		Duolingo
опаздывает	opazdyvaet		Duolingo
опаздываешь	opazdyvaesh'		Duolingo
опаздывал	opazdyval		Duolingo
опаздывала	opazdyvala		Duolingo
опаздываю	opazdyvaiu		Duolingo
опера	opera		Duolingo
опере	opere		Duolingo
оперой	operoi		Duolingo
оперы	opery		Duolingo
описана	opisana		Duolingo
описывает	opisyvaet		Duolingo
опоздал	opozdal		Duolingo
опоздала	opozdala		Duolingo
оппозиции	oppozitsii		Duolingo
опыт	opyt		Duolingo
опыта	opyta		Duolingo
опять	opiat'		Duolingo
организовала	organizovala		Duolingo
организовали	organizovali		Duolingo
оркестр	orkestr		Duolingo
оркестром	orkestrom		Duolingo
оружие	oruzhie		Duolingo
осени	oseni		Duolingo
осенние	osennie		Duolingo
осенних	osennikh		Duolingo
осень	osen'		Duolingo
осенью	osen'iu		Duolingo
осматривает	osmatrivaet		Duolingo
осматривал	osmatrival		Duolingo
осматривали	osmatrivali		Duolingo
осматривают	osmatrivaiut		Duolingo
осмотреть	osmotret'		Duolingo
осталась	ostalas'		Duolingo
осталось	ostalos'		Duolingo
остался	ostalsia		Duolingo
остановилась	ostanovilas'		Duolingo
остановилось	ostanovilos'		Duolingo
остановился	ostanovilsia		Duolingo
остановиться	ostanovit'sia		Duolingo
остановка	ostanovka		Duolingo
остановки	ostanovki		Duolingo
от	ot		Duolingo
ответ	otvet		Duolingo
ответа	otveta		Duolingo
ответил	otvetil		Duolingo
ответила	otvetila		Duolingo
ответили	otvetili		Duolingo
ответить	otvetit'		Duolingo
ответы	otvety		Duolingo
отвечаем	otvechaem		Duolingo
отвечает	otvechaet		Duolingo
отвечаю	otvechaiu		Duolingo
отдела	otdela		Duolingo
отделе	otdele		Duolingo
отдохнули	otdokhnuli		Duolingo
отдохнуть	otdokhnut'		Duolingo
отдыхаем	otdykhaem		Duolingo
отдыхает	otdykhaet		Duolingo
отдыхать	otdykhat'		Duolingo
отдыхаю	otdykhaiu		Duolingo
отец	otets		Duolingo
открой	otkroi		Duolingo
откройте	otkroite		Duolingo
открываем	otkryvaem		Duolingo
открывает	otkryvaet		Duolingo
открывается	otkryvaetsia		Duolingo
открываю	otkryvaiu		Duolingo
открыл	otkryl		Duolingo
открылась	otkrylas'		Duolingo
открыли	otkryli		Duolingo
открылось	otkrylos'		Duolingo
открылся	otkrylsia		Duolingo
открыт	otkryt		Duolingo
открыта	otkryta		Duolingo
открыто	otkryto		Duolingo
открыть	otkryt'		Duolingo
откуда	otkuda		Duolingo
отличается	otlichaetsia		Duolingo
отличаются	otlichaiutsia		Duolingo
отлично	otlichno		Duolingo
отличное	otlichnoe		Duolingo
отличный	otlichnyi		Duolingo
отойди	otoidi		Duolingo
отойдите	otoidite		Duolingo
отправил	otpravil		Duolingo
отправила	otpravila		Duolingo
отправить	otpravit'		Duolingo
отпуск	otpusk		Duolingo
отпуска	otpuska		Duolingo
отпуске	otpuske		Duolingo
отрежь	otrezh'		Duolingo
отрезала	otrezala		Duolingo
отца	ottsa		Duolingo
отце	ottse		Duolingo
отцы	ottsy		Duolingo
офис	ofis		Duolingo
офиса	ofisa		Duolingo
офисе	ofise		Duolingo
офисы	ofisy		Duolingo
официант	ofitsiant		Duolingo
официанткой	ofitsiantkoi		Duolingo
официантом	ofitsiantom		Duolingo
очень	ochen'		Duolingo
очки	ochki		Duolingo
очков	ochkov		Duolingo
ошибка	oshibka		Duolingo
ошибку	oshibku		Duolingo
ошибок	oshibok		Duolingo
пакет	paket		Duolingo
палец	palets		Duolingo
пальто	pal'to		Duolingo
пальцев	pal'tsev		Duolingo
памятник	pamiatnik		Duolingo
памятнику	pamiatniku		Duolingo
память	pamiat'		Duolingo
папа	papa		Duolingo
папе	pape		Duolingo
папой	papoi		Duolingo
папу	papu		Duolingo
папы	papy		Duolingo
парень	paren'		Duolingo
парк	park		Duolingo
парка	parka		Duolingo
парке	parke		Duolingo
парки	parki		Duolingo
парку	parku		Duolingo
парламент	parlament		Duolingo
парламента	parlamenta		Duolingo
пароль	parol'		Duolingo
партии	partii		Duolingo
партий	partii		Duolingo
партия	partiia		Duolingo
партнёр	partner		Duolingo
партнёром	partnerom		Duolingo
пациент	patsient		Duolingo
пациента	patsienta		Duolingo
пациентов	patsientov		Duolingo
пей	pei		Duolingo
пейте	peite		Duolingo
пел	pel		Duolingo
пела	pela		Duolingo
пели	peli		Duolingo
пельмени	pel'meni		Duolingo
первом	pervom		Duolingo
первый	pervyi		Duolingo
перевод	perevod		Duolingo
переводим	perevodim		Duolingo
переводит	perevodit		Duolingo
переводом	perevodom		Duolingo
переводчик	perevodchik		Duolingo
переводчика	perevodchika		Duolingo
переводчиком	perevodchikom		Duolingo
переводы	perevody		Duolingo
перевожу	perevozhu		Duolingo
перед	pered		Duolingo
передай	peredai		Duolingo
передайте	peredaite		Duolingo
передача	peredacha		Duolingo
передачу	peredachu		Duolingo
передумаем	peredumaem		Duolingo
передумаешь	peredumaesh'		Duolingo
передумал	peredumal		Duolingo
передумала	peredumala		Duolingo
переедем	pereedem		Duolingo
перееду	pereedu		Duolingo
переехала	pereekhala		Duolingo
переехали	pereekhali		Duolingo
перезвонил	perezvonil		Duolingo
перезвоните	perezvonite		Duolingo
перезвоню	perezvoniu		Duolingo
переоделась	pereodelas'		Duolingo
переодеться	pereodet'sia		Duolingo
перестал	perestal		Duolingo
перестала	perestala		Duolingo
перестали	perestali		Duolingo
перестань	perestan'		Duolingo
переходите	perekhodite		Duolingo
переходишь	perekhodish'		Duolingo
перехожу	perekhozhu		Duolingo
перец	perets		Duolingo
перца	pertsa		Duolingo
песен	pesen		Duolingo
песни	pesni		Duolingo
песню	pesniu		Duolingo
песня	pesnia		Duolingo
петербург	peterburg		Duolingo
петербурга	peterburga		Duolingo
петербурге	peterburge		Duolingo
печенье	pechen'e		Duolingo
печенья	pechen'ia		Duolingo
пешком	peshkom		Duolingo
пианино	pianino		Duolingo
пианист	pianist		Duolingo
пианиста	pianista		Duolingo
пива	piva		Duolingo
пиво	pivo		Duolingo
писал	pisal		Duolingo
писала	pisala		Duolingo
писатель	pisatel'		Duolingo
писателю	pisateliu		Duolingo
писателя	pisatelia		Duolingo
писать	pisat'		Duolingo
письма	pis'ma		Duolingo
письмо	pis'mo		Duolingo
пить	pit'		Duolingo
пицца	pitstsa		Duolingo
пишет	pishet		Duolingo
пишешь	pishesh'		Duolingo
пиши	pishi		Duolingo
пишите	pishite		Duolingo
пишу	pishu		Duolingo
пишущая	pishushchaia		Duolingo
пишущий	pishushchii		Duolingo
плаваем	plavaem		Duolingo
плаваете	plavaete		Duolingo
плавай	plavai		Duolingo
плавайте	plavaite		Duolingo
плавать	plavat'		Duolingo
план	plan		Duolingo
планета	planeta		Duolingo
планеты	planety		Duolingo
планов	planov		Duolingo
плану	planu		Duolingo
планы	plany		Duolingo
платить	platit'		Duolingo
платье	plat'e		Duolingo
плеер	pleer		Duolingo
плеера	pleera		Duolingo
плееры	pleery		Duolingo
плите	plite		Duolingo
плиту	plitu		Duolingo
плохая	plokhaia		Duolingo
плохие	plokhie		Duolingo
плохо	plokho		Duolingo
плохой	plokhoi		Duolingo
плохую	plokhuiu		Duolingo
площади	ploshchadi		Duolingo
площадь	ploshchad'		Duolingo
площадью	ploshchad'iu		Duolingo
плывёт	plyvet		Duolingo
плыву	plyvu		Duolingo
плывут	plyvut		Duolingo
плыла	plyla		Duolingo
плюс	plius		Duolingo
пляж	pliazh		Duolingo
пляже	pliazhe		Duolingo
по	po		Duolingo
по мнению	po mneniiu		Duolingo
по словам	po slovam		Duolingo
по-вашему	po-vashemu		Duolingo
по-моему	po-moemu		Duolingo
по-твоему	po-tvoemu		Duolingo
победила	pobedila		Duolingo
победит	pobedit		Duolingo
победить	pobedit'		Duolingo
побежал	pobezhal		Duolingo
побежала	pobezhala		Duolingo
побежали	pobezhali		Duolingo
поблагодарил	poblagodaril		Duolingo
поблагодарили	poblagodarili		Duolingo
поблагодарить	poblagodarit'		Duolingo
побольше	pobol'she		Duolingo
повар	povar		Duolingo
повара	povara		Duolingo
повернул	povernul		Duolingo
повернула	povernula		Duolingo
повернули	povernuli		Duolingo
повернуть	povernut'		Duolingo
повесил	povesil		Duolingo
повесили	povesili		Duolingo
повесить	povesit'		Duolingo
повесь	poves'		Duolingo
повтори	povtori		Duolingo
повторите	povtorite		Duolingo
повторить	povtorit'		Duolingo
поговори	pogovori		Duolingo
поговорим	pogovorim		Duolingo
поговорит	pogovorit		Duolingo
поговорите	pogovorite		Duolingo
погода	pogoda		Duolingo
под	pod		Duolingo
подарил	podaril		Duolingo
подарили	podarili		Duolingo
подарки	podarki		Duolingo
подарок	podarok		Duolingo
подарю	podariu		Duolingo
подо	podo		Duolingo
подождать	podozhdat'		Duolingo
подожди	podozhdi		Duolingo
подозреваете	podozrevaete		Duolingo
подозревать	podozrevat'		Duolingo
подозревают	podozrevaiut		Duolingo
подойди	podoidi		Duolingo
подошёл	podoshel		Duolingo
подошли	podoshli		Duolingo
поезд	poezd		Duolingo
поезда	poezda		Duolingo
поезде	poezde		Duolingo
поел	poel		Duolingo
поесть	poest'		Duolingo
поёт	poet		Duolingo
поехал	poekhal		Duolingo
поехала	poekhala		Duolingo
поехали	poekhali		Duolingo
поёшь	poesh'		Duolingo
пожалуйста	pozhaluista		Duolingo
позавтракал	pozavtrakal		Duolingo
позавтракали	pozavtrakali		Duolingo
позавтракать	pozavtrakat'		Duolingo
позавчера	pozavchera		Duolingo
позвони	pozvoni		Duolingo
позвонила	pozvonila		Duolingo
позвонили	pozvonili		Duolingo
позвоните	pozvonite		Duolingo
позвонить	pozvonit'		Duolingo
поздно	pozdno		Duolingo
поздравляю	pozdravliaiu		Duolingo
познакомился	poznakomilsia		Duolingo
познакомиться	poznakomit'sia		Duolingo
поиск	poisk		Duolingo
пойдём	poidem		Duolingo
пойдёт	poidet		Duolingo
пойду	poidu		Duolingo
поймёшь	poimesh'		Duolingo
пойти	poiti		Duolingo
пока	poka		Duolingo
покажу	pokazhu		Duolingo
показал	pokazal		Duolingo
показали	pokazali		Duolingo
показалось	pokazalos'		Duolingo
показывает	pokazyvaet		Duolingo
показывал	pokazyval		Duolingo
показывала	pokazyvala		Duolingo
показываю	pokazyvaiu		Duolingo
показывают	pokazyvaiut		Duolingo
покупаем	pokupaem		Duolingo
покупает	pokupaet		Duolingo
покупать	pokupat'		Duolingo
покупаю	pokupaiu		Duolingo
покупают	pokupaiut		Duolingo
пол	pol		Duolingo
полгода	polgoda		Duolingo
полезную	poleznuiu		Duolingo
полезный	poleznyi		Duolingo
политик	politik		Duolingo
политика	politika		Duolingo
политиков	politikov		Duolingo
полиции	politsii		Duolingo
полиция	politsiia		Duolingo
полка	polka		Duolingo
полке	polke		Duolingo
полки	polki		Duolingo
полная	polnaia		Duolingo
полный	polnyi		Duolingo
половина	polovina		Duolingo
половину	polovinu		Duolingo
положи	polozhi		Duolingo
положил	polozhil		Duolingo
положила	polozhila		Duolingo
положите	polozhite		Duolingo
полотенца	polotentsa		Duolingo
полотенце	polotentse		Duolingo
полу	polu		Duolingo
получил	poluchil		Duolingo
получили	poluchili		Duolingo
получит	poluchit		Duolingo
получите	poluchite		Duolingo
получу	poluchu		Duolingo
польский	pol'skii		Duolingo
польского	pol'skogo		Duolingo
польском	pol'skom		Duolingo
польскую	pol'skuiu		Duolingo
польша	pol'sha		Duolingo
польше	pol'she		Duolingo
польшу	pol'shu		Duolingo
полюс	polius		Duolingo
полюсе	poliuse		Duolingo
поменьше	pomen'she		Duolingo
помидоров	pomidorov		Duolingo
помидоры	pomidory		Duolingo
помнил	pomnil		Duolingo
помнила	pomnila		Duolingo
помнили	pomnili		Duolingo
помнит	pomnit		Duolingo
помню	pomniu		Duolingo
помнят	pomniat		Duolingo
помогает	pomogaet		Duolingo
помогаешь	pomogaesh'		Duolingo
помогать	pomogat'		Duolingo
помогают	pomogaiut		Duolingo
помогла	pomogla		Duolingo
поможем	pomozhem		Duolingo
помой	pomoi		Duolingo
помойте	pomoite		Duolingo
помочь	pomoch'		Duolingo
помощью	pomoshch'iu		Duolingo
помыть	pomyt'		Duolingo
понедельник	ponedel'nik		Duolingo
понедельника	ponedel'nika		Duolingo
понедельникам	ponedel'nikam		Duolingo
понедельнику	ponedel'niku		Duolingo
понимает	ponimaet		Duolingo
понимаешь	ponimaesh'		Duolingo
понимаю	ponimaiu		Duolingo
понимая	ponimaia		Duolingo
понравилась	ponravilas'		Duolingo
понравился	ponravilsia		Duolingo
понравится	ponravitsia		Duolingo
поняла	poniala		Duolingo
поняли	poniali		Duolingo
понятно	poniatno		Duolingo
пообедал	poobedal		Duolingo
пообедать	poobedat'		Duolingo
пообедаю	poobedaiu		Duolingo
попала	popala		Duolingo
попросил	poprosil		Duolingo
попросила	poprosila		Duolingo
пора	pora		Duolingo
пораньше	poran'she		Duolingo
портрет	portret		Duolingo
портретом	portretom		Duolingo
портреты	portrety		Duolingo
посадили	posadili		Duolingo
посадят	posadiat		Duolingo
после	posle		Duolingo
последние	poslednie		Duolingo
последний	poslednii		Duolingo
последняя	posledniaia		Duolingo
послезавтра	poslezavtra		Duolingo
посмотрев	posmotrev		Duolingo
посмотрел	posmotrel		Duolingo
посмотрела	posmotrela		Duolingo
посмотрим	posmotrim		Duolingo
пост	post		Duolingo
поставила	postavila		Duolingo
поставили	postavili		Duolingo
поставит	postavit		Duolingo
поставишь	postavish'		Duolingo
поставлю	postavliu		Duolingo
поставь	postav'		Duolingo
поставьте	postav'te		Duolingo
постирать	postirat'		Duolingo
построен	postroen		Duolingo
построено	postroeno		Duolingo
поступил	postupil		Duolingo
поступила	postupila		Duolingo
поступить	postupit'		Duolingo
посуда	posuda		Duolingo
посуду	posudu		Duolingo
потерял	poterial		Duolingo
потеряла	poteriala		Duolingo
потеряли	poteriali		Duolingo
потом	potom		Duolingo
потому	potomu		Duolingo
потратить	potratit'		Duolingo
похожа	pokhozha		Duolingo
похоже	pokhozhe		Duolingo
похожи	pokhozhi		Duolingo
поцеловались	potselovalis'		Duolingo
поцеловался	potselovalsia		Duolingo
почему	pochemu		Duolingo
почта	pochta		Duolingo
почти	pochti		Duolingo
почту	pochtu		Duolingo
пошёл	poshel		Duolingo
пошла	poshla		Duolingo
пошли	poshli		Duolingo
поэт	poet		Duolingo
поэта	poeta		Duolingo
поэтому	poetomu		Duolingo
поэты	poety		Duolingo
пою	poiu		Duolingo
поют	poiut		Duolingo
прав	prav		Duolingo
права	prava		Duolingo
правая	pravaia		Duolingo
правил	pravil		Duolingo
правила	pravila		Duolingo
правило	pravilo		Duolingo
правильно	pravil'no		Duolingo
правильный	pravil'nyi		Duolingo
правительства	pravitel'stva		Duolingo
правительство	pravitel'stvo		Duolingo
право	pravo		Duolingo
правой	pravoi		Duolingo
правую	pravuiu		Duolingo
праздником	prazdnikom		Duolingo
предложение	predlozhenie		Duolingo
предложений	predlozhenii		Duolingo
предложения	predlozheniia		Duolingo
предмет	predmet		Duolingo
президент	prezident		Duolingo
президента	prezidenta		Duolingo
президентом	prezidentom		Duolingo
президенты	prezidenty		Duolingo
прекрасное	prekrasnoe		Duolingo
прекрасные	prekrasnye		Duolingo
прекрасный	prekrasnyi		Duolingo
премьер	prem'er		Duolingo
премьер-министр	prem'er-ministr		Duolingo
премьера	prem'era		Duolingo
преподавала	prepodavala		Duolingo
преподаватель	prepodavatel'		Duolingo
преподаёт	prepodaet		Duolingo
преподаёте	prepodaete		Duolingo
преподают	prepodaiut		Duolingo
преступление	prestuplenie		Duolingo
преступлением	prestupleniem		Duolingo
преступник	prestupnik		Duolingo
преступника	prestupnika		Duolingo
преступники	prestupniki		Duolingo
при	pri		Duolingo
приближается	priblizhaetsia		Duolingo
привет	privet		Duolingo
привидение	prividenie		Duolingo
привидений	prividenii		Duolingo
привидения	privideniia		Duolingo
привык	privyk		Duolingo
привыкла	privykla		Duolingo
привыкли	privykli		Duolingo
привыкнуть	privyknut'		Duolingo
пригласил	priglasil		Duolingo
пригласила	priglasila		Duolingo
пригласили	priglasili		Duolingo
приговорил	prigovoril		Duolingo
приговорили	prigovorili		Duolingo
приготовим	prigotovim		Duolingo
приготовит	prigotovit		Duolingo
приготовить	prigotovit'		Duolingo
приготовленный	prigotovlennyi		Duolingo
приготовлю	prigotovliu		Duolingo
придёте	pridete		Duolingo
приду	pridu		Duolingo
придумал	pridumal		Duolingo
придумать	pridumat'		Duolingo
придумаю	pridumaiu		Duolingo
приедет	priedet		Duolingo
приеду	priedu		Duolingo
приезжать	priezzhat'		Duolingo
приехал	priekhal		Duolingo
приехали	priekhali		Duolingo
прилетела	priletela		Duolingo
прилетели	prileteli		Duolingo
прилетит	priletit		Duolingo
примут	primut		Duolingo
принёс	prines		Duolingo
принеси	prinesi		Duolingo
принесла	prinesla		Duolingo
принести	prinesti		Duolingo
принесу	prinesu		Duolingo
принимает	prinimaet		Duolingo
принимают	prinimaiut		Duolingo
принял	prinial		Duolingo
приняли	priniali		Duolingo
принять	priniat'		Duolingo
природа	priroda		Duolingo
природу	prirodu		Duolingo
приходил	prikhodil		Duolingo
приходили	prikhodili		Duolingo
приходит	prikhodit		Duolingo
прихожу	prikhozhu		Duolingo
пришел	prishel		Duolingo
пришла	prishla		Duolingo
пришли	prishli		Duolingo
пришло	prishlo		Duolingo
приятно	priiatno		Duolingo
приятный	priiatnyi		Duolingo
про	pro		Duolingo
пробежал	probezhal		Duolingo
пробежала	probezhala		Duolingo
пробежали	probezhali		Duolingo
пробежать	probezhat'		Duolingo
пробежит	probezhit		Duolingo
проблем	problem		Duolingo
проблема	problema		Duolingo
пробовал	proboval		Duolingo
пробовала	probovala		Duolingo
пробовали	probovali		Duolingo
пробуем	probuem		Duolingo
пробует	probuet		Duolingo
пробую	probuiu		Duolingo
проведём	provedem		Duolingo
проведёт	provedet		Duolingo
провёл	provel		Duolingo
провела	provela		Duolingo
провели	proveli		Duolingo
проверить	proverit'		Duolingo
проверьте	prover'te		Duolingo
проверю	proveriu		Duolingo
проводим	provodim		Duolingo
проводить	provodit'		Duolingo
проводят	provodiat		Duolingo
программа	programma		Duolingo
программист	programmist		Duolingo
программистом	programmistom		Duolingo
программу	programmu		Duolingo
продавали	prodavali		Duolingo
продавец	prodavets		Duolingo
продавца	prodavtsa		Duolingo
продаёт	prodaet		Duolingo
продаётся	prodaetsia		Duolingo
продал	prodal		Duolingo
продала	prodala		Duolingo
продали	prodali		Duolingo
продам	prodam		Duolingo
продаст	prodast		Duolingo
продать	prodat'		Duolingo
продают	prodaiut		Duolingo
продаются	prodaiutsia		Duolingo
продолжить	prodolzhit'		Duolingo
продукты	produkty		Duolingo
проедем	proedem		Duolingo
проеду	proedu		Duolingo
проектах	proektakh		Duolingo
проекте	proekte		Duolingo
проектом	proektom		Duolingo
проехал	proekhal		Duolingo
проехала	proekhala		Duolingo
проехали	proekhali		Duolingo
проехать	proekhat'		Duolingo
проживёт	prozhivet		Duolingo
прожил	prozhil		Duolingo
прожили	prozhili		Duolingo
проиграл	proigral		Duolingo
проиграли	proigrali		Duolingo
производит	proizvodit		Duolingo
производите	proizvodite		Duolingo
производят	proizvodiat		Duolingo
произойдёт	proizoidet		Duolingo
произошла	proizoshla		Duolingo
произошло	proizoshlo		Duolingo
происхождение	proiskhozhdenie		Duolingo
происхождения	proiskhozhdeniia		Duolingo
пройдём	proidem		Duolingo
пройдёте	proidete		Duolingo
пройти	proiti		Duolingo
пропуск	propusk		Duolingo
пропуска	propuska		Duolingo
пропустила	propustila		Duolingo
пропустили	propustili		Duolingo
пропустит	propustit		Duolingo
просит	prosit		Duolingo
просишь	prosish'		Duolingo
проспал	prospal		Duolingo
просплю	prospliu		Duolingo
прости	prosti		Duolingo
простите	prostite		Duolingo
просто	prosto		Duolingo
простое	prostoe		Duolingo
простой	prostoi		Duolingo
против	protiv		Duolingo
профессии	professii		Duolingo
профессию	professiiu		Duolingo
профессия	professiia		Duolingo
прохладно	prokhladno		Duolingo
проходит	prokhodit		Duolingo
проходите	prokhodite		Duolingo
прохожу	prokhozhu		Duolingo
процесс	protsess		Duolingo
процессы	protsessy		Duolingo
прочитай	prochitai		Duolingo
прочитайте	prochitaite		Duolingo
прочитал	prochital		Duolingo
прочитала	prochitala		Duolingo
прошёл	proshel		Duolingo
прошла	proshla		Duolingo
прошлая	proshlaia		Duolingo
прошли	proshli		Duolingo
прошлый	proshlyi		Duolingo
пруд	prud		Duolingo
пруда	pruda		Duolingo
пруду	prudu		Duolingo
прыгает	prygaet		Duolingo
прыгать	prygat'		Duolingo
прыгают	prygaiut		Duolingo
прямо	priamo		Duolingo
птиц	ptits		Duolingo
птица	ptitsa		Duolingo
птицы	ptitsy		Duolingo
пустая	pustaia		Duolingo
пустой	pustoi		Duolingo
пустыми	pustymi		Duolingo
пусть	pust'		Duolingo
путешествовать	puteshestvovat'		Duolingo
путь	put'		Duolingo
пушек	pushek		Duolingo
пушка	pushka		Duolingo
пушки	pushki		Duolingo
пьеса	p'esa		Duolingo
пьесу	p'esu		Duolingo
пьесы	p'esy		Duolingo
пьёт	p'et		Duolingo
пьёшь	p'esh'		Duolingo
пью	p'iu		Duolingo
пьют	p'iut		Duolingo
пьющая	p'iushchaia		Duolingo
пьющего	p'iushchego		Duolingo
пьющий	p'iushchii		Duolingo
пюре	piure		Duolingo
пятая	piataia		Duolingo
пятёрка	piaterka		Duolingo
пятёрку	piaterku		Duolingo
пяти	piati		Duolingo
пятнадцать	piatnadtsat'		Duolingo
пятница	piatnitsa		Duolingo
пятницам	piatnitsam		Duolingo
пятом	piatom		Duolingo
пятый	piatyi		Duolingo
пять	piat'		Duolingo
пятьдесят	piat'desiat		Duolingo
пятьсот	piat'sot		Duolingo
работа	rabota		Duolingo
работает	rabotaet		Duolingo
работал	rabotal		Duolingo
работала	rabotala		Duolingo
работали	rabotali		Duolingo
работать	rabotat'		Duolingo
работаю	rabotaiu		Duolingo
работе	rabote		Duolingo
работу	rabotu		Duolingo
работы	raboty		Duolingo
рабочего	rabochego		Duolingo
рабочий	rabochii		Duolingo
рад	rad		Duolingo
рада	rada		Duolingo
радио	radio		Duolingo
рады	rady		Duolingo
раз	raz		Duolingo
разбил	razbil		Duolingo
разбила	razbila		Duolingo
разбили	razbili		Duolingo
разбить	razbit'		Duolingo
разговор	razgovor		Duolingo
разговоры	razgovory		Duolingo
раздевается	razdevaetsia		Duolingo
раздеваешься	razdevaesh'sia		Duolingo
раздевайся	razdevaisia		Duolingo
раздевайтесь	razdevaites'		Duolingo
раздеваюсь	razdevaius'		Duolingo
раздевшись	razdevshis'		Duolingo
размер	razmer		Duolingo
размера	razmera		Duolingo
разное	raznoe		Duolingo
разные	raznye		Duolingo
разобрал	razobral		Duolingo
разобрали	razobrali		Duolingo
разобрать	razobrat'		Duolingo
разработал	razrabotal		Duolingo
разработали	razrabotali		Duolingo
разработать	razrabotat'		Duolingo
район	raion		Duolingo
районе	raione		Duolingo
рано	rano		Duolingo
раньше	ran'she		Duolingo
расписание	raspisanie		Duolingo
расписания	raspisaniia		Duolingo
рассвет	rassvet		Duolingo
рассвете	rassvete		Duolingo
рассказ	rasskaz		Duolingo
рассказывает	rasskazyvaet		Duolingo
рассказываешь	rasskazyvaesh'		Duolingo
рассказывают	rasskazyvaiut		Duolingo
расследование	rassledovanie		Duolingo
расследовании	rassledovanii		Duolingo
расстояние	rasstoianie		Duolingo
расстоянии	rasstoianii		Duolingo
расстроилась	rasstroilas'		Duolingo
расстроился	rasstroilsia		Duolingo
расстроится	rasstroitsia		Duolingo
растёт	rastet		Duolingo
расту	rastu		Duolingo
растут	rastut		Duolingo
ребёнка	rebenka		Duolingo
ребёнком	rebenkom		Duolingo
ребёнок	rebenok		Duolingo
революции	revoliutsii		Duolingo
революцию	revoliutsiiu		Duolingo
революция	revoliutsiia		Duolingo
редко	redko		Duolingo
режиссёр	rezhisser		Duolingo
режиссёром	rezhisserom		Duolingo
результат	rezul'tat		Duolingo
река	reka		Duolingo
реке	reke		Duolingo
реки	reki		Duolingo
рекой	rekoi		Duolingo
религией	religiei		Duolingo
религии	religii		Duolingo
религия	religiia		Duolingo
рептилии	reptilii		Duolingo
рептилий	reptilii		Duolingo
ресторан	restoran		Duolingo
решат	reshat		Duolingo
решение	reshenie		Duolingo
решений	reshenii		Duolingo
решил	reshil		Duolingo
решить	reshit'		Duolingo
рим	rim		Duolingo
рима	rima		Duolingo
риме	rime		Duolingo
рис	ris		Duolingo
риса	risa		Duolingo
рисовать	risovat'		Duolingo
рисуем	risuem		Duolingo
рисует	risuet		Duolingo
рисунки	risunki		Duolingo
рисунков	risunkov		Duolingo
рисунок	risunok		Duolingo
рисую	risuiu		Duolingo
рисующая	risuiushchaia		Duolingo
рисующий	risuiushchii		Duolingo
рисующих	risuiushchikh		Duolingo
рисующую	risuiushchuiu		Duolingo
род	rod		Duolingo
рода	roda		Duolingo
родилась	rodilas'		Duolingo
родились	rodilis'		Duolingo
родился	rodilsia		Duolingo
родина	rodina		Duolingo
родину	rodinu		Duolingo
родины	rodiny		Duolingo
родителей	roditelei		Duolingo
родители	roditeli		Duolingo
родителям	roditeliam		Duolingo
родная	rodnaia		Duolingo
родной	rodnoi		Duolingo
рождение	rozhdenie		Duolingo
рождения	rozhdeniia		Duolingo
рождества	rozhdestva		Duolingo
рождество	rozhdestvo		Duolingo
рок	rok		Duolingo
роман	roman		Duolingo
романы	romany		Duolingo
россии	rossii		Duolingo
россия	rossiia		Duolingo
рост	rost		Duolingo
ростов	rostov		Duolingo
рот	rot		Duolingo
рту	rtu		Duolingo
рты	rty		Duolingo
рубашка	rubashka		Duolingo
рубашку	rubashku		Duolingo
рублей	rublei		Duolingo
рубль	rubl'		Duolingo
рубля	rublia		Duolingo
рука	ruka		Duolingo
руках	rukakh		Duolingo
руке	ruke		Duolingo
руки	ruki		Duolingo
рукой	rukoi		Duolingo
руку	ruku		Duolingo
русски	russki		Duolingo
русский	russkii		Duolingo
ручек	ruchek		Duolingo
ручка	ruchka		Duolingo
ручки	ruchki		Duolingo
ручкой	ruchkoi		Duolingo
рыба	ryba		Duolingo
рыбу	rybu		Duolingo
рыбы	ryby		Duolingo
рыжая	ryzhaia		Duolingo
рыжие	ryzhie		Duolingo
рыжий	ryzhii		Duolingo
рыцари	rytsari		Duolingo
рыцарь	rytsar'		Duolingo
рюкзак	riukzak		Duolingo
ряд	riad		Duolingo
рядов	riadov		Duolingo
рядом	riadom		Duolingo
ряду	riadu		Duolingo
с	s		Duolingo
с молоком	s molokom		Duolingo
с новым годом	s novym godom		Duolingo
с собой	s soboi		Duolingo
сад	sad		Duolingo
садись	sadis'		Duolingo
садится	saditsia		Duolingo
саду	sadu		Duolingo
садятся	sadiatsia		Duolingo
сажусь	sazhus'		Duolingo
сайт	sait		Duolingo
сайта	saita		Duolingo
сайте	saite		Duolingo
салат	salat		Duolingo
салата	salata		Duolingo
сам	sam		Duolingo
сама	sama		Duolingo
самара	samara		Duolingo
самая	samaia		Duolingo
сами	sami		Duolingo
самое	samoe		Duolingo
самолёт	samolet		Duolingo
самолёта	samoleta		Duolingo
самый	samyi		Duolingo
сахар	sakhar		Duolingo
сахара	sakhara		Duolingo
сахаром	sakharom		Duolingo
свари	svari		Duolingo
сварить	svarit'		Duolingo
свежее	svezhee		Duolingo
свежие	svezhie		Duolingo
свежий	svezhii		Duolingo
свежих	svezhikh		Duolingo
свет	svet		Duolingo
светло	svetlo		Duolingo
светлые	svetlye		Duolingo
светлый	svetlyi		Duolingo
свидания	svidaniia		Duolingo
свидетель	svidetel'		Duolingo
свидетелю	svideteliu		Duolingo
свитер	sviter		Duolingo
свитере	svitere		Duolingo
свитером	sviterom		Duolingo
свободен	svoboden		Duolingo
свободна	svobodna		Duolingo
свободная	svobodnaia		Duolingo
свободно	svobodno		Duolingo
свободного	svobodnogo		Duolingo
свободное	svobodnoe		Duolingo
свободный	svobodnyi		Duolingo
своего	svoego		Duolingo
своим	svoim		Duolingo
своих	svoikh		Duolingo
свойств	svoistv		Duolingo
свойства	svoistva		Duolingo
свойство	svoistvo		Duolingo
свою	svoiu		Duolingo
сдавала	sdavala		Duolingo
сдаём	sdaem		Duolingo
сдача	sdacha		Duolingo
сдачи	sdachi		Duolingo
сдачу	sdachu		Duolingo
сдают	sdaiut		Duolingo
сделав	sdelav		Duolingo
сделает	sdelaet		Duolingo
сделай	sdelai		Duolingo
сделайте	sdelaite		Duolingo
сделал	sdelal		Duolingo
сделала	sdelala		Duolingo
сделали	sdelali		Duolingo
сделана	sdelana		Duolingo
сделанная	sdelannaia		Duolingo
сделанное	sdelannoe		Duolingo
сделанный	sdelannyi		Duolingo
сделано	sdelano		Duolingo
сделать	sdelat'		Duolingo
сделаю	sdelaiu		Duolingo
себя	sebia		Duolingo
север	sever		Duolingo
севере	severe		Duolingo
северная	severnaia		Duolingo
северном	severnom		Duolingo
северный	severnyi		Duolingo
севшая	sevshaia		Duolingo
севшие	sevshie		Duolingo
севшую	sevshuiu		Duolingo
сегодня	segodnia		Duolingo
седьмое	sed'moe		Duolingo
седьмой	sed'moi		Duolingo
сейчас	seichas		Duolingo
секретарь	sekretar'		Duolingo
сел	sel		Duolingo
села	sela		Duolingo
сели	seli		Duolingo
семнадцатого	semnadtsatogo		Duolingo
семнадцатом	semnadtsatom		Duolingo
семнадцатый	semnadtsatyi		Duolingo
семнадцать	semnadtsat'		Duolingo
семь	sem'		Duolingo
семьдесят	sem'desiat		Duolingo
семью	sem'iu		Duolingo
семья	sem'ia		Duolingo
сентябре	sentiabre		Duolingo
сентябрь	sentiabr'		Duolingo
серая	seraia		Duolingo
сергей	sergei		Duolingo
сергея	sergeia		Duolingo
сердце	serdtse		Duolingo
сердцу	serdtsu		Duolingo
середина	seredina		Duolingo
середине	seredine		Duolingo
середину	seredinu		Duolingo
сериал	serial		Duolingo
сериалы	serialy		Duolingo
серые	serye		Duolingo
серый	seryi		Duolingo
серьёзная	ser'eznaia		Duolingo
серьёзный	ser'eznyi		Duolingo
сестра	sestra		Duolingo
сестрой	sestroi		Duolingo
сёстры	sestry		Duolingo
сесть	sest'		Duolingo
сети	seti		Duolingo
сеть	set'		Duolingo
сибири	sibiri		Duolingo
сибирь	sibir'		Duolingo
сидеть	sidet'		Duolingo
сидим	sidim		Duolingo
сидит	sidit		Duolingo
сильная	sil'naia		Duolingo
сильнее	sil'nee		Duolingo
сильней	sil'nei		Duolingo
сильные	sil'nye		Duolingo
сильный	sil'nyi		Duolingo
синагога	sinagoga		Duolingo
синагоге	sinagoge		Duolingo
синагогу	sinagogu		Duolingo
синей	sinei		Duolingo
синий	sinii		Duolingo
синих	sinikh		Duolingo
синюю	siniuiu		Duolingo
синяя	siniaia		Duolingo
скажет	skazhet		Duolingo
скажи	skazhi		Duolingo
скажите	skazhite		Duolingo
скажу	skazhu		Duolingo
сказал	skazal		Duolingo
сказала	skazala		Duolingo
сказали	skazali		Duolingo
сказать	skazat'		Duolingo
сказке	skazke		Duolingo
сказки	skazki		Duolingo
сказку	skazku		Duolingo
скачать	skachat'		Duolingo
сквозь	skvoz'		Duolingo
сколько	skol'ko		Duolingo
скопировала	skopirovala		Duolingo
скопировать	skopirovat'		Duolingo
скопируй	skopirui		Duolingo
скорее всего	skoree vsego		Duolingo
скоро	skoro		Duolingo
скорого	skorogo		Duolingo
скорости	skorosti		Duolingo
скорость	skorost'		Duolingo
скрипке	skripke		Duolingo
скучная	skuchnaia		Duolingo
скучный	skuchnyi		Duolingo
скучных	skuchnykh		Duolingo
слабая	slabaia		Duolingo
слабые	slabye		Duolingo
слабый	slabyi		Duolingo
слабых	slabykh		Duolingo
сладкая	sladkaia		Duolingo
сладкий	sladkii		Duolingo
сладкое	sladkoe		Duolingo
слева	sleva		Duolingo
следующей	sleduiushchei		Duolingo
следующем	sleduiushchem		Duolingo
следующие	sleduiushchie		Duolingo
следующий	sleduiushchii		Duolingo
слишком	slishkom		Duolingo
слов	slov		Duolingo
слова	slova		Duolingo
словам	slovam		Duolingo
словарём	slovarem		Duolingo
словарь	slovar'		Duolingo
словаря	slovaria		Duolingo
слово	slovo		Duolingo
сложный	slozhnyi		Duolingo
сломал	slomal		Duolingo
сломала	slomala		Duolingo
сломана	slomana		Duolingo
служат	sluzhat		Duolingo
служим	sluzhim		Duolingo
слушаем	slushaem		Duolingo
слушает	slushaet		Duolingo
слушаешь	slushaesh'		Duolingo
слушай	slushai		Duolingo
слушайте	slushaite		Duolingo
слушаю	slushaiu		Duolingo
слушают	slushaiut		Duolingo
слышал	slyshal		Duolingo
слышала	slyshala		Duolingo
слышали	slyshali		Duolingo
смеётся	smeetsia		Duolingo
смеешься	smeesh'sia		Duolingo
смерти	smerti		Duolingo
смерть	smert'		Duolingo
смеются	smeiutsia		Duolingo
смеялся	smeialsia		Duolingo
смотрел	smotrel		Duolingo
смотрела	smotrela		Duolingo
смотрели	smotreli		Duolingo
смотреть	smotret'		Duolingo
смотри	smotri		Duolingo
смотрим	smotrim		Duolingo
смотрите	smotrite		Duolingo
смотрю	smotriu		Duolingo
сначала	snachala		Duolingo
снег	sneg		Duolingo
снега	snega		Duolingo
снегу	snegu		Duolingo
снизил	snizil		Duolingo
снизили	snizili		Duolingo
снимаем	snimaem		Duolingo
снимаете	snimaete		Duolingo
снимал	snimal		Duolingo
снимала	snimala		Duolingo
снимали	snimali		Duolingo
снимаю	snimaiu		Duolingo
снимите	snimite		Duolingo
снова	snova		Duolingo
снял	snial		Duolingo
сняла	sniala		Duolingo
со	so		Duolingo
со временем	so vremenem		Duolingo
собак	sobak		Duolingo
собака	sobaka		Duolingo
собаки	sobaki		Duolingo
собаку	sobaku		Duolingo
собираемся	sobiraemsia		Duolingo
собираетесь	sobiraetes'		Duolingo
собирается	sobiraetsia		Duolingo
собираешься	sobiraesh'sia		Duolingo
собиралась	sobiralas'		Duolingo
собирались	sobiralis'		Duolingo
собирался	sobiralsia		Duolingo
собираюсь	sobiraius'		Duolingo
собираются	sobiraiutsia		Duolingo
собрала	sobrala		Duolingo
собрали	sobrali		Duolingo
собрание	sobranie		Duolingo
собрания	sobraniia		Duolingo
собрать	sobrat'		Duolingo
совершенно	sovershenno		Duolingo
совершил	sovershil		Duolingo
совершить	sovershit'		Duolingo
совет	sovet		Duolingo
советуем	sovetuem		Duolingo
советует	sovetuet		Duolingo
советую	sovetuiu		Duolingo
современная	sovremennaia		Duolingo
современные	sovremennye		Duolingo
современный	sovremennyi		Duolingo
совсем	sovsem		Duolingo
согласен	soglasen		Duolingo
согласна	soglasna		Duolingo
согласны	soglasny		Duolingo
содержание	soderzhanie		Duolingo
содержании	soderzhanii		Duolingo
создал	sozdal		Duolingo
создали	sozdali		Duolingo
сок	sok		Duolingo
сока	soka		Duolingo
соли	soli		Duolingo
солнце	solntse		Duolingo
солью	sol'iu		Duolingo
сообщение	soobshchenie		Duolingo
сообщения	soobshcheniia		Duolingo
сорок	sorok		Duolingo
сосед	sosed		Duolingo
соседа	soseda		Duolingo
соседе	sosede		Duolingo
соседи	sosedi		Duolingo
состоит	sostoit		Duolingo
состояние	sostoianie		Duolingo
состоянии	sostoianii		Duolingo
состоят	sostoiat		Duolingo
соус	sous		Duolingo
соуса	sousa		Duolingo
социальная	sotsial'naia		Duolingo
социальной	sotsial'noi		Duolingo
социальную	sotsial'nuiu		Duolingo
спал	spal		Duolingo
спала	spala		Duolingo
спасибо	spasibo		Duolingo
спать	spat'		Duolingo
спектакль	spektakl'		Duolingo
спина	spina		Duolingo
спине	spine		Duolingo
спины	spiny		Duolingo
спит	spit		Duolingo
спите	spite		Duolingo
спишь	spish'		Duolingo
сплю	spliu		Duolingo
спокойной	spokoinoi		Duolingo
спорт	sport		Duolingo
спортсмен	sportsmen		Duolingo
спортсменка	sportsmenka		Duolingo
спортсменов	sportsmenov		Duolingo
спортсмены	sportsmeny		Duolingo
справа	sprava		Duolingo
спрашивает	sprashivaet		Duolingo
спрашиваете	sprashivaete		Duolingo
спрашивают	sprashivaiut		Duolingo
спросил	sprosil		Duolingo
спросила	sprosila		Duolingo
спросили	sprosili		Duolingo
спят	spiat		Duolingo
сразу	srazu		Duolingo
среда	sreda		Duolingo
средам	sredam		Duolingo
средний	srednii		Duolingo
средняя	sredniaia		Duolingo
среду	sredu		Duolingo
среды	sredy		Duolingo
ссоримся	ssorimsia		Duolingo
ссорюсь	ssorius'		Duolingo
ссорятся	ssoriatsia		Duolingo
ста	sta		Duolingo
ставил	stavil		Duolingo
ставила	stavila		Duolingo
ставить	stavit'		Duolingo
ставлю	stavliu		Duolingo
стадион	stadion		Duolingo
стадиона	stadiona		Duolingo
стадионе	stadione		Duolingo
стакан	stakan		Duolingo
стакана	stakana		Duolingo
стакане	stakane		Duolingo
стал	stal		Duolingo
стала	stala		Duolingo
становилось	stanovilos'		Duolingo
становится	stanovitsia		Duolingo
станцию	stantsiiu		Duolingo
станция	stantsiia		Duolingo
старая	staraia		Duolingo
старик	starik		Duolingo
старика	starika		Duolingo
старики	stariki		Duolingo
старшая	starshaia		Duolingo
старший	starshii		Duolingo
старый	staryi		Duolingo
стать	stat'		Duolingo
статьи	stat'i		Duolingo
статью	stat'iu		Duolingo
статья	stat'ia		Duolingo
стена	stena		Duolingo
стене	stene		Duolingo
стены	steny		Duolingo
стёр	ster		Duolingo
стёрла	sterla		Duolingo
стихи	stikhi		Duolingo
стихов	stikhov		Duolingo
сто	sto		Duolingo
стоим	stoim		Duolingo
стоит	stoit		Duolingo
стоить	stoit'		Duolingo
стол	stol		Duolingo
столе	stole		Duolingo
столица	stolitsa		Duolingo
столице	stolitse		Duolingo
столов	stolov		Duolingo
столовая	stolovaia		Duolingo
столовой	stolovoi		Duolingo
столовую	stolovuiu		Duolingo
столом	stolom		Duolingo
столу	stolu		Duolingo
столы	stoly		Duolingo
сторона	storona		Duolingo
стороне	storone		Duolingo
стою	stoiu		Duolingo
стоял	stoial		Duolingo
стояла	stoiala		Duolingo
стояли	stoiali		Duolingo
стояло	stoialo		Duolingo
стоят	stoiat		Duolingo
стоять	stoiat'		Duolingo
страдание	stradanie		Duolingo
страна	strana		Duolingo
стране	strane		Duolingo
страниц	stranits		Duolingo
страница	stranitsa		Duolingo
страницы	stranitsy		Duolingo
странное	strannoe		Duolingo
странные	strannye		Duolingo
странный	strannyi		Duolingo
странных	strannykh		Duolingo
страшно	strashno		Duolingo
стрел	strel		Duolingo
стрела	strela		Duolingo
стрелы	strely		Duolingo
стрелял	strelial		Duolingo
стрелять	streliat'		Duolingo
стреляют	streliaiut		Duolingo
строил	stroil		Duolingo
строим	stroim		Duolingo
строит	stroit		Duolingo
строитель	stroitel'		Duolingo
строить	stroit'		Duolingo
студент	student		Duolingo
студента	studenta		Duolingo
студентка	studentka		Duolingo
студентов	studentov		Duolingo
стул	stul		Duolingo
стуле	stule		Duolingo
стулом	stulom		Duolingo
стыдно	stydno		Duolingo
суббота	subbota		Duolingo
субботу	subbotu		Duolingo
субботы	subboty		Duolingo
суд	sud		Duolingo
суда	suda		Duolingo
судьба	sud'ba		Duolingo
судьбу	sud'bu		Duolingo
судьи	sud'i		Duolingo
судья	sud'ia		Duolingo
судя по	sudia po		Duolingo
сумка	sumka		Duolingo
сумках	sumkakh		Duolingo
сумке	sumke		Duolingo
суп	sup		Duolingo
супа	supa		Duolingo
супермаркет	supermarket		Duolingo
супермаркете	supermarkete		Duolingo
суши	sushi		Duolingo
существует	sushchestvuet		Duolingo
существуешь	sushchestvuesh'		Duolingo
существуют	sushchestvuiut		Duolingo
сцена	stsena		Duolingo
сцене	stsene		Duolingo
считает	schitaet		Duolingo
считаете	schitaete		Duolingo
считается	schitaetsia		Duolingo
считать	schitat'		Duolingo
считаю	schitaiu		Duolingo
съел	s'el		Duolingo
съели	s'eli		Duolingo
съешь	s'esh'		Duolingo
сын	syn		Duolingo
сыновей	synovei		Duolingo
сыновья	synov'ia		Duolingo
сыр	syr		Duolingo
сыра	syra		Duolingo
сюда	siuda		Duolingo
сюжет	siuzhet		Duolingo
сюжета	siuzheta		Duolingo
та	ta		Duolingo
та же	ta zhe		Duolingo
так	tak		Duolingo
так же	tak zhe		Duolingo
так как	tak kak		Duolingo
так что	tak chto		Duolingo
такая	takaia		Duolingo
такая же	takaia zhe		Duolingo
такие	takie		Duolingo
таких	takikh		Duolingo
такое же	takoe zhe		Duolingo
такой	takoi		Duolingo
такой же	takoi zhe		Duolingo
такси	taksi		Duolingo
талантливая	talantlivaia		Duolingo
талантливые	talantlivye		Duolingo
талантливый	talantlivyi		Duolingo
там	tam		Duolingo
там же	tam zhe		Duolingo
танки	tanki		Duolingo
танков	tankov		Duolingo
танковая	tankovaia		Duolingo
танцевать	tantsevat'		Duolingo
танцуем	tantsuem		Duolingo
танцует	tantsuet		Duolingo
танцуете	tantsuete		Duolingo
тарелка	tarelka		Duolingo
тарелке	tarelke		Duolingo
тарелки	tarelki		Duolingo
тарелку	tarelku		Duolingo
тарелок	tarelok		Duolingo
твоё	tvoe		Duolingo
твоего	tvoego		Duolingo
твоей	tvoei		Duolingo
твои	tvoi		Duolingo
твоим	tvoim		Duolingo
твой	tvoi		Duolingo
твою	tvoiu		Duolingo
твоя	tvoia		Duolingo
те	te		Duolingo
театр	teatr		Duolingo
театре	teatre		Duolingo
тебе	tebe		Duolingo
тебя	tebia		Duolingo
текст	tekst		Duolingo
тела	tela		Duolingo
телевизор	televizor		Duolingo
телевизора	televizora		Duolingo
телефон	telefon		Duolingo
телефоне	telefone		Duolingo
телефону	telefonu		Duolingo
тело	telo		Duolingo
тёмная	temnaia		Duolingo
темно	temno		Duolingo
тёмные	temnye		Duolingo
тёмный	temnyi		Duolingo
температура	temperatura		Duolingo
теннис	tennis		Duolingo
теория	teoriia		Duolingo
теперь	teper'		Duolingo
тёплая	teplaia		Duolingo
теплее	teplee		Duolingo
тепло	teplo		Duolingo
тёплом	teplom		Duolingo
тёплую	tepluiu		Duolingo
тёплые	teplye		Duolingo
тёплый	teplyi		Duolingo
территории	territorii		Duolingo
территория	territoriia		Duolingo
теряет	teriaet		Duolingo
теряешь	teriaesh'		Duolingo
терять	teriat'		Duolingo
теряю	teriaiu		Duolingo
тёти	teti		Duolingo
тетради	tetradi		Duolingo
тетрадь	tetrad'		Duolingo
тётю	tetiu		Duolingo
тётя	tetia		Duolingo
техника	tekhnika		Duolingo
техники	tekhniki		Duolingo
тим	tim		Duolingo
тихая	tikhaia		Duolingo
тихий	tikhii		Duolingo
тихо	tikho		Duolingo
то	to		Duolingo
то же	to zhe		Duolingo
тобой	toboi		Duolingo
тогда	togda		Duolingo
тогда же	togda zhe		Duolingo
того	togo		Duolingo
тоже	tozhe		Duolingo
той же	toi zhe		Duolingo
толстые	tolstye		Duolingo
толстый	tolstyi		Duolingo
только	tol'ko		Duolingo
только что	tol'ko chto		Duolingo
том	tom		Duolingo
тому	tomu		Duolingo
тонн	tonn		Duolingo
тонна	tonna		Duolingo
тонны	tonny		Duolingo
торт	tort		Duolingo
торта	torta		Duolingo
торте	torte		Duolingo
торты	torty		Duolingo
тот	tot		Duolingo
тот же	tot zhe		Duolingo
точно	tochno		Duolingo
трава	trava		Duolingo
траве	trave		Duolingo
трамвае	tramvae		Duolingo
трамвай	tramvai		Duolingo
трамвая	tramvaia		Duolingo
транспорт	transport		Duolingo
транспорта	transporta		Duolingo
тренируемся	treniruemsia		Duolingo
тренируетесь	treniruetes'		Duolingo
тренируется	treniruetsia		Duolingo
тренируюсь	treniruius'		Duolingo
третий	tretii		Duolingo
третье	tret'e		Duolingo
третьем	tret'em		Duolingo
третью	tret'iu		Duolingo
трёх	trekh		Duolingo
три	tri		Duolingo
тридцать	tridtsat'		Duolingo
тринадцатая	trinadtsataia		Duolingo
тринадцатого	trinadtsatogo		Duolingo
тринадцатое	trinadtsatoe		Duolingo
тринадцать	trinadtsat'		Duolingo
триста	trista		Duolingo
трудная	trudnaia		Duolingo
трудно	trudno		Duolingo
трудное	trudnoe		Duolingo
трудные	trudnye		Duolingo
трудный	trudnyi		Duolingo
трудных	trudnykh		Duolingo
трудом	trudom		Duolingo
ту	tu		Duolingo
туалет	tualet		Duolingo
туалете	tualete		Duolingo
туда	tuda		Duolingo
туда же	tuda zhe		Duolingo
туман	tuman		Duolingo
тумана	tumana		Duolingo
туристы	turisty		Duolingo
тут	tut		Duolingo
туфель	tufel'		Duolingo
туфли	tufli		Duolingo
туч	tuch		Duolingo
туча	tucha		Duolingo
тучи	tuchi		Duolingo
тучу	tuchu		Duolingo
ты	ty		Duolingo
тысяча	tysiacha		Duolingo
тысячи	tysiachi		Duolingo
тюрьма	tiur'ma		Duolingo
тюрьме	tiur'me		Duolingo
тюрьму	tiur'mu		Duolingo
тюрьмы	tiur'my		Duolingo
тяжёлое	tiazheloe		Duolingo
тяжёлый	tiazhelyi		Duolingo
у	u		Duolingo
убегу	ubegu		Duolingo
убежала	ubezhala		Duolingo
убежишь	ubezhish'		Duolingo
убийстве	ubiistve		Duolingo
убийство	ubiistvo		Duolingo
убийца	ubiitsa		Duolingo
убийцу	ubiitsu		Duolingo
убил	ubil		Duolingo
убили	ubili		Duolingo
убить	ubit'		Duolingo
увеличение	uvelichenie		Duolingo
увеличении	uvelichenii		Duolingo
уверен	uveren		Duolingo
уверена	uverena		Duolingo
уверены	uvereny		Duolingo
увидел	uvidel		Duolingo
увидела	uvidela		Duolingo
увидеть	uvidet'		Duolingo
увидит	uvidit		Duolingo
увидите	uvidite		Duolingo
увидишь	uvidish'		Duolingo
уволили	uvolili		Duolingo
уволят	uvoliat		Duolingo
углом	uglom		Duolingo
углу	uglu		Duolingo
угол	ugol		Duolingo
удали	udali		Duolingo
удалила	udalila		Duolingo
удалите	udalite		Duolingo
удалить	udalit'		Duolingo
удобная	udobnaia		Duolingo
удобные	udobnye		Duolingo
удобный	udobnyi		Duolingo
удобных	udobnykh		Duolingo
удовольствием	udovol'stviem		Duolingo
уедут	uedut		Duolingo
уезжаешь	uezzhaesh'		Duolingo
уезжаю	uezzhaiu		Duolingo
уезжают	uezzhaiut		Duolingo
уехал	uekhal		Duolingo
ужасная	uzhasnaia		Duolingo
ужасно	uzhasno		Duolingo
ужасный	uzhasnyi		Duolingo
уже	uzhe		Duolingo
ужин	uzhin		Duolingo
ужинаем	uzhinaem		Duolingo
ужинает	uzhinaet		Duolingo
ужинать	uzhinat'		Duolingo
ужинаю	uzhinaiu		Duolingo
ужинают	uzhinaiut		Duolingo
узнаем	uznaem		Duolingo
узнает	uznaet		Duolingo
узнал	uznal		Duolingo
узнала	uznala		Duolingo
узнали	uznali		Duolingo
узнаю	uznaiu		Duolingo
уйдём	uidem		Duolingo
уйду	uidu		Duolingo
уйти	uiti		Duolingo
украина	ukraina		Duolingo
украине	ukraine		Duolingo
украинец	ukrainets		Duolingo
украинка	ukrainka		Duolingo
украинский	ukrainskii		Duolingo
украинцы	ukraintsy		Duolingo
украины	ukrainy		Duolingo
украл	ukral		Duolingo
украла	ukrala		Duolingo
украли	ukrali		Duolingo
улица	ulitsa		Duolingo
улице	ulitse		Duolingo
улицы	ulitsy		Duolingo
умеет	umeet		Duolingo
умеешь	umeesh'		Duolingo
умел	umel		Duolingo
умела	umela		Duolingo
умер	umer		Duolingo
умерла	umerla		Duolingo
умею	umeiu		Duolingo
умеют	umeiut		Duolingo
умная	umnaia		Duolingo
умный	umnyi		Duolingo
умных	umnykh		Duolingo
университет	universitet		Duolingo
университета	universiteta		Duolingo
университете	universitete		Duolingo
упадёт	upadet		Duolingo
упадёшь	upadesh'		Duolingo
упал	upal		Duolingo
упала	upala		Duolingo
упало	upalo		Duolingo
упражнение	uprazhnenie		Duolingo
упражнения	uprazhneniia		Duolingo
урок	urok		Duolingo
урока	uroka		Duolingo
ускорение	uskorenie		Duolingo
ускорения	uskoreniia		Duolingo
успешная	uspeshnaia		Duolingo
успешный	uspeshnyi		Duolingo
успешных	uspeshnykh		Duolingo
устал	ustal		Duolingo
устала	ustala		Duolingo
устали	ustali		Duolingo
утверждение	utverzhdenie		Duolingo
утка	utka		Duolingo
утки	utki		Duolingo
утку	utku		Duolingo
утра	utra		Duolingo
утро	utro		Duolingo
утром	utrom		Duolingo
ухо	ukho		Duolingo
уходим	ukhodim		Duolingo
уходит	ukhodit		Duolingo
уходите	ukhodite		Duolingo
уходить	ukhodit'		Duolingo
уходя	ukhodia		Duolingo
ухожу	ukhozhu		Duolingo
участвовать	uchastvovat'		Duolingo
участвует	uchastvuet		Duolingo
участвуешь	uchastvuesh'		Duolingo
участвую	uchastvuiu		Duolingo
учебник	uchebnik		Duolingo
учебника	uchebnika		Duolingo
учебнике	uchebnike		Duolingo
учебники	uchebniki		Duolingo
ученик	uchenik		Duolingo
ученики	ucheniki		Duolingo
учеников	uchenikov		Duolingo
ученица	uchenitsa		Duolingo
ученицы	uchenitsy		Duolingo
учёный	uchenyi		Duolingo
учёным	uchenym		Duolingo
учила	uchila		Duolingo
училась	uchilas'		Duolingo
учились	uchilis'		Duolingo
учился	uchilsia		Duolingo
учит	uchit		Duolingo
учителей	uchitelei		Duolingo
учитель	uchitel'		Duolingo
учителю	uchiteliu		Duolingo
учителя	uchitelia		Duolingo
учится	uchitsia		Duolingo
учить	uchit'		Duolingo
учиться	uchit'sia		Duolingo
учу	uchu		Duolingo
учусь	uchus'		Duolingo
уши	ushi		Duolingo
ушла	ushla		Duolingo
файл	fail		Duolingo
файла	faila		Duolingo
файлы	faily		Duolingo
факультеты	fakul'tety		Duolingo
фамилии	familii		Duolingo
фамилию	familiiu		Duolingo
фамилия	familiia		Duolingo
феврале	fevrale		Duolingo
февраль	fevral'		Duolingo
февраля	fevralia		Duolingo
фейсбук	feisbuk		Duolingo
физика	fizika		Duolingo
физике	fizike		Duolingo
физики	fiziki		Duolingo
физический	fizicheskii		Duolingo
физическом	fizicheskom		Duolingo
фильм	fil'm		Duolingo
фильмов	fil'mov		Duolingo
финансовая	finansovaia		Duolingo
финансовый	finansovyi		Duolingo
фирма	firma		Duolingo
фирмы	firmy		Duolingo
флешка	fleshka		Duolingo
флешке	fleshke		Duolingo
форма	forma		Duolingo
форму	formu		Duolingo
формы	formy		Duolingo
фотоаппарат	fotoapparat		Duolingo
фотоаппарата	fotoapparata		Duolingo
фотографии	fotografii		Duolingo
фотографировать	fotografirovat'		Duolingo
фотографию	fotografiiu		Duolingo
франции	frantsii		Duolingo
францию	frantsiiu		Duolingo
француженка	frantsuzhenka		Duolingo
француз	frantsuz		Duolingo
французов	frantsuzov		Duolingo
французски	frantsuzski		Duolingo
французские	frantsuzskie		Duolingo
французский	frantsuzskii		Duolingo
французское	frantsuzskoe		Duolingo
фрукты	frukty		Duolingo
футбол	futbol		Duolingo
футболист	futbolist		Duolingo
футболисты	futbolisty		Duolingo
футболка	futbolka		Duolingo
футболки	futbolki		Duolingo
футболку	futbolku		Duolingo
футболом	futbolom		Duolingo
футбольная	futbol'naia		Duolingo
футбольной	futbol'noi		Duolingo
футбольный	futbol'nyi		Duolingo
характер	kharakter		Duolingo
хватает	khvataet		Duolingo
хватало	khvatalo		Duolingo
хватит	khvatit		Duolingo
хлеб	khleb		Duolingo
хлеба	khleba		Duolingo
ходил	khodil		Duolingo
ходила	khodila		Duolingo
ходили	khodili		Duolingo
ходим	khodim		Duolingo
ходит	khodit		Duolingo
ходите	khodite		Duolingo
ходить	khodit'		Duolingo
ходишь	khodish'		Duolingo
ходят	khodiat		Duolingo
хожу	khozhu		Duolingo
хозяин	khoziain		Duolingo
хозяином	khoziainom		Duolingo
хоккей	khokkei		Duolingo
холодильник	kholodil'nik		Duolingo
холодильнике	kholodil'nike		Duolingo
холодная	kholodnaia		Duolingo
холоднее	kholodnee		Duolingo
холодно	kholodno		Duolingo
холодное	kholodnoe		Duolingo
холодный	kholodnyi		Duolingo
хорошая	khoroshaia		Duolingo
хорошего	khoroshego		Duolingo
хорошее	khoroshee		Duolingo
хорошей	khoroshei		Duolingo
хорошие	khoroshie		Duolingo
хороший	khoroshii		Duolingo
хорошо	khorosho		Duolingo
хорошую	khoroshuiu		Duolingo
хосе	khose		Duolingo
хотел	khotel		Duolingo
хотела	khotela		Duolingo
хотели	khoteli		Duolingo
хотите	khotite		Duolingo
хотя	khotia		Duolingo
хотят	khotiat		Duolingo
хочет	khochet		Duolingo
хочется	khochetsia		Duolingo
хочешь	khochesh'		Duolingo
хочу	khochu		Duolingo
храм	khram		Duolingo
храме	khrame		Duolingo
христиане	khristiane		Duolingo
христианин	khristianin		Duolingo
христианка	khristianka		Duolingo
худая	khudaia		Duolingo
художник	khudozhnik		Duolingo
художника	khudozhnika		Duolingo
художники	khudozhniki		Duolingo
художником	khudozhnikom		Duolingo
худой	khudoi		Duolingo
худые	khudye		Duolingo
хуже	khuzhe		Duolingo
цвет	tsvet		Duolingo
цвета	tsveta		Duolingo
цветов	tsvetov		Duolingo
цветы	tsvety		Duolingo
цел	tsel		Duolingo
целый	tselyi		Duolingo
цена	tsena		Duolingo
центр	tsentr		Duolingo
центра	tsentra		Duolingo
центральном	tsentral'nom		Duolingo
центральный	tsentral'nyi		Duolingo
центре	tsentre		Duolingo
цену	tsenu		Duolingo
церквей	tserkvei		Duolingo
церкви	tserkvi		Duolingo
церковь	tserkov'		Duolingo
цирк	tsirk		Duolingo
чай	chai		Duolingo
чайник	chainik		Duolingo
чайнике	chainike		Duolingo
час	chas		Duolingo
часа	chasa		Duolingo
часов	chasov		Duolingo
части	chasti		Duolingo
частица	chastitsa		Duolingo
частицами	chastitsami		Duolingo
частицы	chastitsy		Duolingo
часто	chasto		Duolingo
часть	chast'		Duolingo
чашек	chashek		Duolingo
чашка	chashka		Duolingo
чашки	chashki		Duolingo
чашку	chashku		Duolingo
чаще	chashche		Duolingo
чая	chaia		Duolingo
чё	che		Duolingo
чё-нибудь	che-nibud'		Duolingo
чего	chego		Duolingo
чей	chei		Duolingo
человек	chelovek		Duolingo
человека	cheloveka		Duolingo
человеке	cheloveke		Duolingo
человеком	chelovekom		Duolingo
человеку	cheloveku		Duolingo
чём	chem		Duolingo
чем-нибудь	chem-nibud'		Duolingo
чем-то	chem-to		Duolingo
через	cherez		Duolingo
чёрная	chernaia		Duolingo
чернов	chernov		Duolingo
чёрный	chernyi		Duolingo
чёрных	chernykh		Duolingo
четверг	chetverg		Duolingo
четверга	chetverga		Duolingo
четвергам	chetvergam		Duolingo
четвёрка	chetverka		Duolingo
четвёрку	chetverku		Duolingo
четвёртом	chetvertom		Duolingo
четвёртый	chetvertyi		Duolingo
четыре	chetyre		Duolingo
четырнадцать	chetyrnadtsat'		Duolingo
число	chislo		Duolingo
чистые	chistye		Duolingo
чистый	chistyi		Duolingo
чистых	chistykh		Duolingo
читает	chitaet		Duolingo
читаешь	chitaesh'		Duolingo
читайте	chitaite		Duolingo
читал	chital		Duolingo
читала	chitala		Duolingo
читатели	chitateli		Duolingo
читатель	chitatel'		Duolingo
читать	chitat'		Duolingo
читаю	chitaiu		Duolingo
читающая	chitaiushchaia		Duolingo
читающего	chitaiushchego		Duolingo
читающие	chitaiushchie		Duolingo
читая	chitaia		Duolingo
что	chto		Duolingo
что такое	chto takoe		Duolingo
что-нибудь	chto-nibud'		Duolingo
что-то	chto-to		Duolingo
чтобы	chtoby		Duolingo
чувствовать	chuvstvovat'		Duolingo
чувствует	chuvstvuet		Duolingo
чувствуете	chuvstvuete		Duolingo
чувствую	chuvstvuiu		Duolingo
чуть не	chut' ne		Duolingo
чуть-чуть	chut'-chut'		Duolingo
чьё	ch'e		Duolingo
чьи	ch'i		Duolingo
чья	ch'ia		Duolingo
шапка	shapka		Duolingo
шапку	shapku		Duolingo
шёл	shel		Duolingo
шестая	shestaia		Duolingo
шести	shesti		Duolingo
шестнадцать	shestnadtsat'		Duolingo
шестой	shestoi		Duolingo
шесть	shest'		Duolingo
шестьдесят	shest'desiat		Duolingo
ширина	shirina		Duolingo
шириной	shirinoi		Duolingo
ширину	shirinu		Duolingo
шкаф	shkaf		Duolingo
шкафу	shkafu		Duolingo
школ	shkol		Duolingo
школа	shkola		Duolingo
школам	shkolam		Duolingo
школе	shkole		Duolingo
школу	shkolu		Duolingo
школы	shkoly		Duolingo
школьная	shkol'naia		Duolingo
школьном	shkol'nom		Duolingo
школьный	shkol'nyi		Duolingo
шла	shla		Duolingo
шли	shli		Duolingo
шоколад	shokolad		Duolingo
шоколада	shokolada		Duolingo
шоколадная	shokoladnaia		Duolingo
шоколадное	shokoladnoe		Duolingo
шоколадный	shokoladnyi		Duolingo
шоссе	shosse		Duolingo
шумно	shumno		Duolingo
щи	shchi		Duolingo
щит	shchit		Duolingo
экзамена	ekzamena		Duolingo
экзамене	ekzamene		Duolingo
экзамену	ekzamenu		Duolingo
экзамены	ekzameny		Duolingo
экономика	ekonomika		Duolingo
экономики	ekonomiki		Duolingo
экономику	ekonomiku		Duolingo
экономист	ekonomist		Duolingo
экономиста	ekonomista		Duolingo
экскурсии	ekskursii		Duolingo
экскурсию	ekskursiiu		Duolingo
экскурсия	ekskursiia		Duolingo
эксперимент	eksperiment		Duolingo
эксперименты	eksperimenty		Duolingo
электричестве	elektrichestve		Duolingo
электричество	elektrichestvo		Duolingo
элемент	element		Duolingo
элемента	elementa		Duolingo
энциклопедии	entsiklopedii		Duolingo
энциклопедию	entsiklopediiu		Duolingo
энциклопедия	entsiklopediia		Duolingo
эта	eta		Duolingo
этаж	etazh		Duolingo
этаже	etazhe		Duolingo
этажей	etazhei		Duolingo
эти	eti		Duolingo
этим	etim		Duolingo
это	eto		Duolingo
этого	etogo		Duolingo
этой	etoi		Duolingo
этом	etom		Duolingo
этому	etomu		Duolingo
этот	etot		Duolingo
эту	etu		Duolingo
эффект	effekt		Duolingo
юбка	iubka		Duolingo
юбку	iubku		Duolingo
юг	iug		Duolingo
юге	iuge		Duolingo
южную	iuzhnuiu		Duolingo
южный	iuzhnyi		Duolingo
юлия	iuliia		Duolingo
юридический	iuridicheskii		Duolingo
юридическом	iuridicheskom		Duolingo
юрист	iurist		Duolingo
юристом	iuristom		Duolingo
я	ia		Duolingo
яблока	iabloka		Duolingo
яблоки	iabloki		Duolingo
яблоко	iabloko		Duolingo
яблочное	iablochnoe		Duolingo
яблочный	iablochnyi		Duolingo
явление	iavlenie		Duolingo
явления	iavleniia		Duolingo
является	iavliaetsia		Duolingo
язык	iazyk		Duolingo
языка	iazyka		Duolingo
языки	iazyki		Duolingo
яйца	iaitsa		Duolingo
яйцо	iaitso		Duolingo
январе	ianvare		Duolingo
январь	ianvar'		Duolingo
января	ianvaria		Duolingo
японец	iaponets		Duolingo
японии	iaponii		Duolingo
японию	iaponiiu		Duolingo
япония	iaponiia		Duolingo
японка	iaponka		Duolingo
японски	iaponski		Duolingo
японский	iaponskii		Duolingo
японского	iaponskogo		Duolingo
японском	iaponskom		Duolingo
японцев	iapontsev		Duolingo
ясно	iasno		Duolingo
